"Random_ID","Trial.Number","Mood","Anxiety","fdbk","PE","Certainty_Rating","m_hist","Prediction","pilot_nr","pilot_details","mini_SPIN_total","Social_Anxiety","SubjPE"
"SUPPRF00216",1,54,60,19,-1,49,20,52,"Pilot 11","Pilot 11: bigger feedback + video + socially anxious",8,"high",-33
"SUPPRF00216",2,68,29,45,-1,56,46,50,"Pilot 11","Pilot 11: bigger feedback + video + socially anxious",8,"high",-5
"SUPPRF00216",3,63,35,22,-15,67,37,50,"Pilot 11","Pilot 11: bigger feedback + video + socially anxious",8,"high",-28
"SUPPRF00216",4,51,41,66,12,66,54,24,"Pilot 11","Pilot 11: bigger feedback + video + socially anxious",8,"high",42
"SUPPRF00216",5,69,33,75,29,66,46,21,"Pilot 11","Pilot 11: bigger feedback + video + socially anxious",8,"high",54
"SUPPRF00216",6,65,38,78,24,68,54,55,"Pilot 11","Pilot 11: bigger feedback + video + socially anxious",8,"high",23
"SUPPRF00216",7,65,35,49,12,64,37,48,"Pilot 11","Pilot 11: bigger feedback + video + socially anxious",8,"high",1
"SUPPRF00216",8,69,49,96,16,60,80,50,"Pilot 11","Pilot 11: bigger feedback + video + socially anxious",8,"high",46
"SUPPRF00216",9,60,32,67,-13,51,80,50,"Pilot 11","Pilot 11: bigger feedback + video + socially anxious",8,"high",17
"SUPPRF00216",10,66,28,47,-16,51,63,51,"Pilot 11","Pilot 11: bigger feedback + video + socially anxious",8,"high",-4
"SUPPRF00216",11,62,25,29,0,70,29,55,"Pilot 11","Pilot 11: bigger feedback + video + socially anxious",8,"high",-26
"SUPPRF00216",12,66,34,37,0,52,37,50,"Pilot 11","Pilot 11: bigger feedback + video + socially anxious",8,"high",-13
"SUPPRF00216",13,48,56,58,12,54,46,54,"Pilot 11","Pilot 11: bigger feedback + video + socially anxious",8,"high",4
"SUPPRF00216",14,57,30,68,-12,56,80,50,"Pilot 11","Pilot 11: bigger feedback + video + socially anxious",8,"high",18
"SUPPRF00216",15,61,38,55,1,70,54,64,"Pilot 11","Pilot 11: bigger feedback + video + socially anxious",8,"high",-9
"SUPPRF00216",16,68,29,100,20,49,80,59,"Pilot 11","Pilot 11: bigger feedback + video + socially anxious",8,"high",41
"SUPPRF00216",17,67,32,81,1,54,80,53,"Pilot 11","Pilot 11: bigger feedback + video + socially anxious",8,"high",28
"SUPPRF00216",18,64,23,70,-1,62,71,73,"Pilot 11","Pilot 11: bigger feedback + video + socially anxious",8,"high",-3
"SUPPRF00216",19,66,25,63,0,61,63,58,"Pilot 11","Pilot 11: bigger feedback + video + socially anxious",8,"high",5
"SUPPRF00216",20,51,60,55,-16,65,71,57,"Pilot 11","Pilot 11: bigger feedback + video + socially anxious",8,"high",-2
"SUPPRF00216",21,61,35,88,25,65,63,57,"Pilot 11","Pilot 11: bigger feedback + video + socially anxious",8,"high",31
"SUPPRF00216",22,68,24,28,-1,75,29,81,"Pilot 11","Pilot 11: bigger feedback + video + socially anxious",8,"high",-53
"SUPPRF00216",23,70,32,71,0,66,71,60,"Pilot 11","Pilot 11: bigger feedback + video + socially anxious",8,"high",11
"SUPPRF00216",24,66,30,6,-14,61,20,63,"Pilot 11","Pilot 11: bigger feedback + video + socially anxious",8,"high",-57
"SUPPRF00216",25,63,28,24,-13,62,37,61,"Pilot 11","Pilot 11: bigger feedback + video + socially anxious",8,"high",-37
"SUPPRF00216",26,67,31,35,15,64,20,66,"Pilot 11","Pilot 11: bigger feedback + video + socially anxious",8,"high",-31
"SUPPRF00216",27,64,29,58,29,62,29,63,"Pilot 11","Pilot 11: bigger feedback + video + socially anxious",8,"high",-5
"SUPPRF00216",28,68,27,46,17,67,29,66,"Pilot 11","Pilot 11: bigger feedback + video + socially anxious",8,"high",-20
"SUPPRF00216",29,64,27,33,-13,70,46,59,"Pilot 11","Pilot 11: bigger feedback + video + socially anxious",8,"high",-26
"SUPPRF00216",30,70,25,83,12,67,71,64,"Pilot 11","Pilot 11: bigger feedback + video + socially anxious",8,"high",19
"SUPPRF00216",31,69,31,15,-14,68,29,67,"Pilot 11","Pilot 11: bigger feedback + video + socially anxious",8,"high",-52
"SUPPRF00216",32,66,28,61,24,59,37,50,"Pilot 11","Pilot 11: bigger feedback + video + socially anxious",8,"high",11
"SUPPRF00216",33,64,25,80,0,63,80,73,"Pilot 11","Pilot 11: bigger feedback + video + socially anxious",8,"high",7
"SUPPRF00216",34,68,30,34,-12,75,46,81,"Pilot 11","Pilot 11: bigger feedback + video + socially anxious",8,"high",-47
"SUPPRF00216",35,71,24,47,27,70,20,65,"Pilot 11","Pilot 11: bigger feedback + video + socially anxious",8,"high",-18
"SUPPRF00216",36,70,25,54,0,74,54,78,"Pilot 11","Pilot 11: bigger feedback + video + socially anxious",8,"high",-24
"SUPPRF00216",37,71,23,46,0,72,46,71,"Pilot 11","Pilot 11: bigger feedback + video + socially anxious",8,"high",-25
"SUPPRF00216",38,69,21,38,1,70,37,67,"Pilot 11","Pilot 11: bigger feedback + video + socially anxious",8,"high",-29
"SUPPRF00216",39,77,28,20,0,63,20,62,"Pilot 11","Pilot 11: bigger feedback + video + socially anxious",8,"high",-42
"SUPPRF00216",40,72,52,16,-13,76,29,73,"Pilot 11","Pilot 11: bigger feedback + video + socially anxious",8,"high",-57
"SUPPRF00216",41,70,30,38,-16,71,54,70,"Pilot 11","Pilot 11: bigger feedback + video + socially anxious",8,"high",-32
"SUPPRF00216",42,73,48,77,14,68,63,79,"Pilot 11","Pilot 11: bigger feedback + video + socially anxious",8,"high",-2
"SUPPRF00216",43,69,47,50,-13,71,63,86,"Pilot 11","Pilot 11: bigger feedback + video + socially anxious",8,"high",-36
"SUPPRF00216",44,68,29,56,-15,58,71,74,"Pilot 11","Pilot 11: bigger feedback + video + socially anxious",8,"high",-18
"SUPPRF00216",45,72,31,94,23,75,71,73,"Pilot 11","Pilot 11: bigger feedback + video + socially anxious",8,"high",21
"SUPPRF00216",46,76,26,62,-1,77,63,77,"Pilot 11","Pilot 11: bigger feedback + video + socially anxious",8,"high",-15
"SUPPRF00216",47,70,48,41,-13,75,54,67,"Pilot 11","Pilot 11: bigger feedback + video + socially anxious",8,"high",-26
"SUPPRF00216",48,52,28,8,-12,75,20,71,"Pilot 11","Pilot 11: bigger feedback + video + socially anxious",8,"high",-63
"SUPPRF00818",1,71,0,78,24,63,54,53,"Pilot 8","Pilot 8: max feedback + text",4,"low",25
"SUPPRF00818",2,70,0,37,0,63,37,40,"Pilot 8","Pilot 8: max feedback + text",4,"low",-3
"SUPPRF00818",3,61,2,22,-15,77,37,35,"Pilot 8","Pilot 8: max feedback + text",4,"low",-13
"SUPPRF00818",4,66,0,29,0,73,29,25,"Pilot 8","Pilot 8: max feedback + text",4,"low",4
"SUPPRF00818",5,68,2,49,12,77,37,22,"Pilot 8","Pilot 8: max feedback + text",4,"low",27
"SUPPRF00818",6,70,0,71,0,89,71,27,"Pilot 8","Pilot 8: max feedback + text",4,"low",44
"SUPPRF00818",7,66,1,24,-13,82,37,35,"Pilot 8","Pilot 8: max feedback + text",4,"low",-11
"SUPPRF00818",8,75,0,96,16,78,80,73,"Pilot 8","Pilot 8: max feedback + text",4,"low",23
"SUPPRF00818",9,67,0,15,-14,70,29,25,"Pilot 8","Pilot 8: max feedback + text",4,"low",-10
"SUPPRF00818",10,65,0,16,-13,66,29,27,"Pilot 8","Pilot 8: max feedback + text",4,"low",-11
"SUPPRF00818",11,71,0,80,0,73,80,76,"Pilot 8","Pilot 8: max feedback + text",4,"low",4
"SUPPRF00818",12,73,1,38,1,79,37,25,"Pilot 8","Pilot 8: max feedback + text",4,"low",13
"SUPPRF00818",13,57,0,38,-16,69,54,49,"Pilot 8","Pilot 8: max feedback + text",4,"low",-11
"SUPPRF00818",14,53,0,6,-14,65,20,13,"Pilot 8","Pilot 8: max feedback + text",4,"low",-7
"SUPPRF00818",15,69,0,58,12,54,46,30,"Pilot 8","Pilot 8: max feedback + text",4,"low",28
"SUPPRF00818",16,74,0,70,-1,73,71,71,"Pilot 8","Pilot 8: max feedback + text",4,"low",-1
"SUPPRF00818",17,71,0,46,0,70,46,30,"Pilot 8","Pilot 8: max feedback + text",4,"low",16
"SUPPRF00818",18,74,0,66,12,77,54,59,"Pilot 8","Pilot 8: max feedback + text",4,"low",7
"SUPPRF00818",19,66,1,28,-1,45,29,34,"Pilot 8","Pilot 8: max feedback + text",4,"low",-6
"SUPPRF00818",20,72,0,61,24,72,37,37,"Pilot 8","Pilot 8: max feedback + text",4,"low",24
"SUPPRF00818",21,76,2,47,27,65,20,12,"Pilot 8","Pilot 8: max feedback + text",4,"low",35
"SUPPRF00818",22,63,0,55,1,64,54,38,"Pilot 8","Pilot 8: max feedback + text",4,"low",17
"SUPPRF00818",23,72,0,41,-13,64,54,37,"Pilot 8","Pilot 8: max feedback + text",4,"low",4
"SUPPRF00818",24,66,0,35,15,59,20,17,"Pilot 8","Pilot 8: max feedback + text",4,"low",18
"SUPPRF00818",25,72,0,54,0,52,54,41,"Pilot 8","Pilot 8: max feedback + text",4,"low",13
"SUPPRF00818",26,78,0,45,-1,45,46,44,"Pilot 8","Pilot 8: max feedback + text",4,"low",1
"SUPPRF00818",27,65,0,56,-15,65,71,63,"Pilot 8","Pilot 8: max feedback + text",4,"low",-7
"SUPPRF00818",28,89,0,75,29,78,46,41,"Pilot 8","Pilot 8: max feedback + text",4,"low",34
"SUPPRF00818",29,76,2,77,14,50,63,35,"Pilot 8","Pilot 8: max feedback + text",4,"low",42
"SUPPRF00818",30,65,0,20,0,59,20,12,"Pilot 8","Pilot 8: max feedback + text",4,"low",8
"SUPPRF00818",31,71,0,68,-12,68,80,66,"Pilot 8","Pilot 8: max feedback + text",4,"low",2
"SUPPRF00818",32,66,0,33,-13,49,46,24,"Pilot 8","Pilot 8: max feedback + text",4,"low",9
"SUPPRF00818",33,66,0,50,-13,69,63,45,"Pilot 8","Pilot 8: max feedback + text",4,"low",5
"SUPPRF00818",34,72,0,83,12,74,71,66,"Pilot 8","Pilot 8: max feedback + text",4,"low",17
"SUPPRF00818",35,72,0,19,-1,75,20,17,"Pilot 8","Pilot 8: max feedback + text",4,"low",2
"SUPPRF00818",36,74,0,46,17,67,29,33,"Pilot 8","Pilot 8: max feedback + text",4,"low",13
"SUPPRF00818",37,82,0,100,20,72,80,72,"Pilot 8","Pilot 8: max feedback + text",4,"low",28
"SUPPRF00818",38,75,0,81,1,75,80,71,"Pilot 8","Pilot 8: max feedback + text",4,"low",10
"SUPPRF00818",39,82,0,63,0,48,63,41,"Pilot 8","Pilot 8: max feedback + text",4,"low",22
"SUPPRF00818",40,71,0,47,-16,52,63,52,"Pilot 8","Pilot 8: max feedback + text",4,"low",-5
"SUPPRF00818",41,71,0,67,-13,40,80,51,"Pilot 8","Pilot 8: max feedback + text",4,"low",16
"SUPPRF00818",42,82,0,55,-16,58,71,49,"Pilot 8","Pilot 8: max feedback + text",4,"low",6
"SUPPRF00818",43,72,0,58,29,49,29,39,"Pilot 8","Pilot 8: max feedback + text",4,"low",19
"SUPPRF00818",44,59,1,34,-12,60,46,44,"Pilot 8","Pilot 8: max feedback + text",4,"low",-10
"SUPPRF00818",45,70,0,8,-12,62,20,9,"Pilot 8","Pilot 8: max feedback + text",4,"low",-1
"SUPPRF00818",46,80,0,88,25,67,63,44,"Pilot 8","Pilot 8: max feedback + text",4,"low",44
"SUPPRF00818",47,89,0,94,23,67,71,28,"Pilot 8","Pilot 8: max feedback + text",4,"low",66
"SUPPRF00818",48,75,0,62,-1,46,63,47,"Pilot 8","Pilot 8: max feedback + text",4,"low",15
"SUPPRF01236",1,93,0,45,-1,89,46,47,"Pilot 8","Pilot 8: max feedback + text",3,"low",-2
"SUPPRF01236",2,92,0,50,-13,50,63,48,"Pilot 8","Pilot 8: max feedback + text",3,"low",2
"SUPPRF01236",3,96,1,68,-12,73,80,74,"Pilot 8","Pilot 8: max feedback + text",3,"low",-6
"SUPPRF01236",4,93,0,15,-14,16,29,76,"Pilot 8","Pilot 8: max feedback + text",3,"low",-61
"SUPPRF01236",5,89,0,24,-13,98,37,6,"Pilot 8","Pilot 8: max feedback + text",3,"low",18
"SUPPRF01236",6,74,4,41,-13,59,54,52,"Pilot 8","Pilot 8: max feedback + text",3,"low",-11
"SUPPRF01236",7,98,0,46,0,47,46,46,"Pilot 8","Pilot 8: max feedback + text",3,"low",0
"SUPPRF01236",8,81,0,78,24,48,54,49,"Pilot 8","Pilot 8: max feedback + text",3,"low",29
"SUPPRF01236",9,97,0,94,23,48,71,51,"Pilot 8","Pilot 8: max feedback + text",3,"low",43
"SUPPRF01236",10,86,1,16,-13,48,29,49,"Pilot 8","Pilot 8: max feedback + text",3,"low",-33
"SUPPRF01236",11,85,4,77,14,49,63,51,"Pilot 8","Pilot 8: max feedback + text",3,"low",26
"SUPPRF01236",12,73,0,70,-1,36,71,52,"Pilot 8","Pilot 8: max feedback + text",3,"low",18
"SUPPRF01236",13,91,0,47,27,100,20,0,"Pilot 8","Pilot 8: max feedback + text",3,"low",47
"SUPPRF01236",14,88,0,33,-13,50,46,65,"Pilot 8","Pilot 8: max feedback + text",3,"low",-32
"SUPPRF01236",15,48,47,37,0,48,37,51,"Pilot 8","Pilot 8: max feedback + text",3,"low",-14
"SUPPRF01236",16,71,6,56,-15,49,71,45,"Pilot 8","Pilot 8: max feedback + text",3,"low",11
"SUPPRF01236",17,49,41,19,-1,48,20,51,"Pilot 8","Pilot 8: max feedback + text",3,"low",-32
"SUPPRF01236",18,22,25,61,24,51,37,48,"Pilot 8","Pilot 8: max feedback + text",3,"low",13
"SUPPRF01236",19,0,38,100,20,49,80,45,"Pilot 8","Pilot 8: max feedback + text",3,"low",55
"SUPPRF01236",20,0,31,75,29,47,46,43,"Pilot 8","Pilot 8: max feedback + text",3,"low",32
"SUPPRF01236",21,2,25,80,0,48,80,49,"Pilot 8","Pilot 8: max feedback + text",3,"low",31
"SUPPRF01236",22,2,42,6,-14,49,20,46,"Pilot 8","Pilot 8: max feedback + text",3,"low",-40
"SUPPRF01236",23,4,44,49,12,41,37,47,"Pilot 8","Pilot 8: max feedback + text",3,"low",2
"SUPPRF01236",24,14,43,22,-15,49,37,46,"Pilot 8","Pilot 8: max feedback + text",3,"low",-24
"SUPPRF01236",25,6,44,54,0,38,54,44,"Pilot 8","Pilot 8: max feedback + text",3,"low",10
"SUPPRF01236",26,9,22,28,-1,47,29,42,"Pilot 8","Pilot 8: max feedback + text",3,"low",-14
"SUPPRF01236",27,16,25,67,-13,44,80,48,"Pilot 8","Pilot 8: max feedback + text",3,"low",19
"SUPPRF01236",28,19,10,8,-12,47,20,44,"Pilot 8","Pilot 8: max feedback + text",3,"low",-36
"SUPPRF01236",29,8,7,55,1,47,54,48,"Pilot 8","Pilot 8: max feedback + text",3,"low",7
"SUPPRF01236",30,7,8,38,-16,45,54,46,"Pilot 8","Pilot 8: max feedback + text",3,"low",-8
"SUPPRF01236",31,11,34,47,-16,46,63,48,"Pilot 8","Pilot 8: max feedback + text",3,"low",-1
"SUPPRF01236",32,7,10,58,29,48,29,39,"Pilot 8","Pilot 8: max feedback + text",3,"low",19
"SUPPRF01236",33,25,38,58,12,31,46,53,"Pilot 8","Pilot 8: max feedback + text",3,"low",5
"SUPPRF01236",34,10,20,46,17,41,29,46,"Pilot 8","Pilot 8: max feedback + text",3,"low",0
"SUPPRF01236",35,12,5,62,-1,45,63,50,"Pilot 8","Pilot 8: max feedback + text",3,"low",12
"SUPPRF01236",36,12,8,88,25,45,63,46,"Pilot 8","Pilot 8: max feedback + text",3,"low",42
"SUPPRF01236",37,16,6,71,0,45,71,51,"Pilot 8","Pilot 8: max feedback + text",3,"low",20
"SUPPRF01236",38,11,25,81,1,48,80,49,"Pilot 8","Pilot 8: max feedback + text",3,"low",32
"SUPPRF01236",39,44,45,29,0,47,29,42,"Pilot 8","Pilot 8: max feedback + text",3,"low",-13
"SUPPRF01236",40,25,33,34,-12,45,46,50,"Pilot 8","Pilot 8: max feedback + text",3,"low",-16
"SUPPRF01236",41,10,2,66,12,45,54,44,"Pilot 8","Pilot 8: max feedback + text",3,"low",22
"SUPPRF01236",42,2,8,38,1,45,37,48,"Pilot 8","Pilot 8: max feedback + text",3,"low",-10
"SUPPRF01236",43,10,11,55,-16,43,71,44,"Pilot 8","Pilot 8: max feedback + text",3,"low",11
"SUPPRF01236",44,31,34,20,0,45,20,46,"Pilot 8","Pilot 8: max feedback + text",3,"low",-26
"SUPPRF01236",45,30,16,96,16,49,80,37,"Pilot 8","Pilot 8: max feedback + text",3,"low",59
"SUPPRF01236",46,44,45,35,15,44,20,49,"Pilot 8","Pilot 8: max feedback + text",3,"low",-14
"SUPPRF01236",47,47,45,63,0,46,63,41,"Pilot 8","Pilot 8: max feedback + text",3,"low",22
"SUPPRF01236",48,38,30,83,12,49,71,45,"Pilot 8","Pilot 8: max feedback + text",3,"low",38
"SUPPRF01788",1,15,68,55,-16,67,71,57,"Pilot 7","Pilot 7: bigger feedback + text",7,"high",-2
"SUPPRF01788",2,35,58,46,17,79,29,26,"Pilot 7","Pilot 7: bigger feedback + text",7,"high",20
"SUPPRF01788",3,30,63,29,0,83,29,41,"Pilot 7","Pilot 7: bigger feedback + text",7,"high",-12
"SUPPRF01788",4,27,64,56,-15,12,71,21,"Pilot 7","Pilot 7: bigger feedback + text",7,"high",35
"SUPPRF01788",5,16,73,15,-14,74,29,29,"Pilot 7","Pilot 7: bigger feedback + text",7,"high",-14
"SUPPRF01788",6,33,57,62,-1,65,63,53,"Pilot 7","Pilot 7: bigger feedback + text",7,"high",9
"SUPPRF01788",7,35,65,84,13,64,71,60,"Pilot 7","Pilot 7: bigger feedback + text",7,"high",24
"SUPPRF01788",8,29,55,68,-12,73,80,68,"Pilot 7","Pilot 7: bigger feedback + text",7,"high",0
"SUPPRF01788",9,35,56,41,-13,65,54,53,"Pilot 7","Pilot 7: bigger feedback + text",7,"high",-12
"SUPPRF01788",10,34,52,63,0,52,63,33,"Pilot 7","Pilot 7: bigger feedback + text",7,"high",30
"SUPPRF01788",11,30,48,67,-13,81,80,68,"Pilot 7","Pilot 7: bigger feedback + text",7,"high",-1
"SUPPRF01788",12,26,59,38,-16,89,54,62,"Pilot 7","Pilot 7: bigger feedback + text",7,"high",-24
"SUPPRF01788",13,11,66,6,-14,91,20,15,"Pilot 7","Pilot 7: bigger feedback + text",7,"high",-9
"SUPPRF01788",14,31,70,49,12,74,37,32,"Pilot 7","Pilot 7: bigger feedback + text",7,"high",17
"SUPPRF01788",15,34,51,48,19,21,29,35,"Pilot 7","Pilot 7: bigger feedback + text",7,"high",13
"SUPPRF01788",16,27,42,70,-1,69,71,62,"Pilot 7","Pilot 7: bigger feedback + text",7,"high",8
"SUPPRF01788",17,24,43,80,0,25,80,55,"Pilot 7","Pilot 7: bigger feedback + text",7,"high",25
"SUPPRF01788",18,39,55,83,12,58,71,52,"Pilot 7","Pilot 7: bigger feedback + text",7,"high",31
"SUPPRF01788",19,41,47,19,-1,94,20,7,"Pilot 7","Pilot 7: bigger feedback + text",7,"high",12
"SUPPRF01788",20,23,41,22,-15,75,37,33,"Pilot 7","Pilot 7: bigger feedback + text",7,"high",-11
"SUPPRF01788",21,41,48,50,-13,69,63,40,"Pilot 7","Pilot 7: bigger feedback + text",7,"high",10
"SUPPRF01788",22,31,61,16,-13,69,29,37,"Pilot 7","Pilot 7: bigger feedback + text",7,"high",-21
"SUPPRF01788",23,40,41,78,15,57,63,37,"Pilot 7","Pilot 7: bigger feedback + text",7,"high",41
"SUPPRF01788",24,26,65,24,-13,83,37,38,"Pilot 7","Pilot 7: bigger feedback + text",7,"high",-14
"SUPPRF01788",25,35,35,65,19,71,46,35,"Pilot 7","Pilot 7: bigger feedback + text",7,"high",30
"SUPPRF01788",26,31,65,34,-12,76,46,43,"Pilot 7","Pilot 7: bigger feedback + text",7,"high",-9
"SUPPRF01788",27,25,40,81,1,89,80,74,"Pilot 7","Pilot 7: bigger feedback + text",7,"high",7
"SUPPRF01788",28,27,62,46,0,81,46,58,"Pilot 7","Pilot 7: bigger feedback + text",7,"high",-12
"SUPPRF01788",29,10,66,28,-1,73,29,32,"Pilot 7","Pilot 7: bigger feedback + text",7,"high",-4
"SUPPRF01788",30,31,56,71,0,79,71,53,"Pilot 7","Pilot 7: bigger feedback + text",7,"high",18
"SUPPRF01788",31,29,61,47,-16,64,63,45,"Pilot 7","Pilot 7: bigger feedback + text",7,"high",2
"SUPPRF01788",32,34,54,58,12,63,46,52,"Pilot 7","Pilot 7: bigger feedback + text",7,"high",6
"SUPPRF01788",33,35,61,33,-13,60,46,54,"Pilot 7","Pilot 7: bigger feedback + text",7,"high",-21
"SUPPRF01788",34,45,56,77,14,58,63,40,"Pilot 7","Pilot 7: bigger feedback + text",7,"high",37
"SUPPRF01788",35,44,63,55,1,28,54,33,"Pilot 7","Pilot 7: bigger feedback + text",7,"high",22
"SUPPRF01788",36,39,63,45,-1,58,46,53,"Pilot 7","Pilot 7: bigger feedback + text",7,"high",-8
"SUPPRF01788",37,42,70,35,15,86,20,8,"Pilot 7","Pilot 7: bigger feedback + text",7,"high",27
"SUPPRF01788",38,34,59,66,12,58,54,48,"Pilot 7","Pilot 7: bigger feedback + text",7,"high",18
"SUPPRF01788",39,36,51,68,14,70,54,45,"Pilot 7","Pilot 7: bigger feedback + text",7,"high",23
"SUPPRF01788",40,42,56,51,14,4,37,12,"Pilot 7","Pilot 7: bigger feedback + text",7,"high",39
"SUPPRF01788",41,42,62,96,16,73,80,71,"Pilot 7","Pilot 7: bigger feedback + text",7,"high",25
"SUPPRF01788",42,35,58,38,1,64,37,40,"Pilot 7","Pilot 7: bigger feedback + text",7,"high",-2
"SUPPRF01788",43,31,58,97,17,70,80,81,"Pilot 7","Pilot 7: bigger feedback + text",7,"high",16
"SUPPRF01788",44,36,59,37,0,71,37,33,"Pilot 7","Pilot 7: bigger feedback + text",7,"high",4
"SUPPRF01788",45,36,58,8,-12,74,20,10,"Pilot 7","Pilot 7: bigger feedback + text",7,"high",-2
"SUPPRF01788",46,43,58,37,17,79,20,6,"Pilot 7","Pilot 7: bigger feedback + text",7,"high",31
"SUPPRF01788",47,37,60,54,0,23,54,33,"Pilot 7","Pilot 7: bigger feedback + text",7,"high",21
"SUPPRF01788",48,36,52,20,0,64,20,16,"Pilot 7","Pilot 7: bigger feedback + text",7,"high",4
"SUPPRF03208",1,86,28,38,1,20,37,30,"Pilot 8","Pilot 8: max feedback + text",0,"low",8
"SUPPRF03208",2,79,23,28,-1,19,29,36,"Pilot 8","Pilot 8: max feedback + text",0,"low",-8
"SUPPRF03208",3,86,7,80,0,9,80,76,"Pilot 8","Pilot 8: max feedback + text",0,"low",4
"SUPPRF03208",4,90,5,83,12,6,71,73,"Pilot 8","Pilot 8: max feedback + text",0,"low",10
"SUPPRF03208",5,87,4,50,-13,5,63,65,"Pilot 8","Pilot 8: max feedback + text",0,"low",-15
"SUPPRF03208",6,90,4,68,-12,13,80,77,"Pilot 8","Pilot 8: max feedback + text",0,"low",-9
"SUPPRF03208",7,89,2,45,-1,3,46,75,"Pilot 8","Pilot 8: max feedback + text",0,"low",-30
"SUPPRF03208",8,93,1,47,27,3,20,9,"Pilot 8","Pilot 8: max feedback + text",0,"low",38
"SUPPRF03208",9,92,1,41,-13,42,54,1,"Pilot 8","Pilot 8: max feedback + text",0,"low",40
"SUPPRF03208",10,90,2,61,24,6,37,18,"Pilot 8","Pilot 8: max feedback + text",0,"low",43
"SUPPRF03208",11,87,0,33,-13,3,46,22,"Pilot 8","Pilot 8: max feedback + text",0,"low",11
"SUPPRF03208",12,90,0,71,0,1,71,50,"Pilot 8","Pilot 8: max feedback + text",0,"low",21
"SUPPRF03208",13,89,0,35,15,2,20,9,"Pilot 8","Pilot 8: max feedback + text",0,"low",26
"SUPPRF03208",14,100,0,94,23,1,71,63,"Pilot 8","Pilot 8: max feedback + text",0,"low",31
"SUPPRF03208",15,91,0,58,12,3,46,28,"Pilot 8","Pilot 8: max feedback + text",0,"low",30
"SUPPRF03208",16,90,1,67,-13,1,80,68,"Pilot 8","Pilot 8: max feedback + text",0,"low",-1
"SUPPRF03208",17,91,1,49,12,2,37,24,"Pilot 8","Pilot 8: max feedback + text",0,"low",25
"SUPPRF03208",18,88,1,8,-12,1,20,15,"Pilot 8","Pilot 8: max feedback + text",0,"low",-7
"SUPPRF03208",19,87,1,16,-13,0,29,37,"Pilot 8","Pilot 8: max feedback + text",0,"low",-21
"SUPPRF03208",20,85,1,22,-15,1,37,20,"Pilot 8","Pilot 8: max feedback + text",0,"low",2
"SUPPRF03208",21,90,1,62,-1,2,63,21,"Pilot 8","Pilot 8: max feedback + text",0,"low",41
"SUPPRF03208",22,92,3,96,16,0,80,82,"Pilot 8","Pilot 8: max feedback + text",0,"low",14
"SUPPRF03208",23,93,1,75,29,1,46,47,"Pilot 8","Pilot 8: max feedback + text",0,"low",28
"SUPPRF03208",24,86,1,15,-14,1,29,46,"Pilot 8","Pilot 8: max feedback + text",0,"low",-31
"SUPPRF03208",25,91,1,70,-1,1,71,66,"Pilot 8","Pilot 8: max feedback + text",0,"low",4
"SUPPRF03208",26,90,0,66,12,2,54,40,"Pilot 8","Pilot 8: max feedback + text",0,"low",26
"SUPPRF03208",27,92,1,100,20,1,80,64,"Pilot 8","Pilot 8: max feedback + text",0,"low",36
"SUPPRF03208",28,92,1,20,0,1,20,5,"Pilot 8","Pilot 8: max feedback + text",0,"low",15
"SUPPRF03208",29,90,1,6,-14,0,20,6,"Pilot 8","Pilot 8: max feedback + text",0,"low",0
"SUPPRF03208",30,87,1,63,0,1,63,28,"Pilot 8","Pilot 8: max feedback + text",0,"low",35
"SUPPRF03208",31,87,0,54,0,1,54,2,"Pilot 8","Pilot 8: max feedback + text",0,"low",52
"SUPPRF03208",32,85,1,47,-16,1,63,50,"Pilot 8","Pilot 8: max feedback + text",0,"low",-3
"SUPPRF03208",33,90,0,38,-16,0,54,1,"Pilot 8","Pilot 8: max feedback + text",0,"low",37
"SUPPRF03208",34,88,0,29,0,1,29,19,"Pilot 8","Pilot 8: max feedback + text",0,"low",10
"SUPPRF03208",35,90,0,56,-15,2,71,50,"Pilot 8","Pilot 8: max feedback + text",0,"low",6
"SUPPRF03208",36,86,1,46,0,1,46,31,"Pilot 8","Pilot 8: max feedback + text",0,"low",15
"SUPPRF03208",37,89,1,24,-13,1,37,23,"Pilot 8","Pilot 8: max feedback + text",0,"low",1
"SUPPRF03208",38,88,1,19,-1,1,20,9,"Pilot 8","Pilot 8: max feedback + text",0,"low",10
"SUPPRF03208",39,92,1,55,-16,2,71,3,"Pilot 8","Pilot 8: max feedback + text",0,"low",52
"SUPPRF03208",40,87,1,55,1,1,54,26,"Pilot 8","Pilot 8: max feedback + text",0,"low",29
"SUPPRF03208",41,88,1,34,-12,1,46,26,"Pilot 8","Pilot 8: max feedback + text",0,"low",8
"SUPPRF03208",42,88,2,46,17,0,29,42,"Pilot 8","Pilot 8: max feedback + text",0,"low",4
"SUPPRF03208",43,90,1,88,25,1,63,23,"Pilot 8","Pilot 8: max feedback + text",0,"low",65
"SUPPRF03208",44,87,0,77,14,2,63,41,"Pilot 8","Pilot 8: max feedback + text",0,"low",36
"SUPPRF03208",45,88,3,58,29,1,29,4,"Pilot 8","Pilot 8: max feedback + text",0,"low",54
"SUPPRF03208",46,90,1,81,1,1,80,40,"Pilot 8","Pilot 8: max feedback + text",0,"low",41
"SUPPRF03208",47,89,1,37,0,2,37,42,"Pilot 8","Pilot 8: max feedback + text",0,"low",-5
"SUPPRF03208",48,90,1,78,24,1,54,36,"Pilot 8","Pilot 8: max feedback + text",0,"low",42
"SUPPRF03254",1,50,30,47,-16,21,63,43,"Pilot 11","Pilot 11: bigger feedback + video + socially anxious",8,"high",4
"SUPPRF03254",2,57,29,94,23,39,71,68,"Pilot 11","Pilot 11: bigger feedback + video + socially anxious",8,"high",26
"SUPPRF03254",3,57,26,29,0,36,29,53,"Pilot 11","Pilot 11: bigger feedback + video + socially anxious",8,"high",-24
"SUPPRF03254",4,60,33,34,-12,45,46,43,"Pilot 11","Pilot 11: bigger feedback + video + socially anxious",8,"high",-9
"SUPPRF03254",5,65,41,46,0,45,46,30,"Pilot 11","Pilot 11: bigger feedback + video + socially anxious",8,"high",16
"SUPPRF03254",6,61,34,83,12,57,71,67,"Pilot 11","Pilot 11: bigger feedback + video + socially anxious",8,"high",16
"SUPPRF03254",7,64,27,62,-1,29,63,44,"Pilot 11","Pilot 11: bigger feedback + video + socially anxious",8,"high",18
"SUPPRF03254",8,61,34,37,0,31,37,34,"Pilot 11","Pilot 11: bigger feedback + video + socially anxious",8,"high",3
"SUPPRF03254",9,70,28,68,-12,31,80,51,"Pilot 11","Pilot 11: bigger feedback + video + socially anxious",8,"high",17
"SUPPRF03254",10,62,32,61,24,29,37,40,"Pilot 11","Pilot 11: bigger feedback + video + socially anxious",8,"high",21
"SUPPRF03254",11,58,21,63,0,27,63,54,"Pilot 11","Pilot 11: bigger feedback + video + socially anxious",8,"high",9
"SUPPRF03254",12,42,23,33,-13,25,46,46,"Pilot 11","Pilot 11: bigger feedback + video + socially anxious",8,"high",-13
"SUPPRF03254",13,65,27,19,-1,66,20,10,"Pilot 11","Pilot 11: bigger feedback + video + socially anxious",8,"high",9
"SUPPRF03254",14,52,31,46,17,28,29,44,"Pilot 11","Pilot 11: bigger feedback + video + socially anxious",8,"high",2
"SUPPRF03254",15,68,19,55,-16,40,71,31,"Pilot 11","Pilot 11: bigger feedback + video + socially anxious",8,"high",24
"SUPPRF03254",16,67,32,100,20,45,80,62,"Pilot 11","Pilot 11: bigger feedback + video + socially anxious",8,"high",38
"SUPPRF03254",17,58,39,38,-16,35,54,56,"Pilot 11","Pilot 11: bigger feedback + video + socially anxious",8,"high",-18
"SUPPRF03254",18,79,21,56,-15,14,71,71,"Pilot 11","Pilot 11: bigger feedback + video + socially anxious",8,"high",-15
"SUPPRF03254",19,76,21,78,24,54,54,37,"Pilot 11","Pilot 11: bigger feedback + video + socially anxious",8,"high",41
"SUPPRF03254",20,60,26,45,-1,53,46,44,"Pilot 11","Pilot 11: bigger feedback + video + socially anxious",8,"high",1
"SUPPRF03254",21,64,22,49,12,45,37,39,"Pilot 11","Pilot 11: bigger feedback + video + socially anxious",8,"high",10
"SUPPRF03254",22,64,26,81,1,18,80,48,"Pilot 11","Pilot 11: bigger feedback + video + socially anxious",8,"high",33
"SUPPRF03254",23,75,26,54,0,30,54,67,"Pilot 11","Pilot 11: bigger feedback + video + socially anxious",8,"high",-13
"SUPPRF03254",24,69,20,38,1,33,37,59,"Pilot 11","Pilot 11: bigger feedback + video + socially anxious",8,"high",-21
"SUPPRF03254",25,75,12,67,-13,8,80,51,"Pilot 11","Pilot 11: bigger feedback + video + socially anxious",8,"high",16
"SUPPRF03254",26,77,15,80,0,30,80,75,"Pilot 11","Pilot 11: bigger feedback + video + socially anxious",8,"high",5
"SUPPRF03254",27,78,19,71,0,18,71,65,"Pilot 11","Pilot 11: bigger feedback + video + socially anxious",8,"high",6
"SUPPRF03254",28,69,29,35,15,11,20,31,"Pilot 11","Pilot 11: bigger feedback + video + socially anxious",8,"high",4
"SUPPRF03254",29,72,25,58,29,27,29,30,"Pilot 11","Pilot 11: bigger feedback + video + socially anxious",8,"high",28
"SUPPRF03254",30,69,24,66,12,31,54,61,"Pilot 11","Pilot 11: bigger feedback + video + socially anxious",8,"high",5
"SUPPRF03254",31,79,31,88,25,24,63,61,"Pilot 11","Pilot 11: bigger feedback + video + socially anxious",8,"high",27
"SUPPRF03254",32,74,23,77,14,25,63,45,"Pilot 11","Pilot 11: bigger feedback + video + socially anxious",8,"high",32
"SUPPRF03254",33,78,21,6,-14,23,20,42,"Pilot 11","Pilot 11: bigger feedback + video + socially anxious",8,"high",-36
"SUPPRF03254",34,62,22,41,-13,17,54,54,"Pilot 11","Pilot 11: bigger feedback + video + socially anxious",8,"high",-13
"SUPPRF03254",35,73,32,47,27,58,20,11,"Pilot 11","Pilot 11: bigger feedback + video + socially anxious",8,"high",36
"SUPPRF03254",36,74,21,75,29,51,46,51,"Pilot 11","Pilot 11: bigger feedback + video + socially anxious",8,"high",24
"SUPPRF03254",37,71,20,55,1,28,54,49,"Pilot 11","Pilot 11: bigger feedback + video + socially anxious",8,"high",6
"SUPPRF03254",38,68,12,15,-14,21,29,55,"Pilot 11","Pilot 11: bigger feedback + video + socially anxious",8,"high",-40
"SUPPRF03254",39,58,38,24,-13,32,37,22,"Pilot 11","Pilot 11: bigger feedback + video + socially anxious",8,"high",2
"SUPPRF03254",40,54,28,20,0,22,20,23,"Pilot 11","Pilot 11: bigger feedback + video + socially anxious",8,"high",-3
"SUPPRF03254",41,65,19,58,12,30,46,15,"Pilot 11","Pilot 11: bigger feedback + video + socially anxious",8,"high",43
"SUPPRF03254",42,72,22,28,-1,41,29,59,"Pilot 11","Pilot 11: bigger feedback + video + socially anxious",8,"high",-31
"SUPPRF03254",43,49,21,16,-13,25,29,50,"Pilot 11","Pilot 11: bigger feedback + video + socially anxious",8,"high",-34
"SUPPRF03254",44,57,31,22,-15,23,37,35,"Pilot 11","Pilot 11: bigger feedback + video + socially anxious",8,"high",-13
"SUPPRF03254",45,68,19,70,-1,14,71,72,"Pilot 11","Pilot 11: bigger feedback + video + socially anxious",8,"high",-2
"SUPPRF03254",46,43,35,8,-12,25,20,37,"Pilot 11","Pilot 11: bigger feedback + video + socially anxious",8,"high",-29
"SUPPRF03254",47,67,23,50,-13,30,63,46,"Pilot 11","Pilot 11: bigger feedback + video + socially anxious",8,"high",4
"SUPPRF03254",48,69,32,96,16,25,80,43,"Pilot 11","Pilot 11: bigger feedback + video + socially anxious",8,"high",53
"SUPPRF03421",1,63,0,49,12,82,37,40,"Pilot 8","Pilot 8: max feedback + text",0,"low",9
"SUPPRF03421",2,59,2,58,12,67,46,49,"Pilot 8","Pilot 8: max feedback + text",0,"low",9
"SUPPRF03421",3,47,1,55,1,34,54,53,"Pilot 8","Pilot 8: max feedback + text",0,"low",2
"SUPPRF03421",4,65,1,71,0,44,71,63,"Pilot 8","Pilot 8: max feedback + text",0,"low",8
"SUPPRF03421",5,53,1,83,12,51,71,72,"Pilot 8","Pilot 8: max feedback + text",0,"low",11
"SUPPRF03421",6,46,1,67,-13,24,80,71,"Pilot 8","Pilot 8: max feedback + text",0,"low",-4
"SUPPRF03421",7,13,1,6,-14,54,20,33,"Pilot 8","Pilot 8: max feedback + text",0,"low",-27
"SUPPRF03421",8,38,1,20,0,76,20,17,"Pilot 8","Pilot 8: max feedback + text",0,"low",3
"SUPPRF03421",9,52,1,35,15,64,20,12,"Pilot 8","Pilot 8: max feedback + text",0,"low",23
"SUPPRF03421",10,56,1,54,0,61,54,36,"Pilot 8","Pilot 8: max feedback + text",0,"low",18
"SUPPRF03421",11,81,2,88,25,62,63,26,"Pilot 8","Pilot 8: max feedback + text",0,"low",62
"SUPPRF03421",12,35,3,15,-14,62,29,32,"Pilot 8","Pilot 8: max feedback + text",0,"low",-17
"SUPPRF03421",13,78,1,34,-12,81,46,43,"Pilot 8","Pilot 8: max feedback + text",0,"low",-9
"SUPPRF03421",14,49,0,33,-13,50,46,36,"Pilot 8","Pilot 8: max feedback + text",0,"low",-3
"SUPPRF03421",15,34,3,55,-16,70,71,71,"Pilot 8","Pilot 8: max feedback + text",0,"low",-16
"SUPPRF03421",16,49,8,38,1,32,37,35,"Pilot 8","Pilot 8: max feedback + text",0,"low",3
"SUPPRF03421",17,27,1,16,-13,77,29,35,"Pilot 8","Pilot 8: max feedback + text",0,"low",-19
"SUPPRF03421",18,98,1,100,20,70,80,72,"Pilot 8","Pilot 8: max feedback + text",0,"low",28
"SUPPRF03421",19,51,0,66,12,43,54,48,"Pilot 8","Pilot 8: max feedback + text",0,"low",18
"SUPPRF03421",20,55,1,19,-1,93,20,15,"Pilot 8","Pilot 8: max feedback + text",0,"low",4
"SUPPRF03421",21,50,1,45,-1,28,46,24,"Pilot 8","Pilot 8: max feedback + text",0,"low",21
"SUPPRF03421",22,61,3,46,0,87,46,52,"Pilot 8","Pilot 8: max feedback + text",0,"low",-6
"SUPPRF03421",23,50,1,70,-1,63,71,55,"Pilot 8","Pilot 8: max feedback + text",0,"low",15
"SUPPRF03421",24,52,1,29,0,92,29,25,"Pilot 8","Pilot 8: max feedback + text",0,"low",4
"SUPPRF03421",25,65,0,77,14,78,63,53,"Pilot 8","Pilot 8: max feedback + text",0,"low",24
"SUPPRF03421",26,53,2,61,24,85,37,36,"Pilot 8","Pilot 8: max feedback + text",0,"low",25
"SUPPRF03421",27,88,52,75,29,14,46,33,"Pilot 8","Pilot 8: max feedback + text",0,"low",42
"SUPPRF03421",28,51,0,47,-16,81,63,57,"Pilot 8","Pilot 8: max feedback + text",0,"low",-10
"SUPPRF03421",29,68,2,80,0,88,80,76,"Pilot 8","Pilot 8: max feedback + text",0,"low",4
"SUPPRF03421",30,72,2,58,29,94,29,21,"Pilot 8","Pilot 8: max feedback + text",0,"low",37
"SUPPRF03421",31,35,0,28,-1,44,29,38,"Pilot 8","Pilot 8: max feedback + text",0,"low",-10
"SUPPRF03421",32,50,2,38,-16,58,54,52,"Pilot 8","Pilot 8: max feedback + text",0,"low",-14
"SUPPRF03421",33,73,1,46,17,68,29,18,"Pilot 8","Pilot 8: max feedback + text",0,"low",28
"SUPPRF03421",34,43,3,56,-15,64,71,68,"Pilot 8","Pilot 8: max feedback + text",0,"low",-12
"SUPPRF03421",35,64,2,50,-13,64,63,52,"Pilot 8","Pilot 8: max feedback + text",0,"low",-2
"SUPPRF03421",36,8,0,22,-15,73,37,47,"Pilot 8","Pilot 8: max feedback + text",0,"low",-25
"SUPPRF03421",37,52,0,63,0,26,63,83,"Pilot 8","Pilot 8: max feedback + text",0,"low",-20
"SUPPRF03421",38,17,2,8,-12,85,20,28,"Pilot 8","Pilot 8: max feedback + text",0,"low",-20
"SUPPRF03421",39,35,6,37,0,83,37,22,"Pilot 8","Pilot 8: max feedback + text",0,"low",15
"SUPPRF03421",40,46,1,78,24,59,54,38,"Pilot 8","Pilot 8: max feedback + text",0,"low",40
"SUPPRF03421",41,35,1,24,-13,70,37,32,"Pilot 8","Pilot 8: max feedback + text",0,"low",-8
"SUPPRF03421",42,42,4,81,1,78,80,64,"Pilot 8","Pilot 8: max feedback + text",0,"low",17
"SUPPRF03421",43,39,4,94,23,58,71,74,"Pilot 8","Pilot 8: max feedback + text",0,"low",20
"SUPPRF03421",44,39,0,41,-13,69,54,60,"Pilot 8","Pilot 8: max feedback + text",0,"low",-19
"SUPPRF03421",45,28,3,68,-12,73,80,36,"Pilot 8","Pilot 8: max feedback + text",0,"low",32
"SUPPRF03421",46,49,3,62,-1,82,63,64,"Pilot 8","Pilot 8: max feedback + text",0,"low",-2
"SUPPRF03421",47,52,3,47,27,87,20,15,"Pilot 8","Pilot 8: max feedback + text",0,"low",32
"SUPPRF03421",48,58,0,96,16,78,80,75,"Pilot 8","Pilot 8: max feedback + text",0,"low",21
"SUPPRF04190",1,51,38,75,29,72,46,44,"Pilot 9","Pilot 9: bigger feedback + text",12,"high",31
"SUPPRF04190",2,73,25,81,1,85,80,88,"Pilot 9","Pilot 9: bigger feedback + text",12,"high",-7
"SUPPRF04190",3,40,41,35,15,58,20,10,"Pilot 9","Pilot 9: bigger feedback + text",12,"high",25
"SUPPRF04190",4,58,65,96,16,75,80,93,"Pilot 9","Pilot 9: bigger feedback + text",12,"high",3
"SUPPRF04190",5,52,37,50,-13,62,63,69,"Pilot 9","Pilot 9: bigger feedback + text",12,"high",-19
"SUPPRF04190",6,53,51,70,-1,74,71,76,"Pilot 9","Pilot 9: bigger feedback + text",12,"high",-6
"SUPPRF04190",7,53,50,6,-14,54,20,16,"Pilot 9","Pilot 9: bigger feedback + text",12,"high",-10
"SUPPRF04190",8,48,50,19,-1,63,20,17,"Pilot 9","Pilot 9: bigger feedback + text",12,"high",2
"SUPPRF04190",9,51,50,56,-15,10,71,43,"Pilot 9","Pilot 9: bigger feedback + text",12,"high",13
"SUPPRF04190",10,51,49,29,0,39,29,54,"Pilot 9","Pilot 9: bigger feedback + text",12,"high",-25
"SUPPRF04190",11,48,48,16,-13,47,29,27,"Pilot 9","Pilot 9: bigger feedback + text",12,"high",-11
"SUPPRF04190",12,47,51,24,-13,50,37,32,"Pilot 9","Pilot 9: bigger feedback + text",12,"high",-8
"SUPPRF04190",13,50,48,66,12,65,54,42,"Pilot 9","Pilot 9: bigger feedback + text",12,"high",24
"SUPPRF04190",14,38,59,71,0,45,71,21,"Pilot 9","Pilot 9: bigger feedback + text",12,"high",50
"SUPPRF04190",15,48,50,46,17,56,29,41,"Pilot 9","Pilot 9: bigger feedback + text",12,"high",5
"SUPPRF04190",16,47,49,20,0,36,20,26,"Pilot 9","Pilot 9: bigger feedback + text",12,"high",-6
"SUPPRF04190",17,52,50,61,24,45,37,41,"Pilot 9","Pilot 9: bigger feedback + text",12,"high",20
"SUPPRF04190",18,48,49,83,12,54,71,54,"Pilot 9","Pilot 9: bigger feedback + text",12,"high",29
"SUPPRF04190",19,52,52,41,-13,63,54,61,"Pilot 9","Pilot 9: bigger feedback + text",12,"high",-20
"SUPPRF04190",20,61,43,100,20,26,80,64,"Pilot 9","Pilot 9: bigger feedback + text",12,"high",36
"SUPPRF04190",21,53,52,67,-13,73,80,100,"Pilot 9","Pilot 9: bigger feedback + text",12,"high",-33
"SUPPRF04190",22,52,50,88,25,13,63,49,"Pilot 9","Pilot 9: bigger feedback + text",12,"high",39
"SUPPRF04190",23,51,50,55,-16,64,71,47,"Pilot 9","Pilot 9: bigger feedback + text",12,"high",8
"SUPPRF04190",24,51,51,38,1,51,37,48,"Pilot 9","Pilot 9: bigger feedback + text",12,"high",-10
"SUPPRF04190",25,51,51,58,29,62,29,38,"Pilot 9","Pilot 9: bigger feedback + text",12,"high",20
"SUPPRF04190",26,54,49,49,12,48,37,49,"Pilot 9","Pilot 9: bigger feedback + text",12,"high",0
"SUPPRF04190",27,51,51,8,-12,38,20,38,"Pilot 9","Pilot 9: bigger feedback + text",12,"high",-30
"SUPPRF04190",28,50,51,62,-1,5,63,41,"Pilot 9","Pilot 9: bigger feedback + text",12,"high",21
"SUPPRF04190",29,48,51,78,24,81,54,41,"Pilot 9","Pilot 9: bigger feedback + text",12,"high",37
"SUPPRF04190",30,52,52,46,0,48,46,43,"Pilot 9","Pilot 9: bigger feedback + text",12,"high",3
"SUPPRF04190",31,51,50,58,12,74,46,53,"Pilot 9","Pilot 9: bigger feedback + text",12,"high",5
"SUPPRF04190",32,50,50,22,-15,21,37,32,"Pilot 9","Pilot 9: bigger feedback + text",12,"high",-10
"SUPPRF04190",33,52,51,94,23,67,71,67,"Pilot 9","Pilot 9: bigger feedback + text",12,"high",27
"SUPPRF04190",34,48,48,33,-13,49,46,49,"Pilot 9","Pilot 9: bigger feedback + text",12,"high",-16
"SUPPRF04190",35,51,48,54,0,11,54,46,"Pilot 9","Pilot 9: bigger feedback + text",12,"high",8
"SUPPRF04190",36,46,48,28,-1,9,29,36,"Pilot 9","Pilot 9: bigger feedback + text",12,"high",-8
"SUPPRF04190",37,51,48,55,1,10,54,58,"Pilot 9","Pilot 9: bigger feedback + text",12,"high",-3
"SUPPRF04190",38,51,51,37,0,21,37,47,"Pilot 9","Pilot 9: bigger feedback + text",12,"high",-10
"SUPPRF04190",39,50,51,63,0,51,63,51,"Pilot 9","Pilot 9: bigger feedback + text",12,"high",12
"SUPPRF04190",40,50,47,47,-16,49,63,35,"Pilot 9","Pilot 9: bigger feedback + text",12,"high",12
"SUPPRF04190",41,53,51,34,-12,65,46,40,"Pilot 9","Pilot 9: bigger feedback + text",12,"high",-6
"SUPPRF04190",42,58,57,80,0,35,80,65,"Pilot 9","Pilot 9: bigger feedback + text",12,"high",15
"SUPPRF04190",43,49,48,47,27,49,20,43,"Pilot 9","Pilot 9: bigger feedback + text",12,"high",4
"SUPPRF04190",44,48,49,77,14,20,63,7,"Pilot 9","Pilot 9: bigger feedback + text",12,"high",70
"SUPPRF04190",45,51,52,38,-16,82,54,70,"Pilot 9","Pilot 9: bigger feedback + text",12,"high",-32
"SUPPRF04190",46,50,50,68,-12,52,80,52,"Pilot 9","Pilot 9: bigger feedback + text",12,"high",16
"SUPPRF04190",47,51,49,45,-1,77,46,65,"Pilot 9","Pilot 9: bigger feedback + text",12,"high",-20
"SUPPRF04190",48,50,50,15,-14,48,29,41,"Pilot 9","Pilot 9: bigger feedback + text",12,"high",-26
"SUPPRF05688",1,63,61,78,15,45,63,70,"Pilot 7","Pilot 7: bigger feedback + text",7,"high",8
"SUPPRF05688",2,51,40,68,-12,41,80,87,"Pilot 7","Pilot 7: bigger feedback + text",7,"high",-19
"SUPPRF05688",3,31,34,28,-1,41,29,72,"Pilot 7","Pilot 7: bigger feedback + text",7,"high",-44
"SUPPRF05688",4,54,31,81,1,76,80,61,"Pilot 7","Pilot 7: bigger feedback + text",7,"high",20
"SUPPRF05688",5,75,15,84,13,49,71,33,"Pilot 7","Pilot 7: bigger feedback + text",7,"high",51
"SUPPRF05688",6,18,43,38,1,15,37,62,"Pilot 7","Pilot 7: bigger feedback + text",7,"high",-24
"SUPPRF05688",7,60,41,62,-1,100,63,3,"Pilot 7","Pilot 7: bigger feedback + text",7,"high",59
"SUPPRF05688",8,12,41,6,-14,45,20,44,"Pilot 7","Pilot 7: bigger feedback + text",7,"high",-38
"SUPPRF05688",9,82,0,97,17,32,80,56,"Pilot 7","Pilot 7: bigger feedback + text",7,"high",41
"SUPPRF05688",10,74,0,56,-15,24,71,28,"Pilot 7","Pilot 7: bigger feedback + text",7,"high",28
"SUPPRF05688",11,51,23,49,12,56,37,19,"Pilot 7","Pilot 7: bigger feedback + text",7,"high",30
"SUPPRF05688",12,29,63,16,-13,38,29,68,"Pilot 7","Pilot 7: bigger feedback + text",7,"high",-52
"SUPPRF05688",13,11,35,41,-13,33,54,36,"Pilot 7","Pilot 7: bigger feedback + text",7,"high",5
"SUPPRF05688",14,62,16,63,0,47,63,51,"Pilot 7","Pilot 7: bigger feedback + text",7,"high",12
"SUPPRF05688",15,50,33,38,-16,27,54,62,"Pilot 7","Pilot 7: bigger feedback + text",7,"high",-24
"SUPPRF05688",16,72,9,58,12,29,46,51,"Pilot 7","Pilot 7: bigger feedback + text",7,"high",7
"SUPPRF05688",17,94,9,71,0,83,71,7,"Pilot 7","Pilot 7: bigger feedback + text",7,"high",64
"SUPPRF05688",18,74,0,70,-1,34,71,43,"Pilot 7","Pilot 7: bigger feedback + text",7,"high",27
"SUPPRF05688",19,67,11,66,12,35,54,19,"Pilot 7","Pilot 7: bigger feedback + text",7,"high",47
"SUPPRF05688",20,77,16,46,0,43,46,67,"Pilot 7","Pilot 7: bigger feedback + text",7,"high",-21
"SUPPRF05688",21,77,18,68,14,35,54,27,"Pilot 7","Pilot 7: bigger feedback + text",7,"high",41
"SUPPRF05688",22,69,0,45,-1,59,46,39,"Pilot 7","Pilot 7: bigger feedback + text",7,"high",6
"SUPPRF05688",23,77,7,8,-12,51,20,10,"Pilot 7","Pilot 7: bigger feedback + text",7,"high",-2
"SUPPRF05688",24,79,6,80,0,38,80,56,"Pilot 7","Pilot 7: bigger feedback + text",7,"high",24
"SUPPRF05688",25,84,18,24,-13,33,37,21,"Pilot 7","Pilot 7: bigger feedback + text",7,"high",3
"SUPPRF05688",26,98,0,96,16,64,80,63,"Pilot 7","Pilot 7: bigger feedback + text",7,"high",33
"SUPPRF05688",27,97,47,50,-13,98,63,0,"Pilot 7","Pilot 7: bigger feedback + text",7,"high",50
"SUPPRF05688",28,66,27,19,-1,65,20,55,"Pilot 7","Pilot 7: bigger feedback + text",7,"high",-36
"SUPPRF05688",29,66,16,83,12,64,71,63,"Pilot 7","Pilot 7: bigger feedback + text",7,"high",20
"SUPPRF05688",30,81,13,55,1,68,54,50,"Pilot 7","Pilot 7: bigger feedback + text",7,"high",5
"SUPPRF05688",31,90,12,54,0,80,54,45,"Pilot 7","Pilot 7: bigger feedback + text",7,"high",9
"SUPPRF05688",32,87,9,37,17,92,20,6,"Pilot 7","Pilot 7: bigger feedback + text",7,"high",31
"SUPPRF05688",33,51,30,33,-13,16,46,48,"Pilot 7","Pilot 7: bigger feedback + text",7,"high",-15
"SUPPRF05688",34,64,32,15,-14,64,29,36,"Pilot 7","Pilot 7: bigger feedback + text",7,"high",-21
"SUPPRF05688",35,61,18,55,-16,60,71,55,"Pilot 7","Pilot 7: bigger feedback + text",7,"high",0
"SUPPRF05688",36,74,25,67,-13,39,80,58,"Pilot 7","Pilot 7: bigger feedback + text",7,"high",9
"SUPPRF05688",37,47,33,34,-12,71,46,60,"Pilot 7","Pilot 7: bigger feedback + text",7,"high",-26
"SUPPRF05688",38,70,23,77,14,59,63,62,"Pilot 7","Pilot 7: bigger feedback + text",7,"high",15
"SUPPRF05688",39,54,39,47,-16,31,63,41,"Pilot 7","Pilot 7: bigger feedback + text",7,"high",6
"SUPPRF05688",40,67,28,37,0,66,37,36,"Pilot 7","Pilot 7: bigger feedback + text",7,"high",1
"SUPPRF05688",41,56,31,46,17,62,29,8,"Pilot 7","Pilot 7: bigger feedback + text",7,"high",38
"SUPPRF05688",42,60,29,29,0,67,29,16,"Pilot 7","Pilot 7: bigger feedback + text",7,"high",13
"SUPPRF05688",43,70,24,20,0,70,20,20,"Pilot 7","Pilot 7: bigger feedback + text",7,"high",0
"SUPPRF05688",44,71,17,65,19,37,46,49,"Pilot 7","Pilot 7: bigger feedback + text",7,"high",16
"SUPPRF05688",45,71,26,35,15,69,20,14,"Pilot 7","Pilot 7: bigger feedback + text",7,"high",21
"SUPPRF05688",46,66,32,51,14,71,37,33,"Pilot 7","Pilot 7: bigger feedback + text",7,"high",18
"SUPPRF05688",47,69,41,22,-15,62,37,58,"Pilot 7","Pilot 7: bigger feedback + text",7,"high",-36
"SUPPRF05688",48,64,32,48,19,78,29,55,"Pilot 7","Pilot 7: bigger feedback + text",7,"high",-7
"SUPPRF06127",1,91,9,81,1,80,80,92,"Pilot 11","Pilot 11: bigger feedback + video + socially anxious",6,"high",-11
"SUPPRF06127",2,81,10,15,-14,81,29,25,"Pilot 11","Pilot 11: bigger feedback + video + socially anxious",6,"high",-10
"SUPPRF06127",3,84,10,41,-13,72,54,70,"Pilot 11","Pilot 11: bigger feedback + video + socially anxious",6,"high",-29
"SUPPRF06127",4,92,8,34,-12,72,46,33,"Pilot 11","Pilot 11: bigger feedback + video + socially anxious",6,"high",1
"SUPPRF06127",5,93,8,38,1,81,37,33,"Pilot 11","Pilot 11: bigger feedback + video + socially anxious",6,"high",5
"SUPPRF06127",6,89,8,71,0,71,71,73,"Pilot 11","Pilot 11: bigger feedback + video + socially anxious",6,"high",-2
"SUPPRF06127",7,92,7,80,0,74,80,85,"Pilot 11","Pilot 11: bigger feedback + video + socially anxious",6,"high",-5
"SUPPRF06127",8,91,11,50,-13,53,63,29,"Pilot 11","Pilot 11: bigger feedback + video + socially anxious",6,"high",21
"SUPPRF06127",9,91,6,70,-1,46,71,67,"Pilot 11","Pilot 11: bigger feedback + video + socially anxious",6,"high",3
"SUPPRF06127",10,89,8,38,-16,48,54,67,"Pilot 11","Pilot 11: bigger feedback + video + socially anxious",6,"high",-29
"SUPPRF06127",11,93,4,83,12,50,71,43,"Pilot 11","Pilot 11: bigger feedback + video + socially anxious",6,"high",40
"SUPPRF06127",12,92,6,66,12,21,54,26,"Pilot 11","Pilot 11: bigger feedback + video + socially anxious",6,"high",40
"SUPPRF06127",13,95,5,37,0,42,37,32,"Pilot 11","Pilot 11: bigger feedback + video + socially anxious",6,"high",5
"SUPPRF06127",14,93,4,47,-16,48,63,60,"Pilot 11","Pilot 11: bigger feedback + video + socially anxious",6,"high",-13
"SUPPRF06127",15,91,4,16,-13,77,29,55,"Pilot 11","Pilot 11: bigger feedback + video + socially anxious",6,"high",-39
"SUPPRF06127",16,90,4,45,-1,62,46,36,"Pilot 11","Pilot 11: bigger feedback + video + socially anxious",6,"high",9
"SUPPRF06127",17,89,8,56,-15,66,71,60,"Pilot 11","Pilot 11: bigger feedback + video + socially anxious",6,"high",-4
"SUPPRF06127",18,94,8,68,-12,84,80,79,"Pilot 11","Pilot 11: bigger feedback + video + socially anxious",6,"high",-11
"SUPPRF06127",19,90,5,46,0,44,46,47,"Pilot 11","Pilot 11: bigger feedback + video + socially anxious",6,"high",-1
"SUPPRF06127",20,96,7,24,-13,18,37,20,"Pilot 11","Pilot 11: bigger feedback + video + socially anxious",6,"high",4
"SUPPRF06127",21,90,6,33,-13,76,46,29,"Pilot 11","Pilot 11: bigger feedback + video + socially anxious",6,"high",4
"SUPPRF06127",22,96,3,94,23,66,71,61,"Pilot 11","Pilot 11: bigger feedback + video + socially anxious",6,"high",33
"SUPPRF06127",23,97,6,8,-12,75,20,17,"Pilot 11","Pilot 11: bigger feedback + video + socially anxious",6,"high",-9
"SUPPRF06127",24,95,2,28,-1,90,29,8,"Pilot 11","Pilot 11: bigger feedback + video + socially anxious",6,"high",20
"SUPPRF06127",25,96,3,46,17,68,29,30,"Pilot 11","Pilot 11: bigger feedback + video + socially anxious",6,"high",16
"SUPPRF06127",26,95,4,78,24,76,54,60,"Pilot 11","Pilot 11: bigger feedback + video + socially anxious",6,"high",18
"SUPPRF06127",27,96,2,49,12,76,37,26,"Pilot 11","Pilot 11: bigger feedback + video + socially anxious",6,"high",23
"SUPPRF06127",28,95,7,77,14,40,63,46,"Pilot 11","Pilot 11: bigger feedback + video + socially anxious",6,"high",31
"SUPPRF06127",29,95,5,20,0,82,20,20,"Pilot 11","Pilot 11: bigger feedback + video + socially anxious",6,"high",0
"SUPPRF06127",30,94,6,58,29,45,29,24,"Pilot 11","Pilot 11: bigger feedback + video + socially anxious",6,"high",34
"SUPPRF06127",31,96,4,19,-1,76,20,34,"Pilot 11","Pilot 11: bigger feedback + video + socially anxious",6,"high",-15
"SUPPRF06127",32,95,5,61,24,74,37,28,"Pilot 11","Pilot 11: bigger feedback + video + socially anxious",6,"high",33
"SUPPRF06127",33,93,4,58,12,24,46,34,"Pilot 11","Pilot 11: bigger feedback + video + socially anxious",6,"high",24
"SUPPRF06127",34,96,5,96,16,86,80,83,"Pilot 11","Pilot 11: bigger feedback + video + socially anxious",6,"high",13
"SUPPRF06127",35,96,5,55,-16,73,71,74,"Pilot 11","Pilot 11: bigger feedback + video + socially anxious",6,"high",-19
"SUPPRF06127",36,95,2,22,-15,51,37,43,"Pilot 11","Pilot 11: bigger feedback + video + socially anxious",6,"high",-21
"SUPPRF06127",37,96,4,88,25,16,63,26,"Pilot 11","Pilot 11: bigger feedback + video + socially anxious",6,"high",62
"SUPPRF06127",38,96,5,47,27,79,20,20,"Pilot 11","Pilot 11: bigger feedback + video + socially anxious",6,"high",27
"SUPPRF06127",39,94,4,35,15,74,20,30,"Pilot 11","Pilot 11: bigger feedback + video + socially anxious",6,"high",5
"SUPPRF06127",40,89,7,55,1,74,54,70,"Pilot 11","Pilot 11: bigger feedback + video + socially anxious",6,"high",-15
"SUPPRF06127",41,91,3,6,-14,38,20,27,"Pilot 11","Pilot 11: bigger feedback + video + socially anxious",6,"high",-21
"SUPPRF06127",42,94,13,63,0,65,63,59,"Pilot 11","Pilot 11: bigger feedback + video + socially anxious",6,"high",4
"SUPPRF06127",43,91,6,29,0,76,29,20,"Pilot 11","Pilot 11: bigger feedback + video + socially anxious",6,"high",9
"SUPPRF06127",44,95,6,100,20,84,80,74,"Pilot 11","Pilot 11: bigger feedback + video + socially anxious",6,"high",26
"SUPPRF06127",45,94,8,67,-13,79,80,80,"Pilot 11","Pilot 11: bigger feedback + video + socially anxious",6,"high",-13
"SUPPRF06127",46,93,8,75,29,77,46,60,"Pilot 11","Pilot 11: bigger feedback + video + socially anxious",6,"high",15
"SUPPRF06127",47,93,4,62,-1,74,63,58,"Pilot 11","Pilot 11: bigger feedback + video + socially anxious",6,"high",4
"SUPPRF06127",48,94,9,54,0,70,54,44,"Pilot 11","Pilot 11: bigger feedback + video + socially anxious",6,"high",10
"SUPPRF06248",1,55,58,67,-13,69,80,81,"Pilot 10","Pilot 10: bigger feedback + video",3,"low",-14
"SUPPRF06248",2,53,54,38,1,61,37,40,"Pilot 10","Pilot 10: bigger feedback + video",3,"low",-2
"SUPPRF06248",3,57,55,29,0,60,29,22,"Pilot 10","Pilot 10: bigger feedback + video",3,"low",7
"SUPPRF06248",4,59,52,58,29,63,29,35,"Pilot 10","Pilot 10: bigger feedback + video",3,"low",23
"SUPPRF06248",5,53,59,37,0,61,37,29,"Pilot 10","Pilot 10: bigger feedback + video",3,"low",8
"SUPPRF06248",6,54,53,45,-1,51,46,65,"Pilot 10","Pilot 10: bigger feedback + video",3,"low",-20
"SUPPRF06248",7,51,53,41,-13,50,54,44,"Pilot 10","Pilot 10: bigger feedback + video",3,"low",-3
"SUPPRF06248",8,57,50,81,1,50,80,40,"Pilot 10","Pilot 10: bigger feedback + video",3,"low",41
"SUPPRF06248",9,52,57,63,0,62,63,53,"Pilot 10","Pilot 10: bigger feedback + video",3,"low",10
"SUPPRF06248",10,51,50,47,-16,57,63,43,"Pilot 10","Pilot 10: bigger feedback + video",3,"low",4
"SUPPRF06248",11,50,48,50,-13,58,63,40,"Pilot 10","Pilot 10: bigger feedback + video",3,"low",10
"SUPPRF06248",12,54,48,46,0,56,46,50,"Pilot 10","Pilot 10: bigger feedback + video",3,"low",-4
"SUPPRF06248",13,47,49,46,17,53,29,26,"Pilot 10","Pilot 10: bigger feedback + video",3,"low",20
"SUPPRF06248",14,53,53,22,-15,64,37,50,"Pilot 10","Pilot 10: bigger feedback + video",3,"low",-28
"SUPPRF06248",15,44,57,49,12,47,37,37,"Pilot 10","Pilot 10: bigger feedback + video",3,"low",12
"SUPPRF06248",16,40,59,71,0,53,71,55,"Pilot 10","Pilot 10: bigger feedback + video",3,"low",16
"SUPPRF06248",17,48,58,55,1,52,54,35,"Pilot 10","Pilot 10: bigger feedback + video",3,"low",20
"SUPPRF06248",18,49,57,83,12,55,71,63,"Pilot 10","Pilot 10: bigger feedback + video",3,"low",20
"SUPPRF06248",19,44,56,55,-16,52,71,65,"Pilot 10","Pilot 10: bigger feedback + video",3,"low",-10
"SUPPRF06248",20,43,59,38,-16,49,54,65,"Pilot 10","Pilot 10: bigger feedback + video",3,"low",-27
"SUPPRF06248",21,44,64,75,29,47,46,55,"Pilot 10","Pilot 10: bigger feedback + video",3,"low",20
"SUPPRF06248",22,49,51,78,24,47,54,51,"Pilot 10","Pilot 10: bigger feedback + video",3,"low",27
"SUPPRF06248",23,45,57,100,20,44,80,40,"Pilot 10","Pilot 10: bigger feedback + video",3,"low",60
"SUPPRF06248",24,47,58,80,0,49,80,74,"Pilot 10","Pilot 10: bigger feedback + video",3,"low",6
"SUPPRF06248",25,48,51,24,-13,52,37,32,"Pilot 10","Pilot 10: bigger feedback + video",3,"low",-8
"SUPPRF06248",26,42,51,19,-1,41,20,32,"Pilot 10","Pilot 10: bigger feedback + video",3,"low",-13
"SUPPRF06248",27,44,50,62,-1,51,63,46,"Pilot 10","Pilot 10: bigger feedback + video",3,"low",16
"SUPPRF06248",28,42,59,94,23,55,71,64,"Pilot 10","Pilot 10: bigger feedback + video",3,"low",30
"SUPPRF06248",29,39,58,61,24,55,37,42,"Pilot 10","Pilot 10: bigger feedback + video",3,"low",19
"SUPPRF06248",30,44,55,96,16,48,80,52,"Pilot 10","Pilot 10: bigger feedback + video",3,"low",44
"SUPPRF06248",31,48,61,56,-15,52,71,64,"Pilot 10","Pilot 10: bigger feedback + video",3,"low",-8
"SUPPRF06248",32,36,58,34,-12,54,46,48,"Pilot 10","Pilot 10: bigger feedback + video",3,"low",-14
"SUPPRF06248",33,40,58,28,-1,47,29,22,"Pilot 10","Pilot 10: bigger feedback + video",3,"low",6
"SUPPRF06248",34,37,63,66,12,47,54,40,"Pilot 10","Pilot 10: bigger feedback + video",3,"low",26
"SUPPRF06248",35,41,62,6,-14,47,20,24,"Pilot 10","Pilot 10: bigger feedback + video",3,"low",-18
"SUPPRF06248",36,29,62,15,-14,50,29,17,"Pilot 10","Pilot 10: bigger feedback + video",3,"low",-2
"SUPPRF06248",37,26,60,88,25,48,63,40,"Pilot 10","Pilot 10: bigger feedback + video",3,"low",48
"SUPPRF06248",38,36,52,77,14,50,63,46,"Pilot 10","Pilot 10: bigger feedback + video",3,"low",31
"SUPPRF06248",39,32,58,20,0,48,20,15,"Pilot 10","Pilot 10: bigger feedback + video",3,"low",5
"SUPPRF06248",40,29,65,68,-12,70,80,10,"Pilot 10","Pilot 10: bigger feedback + video",3,"low",58
"SUPPRF06248",41,28,64,54,0,49,54,45,"Pilot 10","Pilot 10: bigger feedback + video",3,"low",9
"SUPPRF06248",42,25,65,33,-13,48,46,40,"Pilot 10","Pilot 10: bigger feedback + video",3,"low",-7
"SUPPRF06248",43,25,67,16,-13,34,29,20,"Pilot 10","Pilot 10: bigger feedback + video",3,"low",-4
"SUPPRF06248",44,17,65,47,27,55,20,12,"Pilot 10","Pilot 10: bigger feedback + video",3,"low",35
"SUPPRF06248",45,27,62,8,-12,49,20,21,"Pilot 10","Pilot 10: bigger feedback + video",3,"low",-13
"SUPPRF06248",46,27,63,35,15,46,20,10,"Pilot 10","Pilot 10: bigger feedback + video",3,"low",25
"SUPPRF06248",47,29,65,70,-1,50,71,46,"Pilot 10","Pilot 10: bigger feedback + video",3,"low",24
"SUPPRF06248",48,29,56,58,12,50,46,45,"Pilot 10","Pilot 10: bigger feedback + video",3,"low",13
"SUPPRF06342",1,39,73,24,-13,59,37,53,"Pilot 9","Pilot 9: bigger feedback + text",10,"high",-29
"SUPPRF06342",2,50,59,61,24,72,37,21,"Pilot 9","Pilot 9: bigger feedback + text",10,"high",40
"SUPPRF06342",3,28,66,16,-13,73,29,9,"Pilot 9","Pilot 9: bigger feedback + text",10,"high",7
"SUPPRF06342",4,58,69,100,20,66,80,70,"Pilot 9","Pilot 9: bigger feedback + text",10,"high",30
"SUPPRF06342",5,55,60,63,0,41,63,54,"Pilot 9","Pilot 9: bigger feedback + text",10,"high",9
"SUPPRF06342",6,49,56,56,-15,61,71,70,"Pilot 9","Pilot 9: bigger feedback + text",10,"high",-14
"SUPPRF06342",7,49,51,68,-12,63,80,43,"Pilot 9","Pilot 9: bigger feedback + text",10,"high",25
"SUPPRF06342",8,48,40,71,0,63,71,65,"Pilot 9","Pilot 9: bigger feedback + text",10,"high",6
"SUPPRF06342",9,45,46,54,0,59,54,59,"Pilot 9","Pilot 9: bigger feedback + text",10,"high",-5
"SUPPRF06342",10,49,47,62,-1,72,63,49,"Pilot 9","Pilot 9: bigger feedback + text",10,"high",13
"SUPPRF06342",11,41,55,45,-1,71,46,39,"Pilot 9","Pilot 9: bigger feedback + text",10,"high",6
"SUPPRF06342",12,51,54,58,12,59,46,31,"Pilot 9","Pilot 9: bigger feedback + text",10,"high",27
"SUPPRF06342",13,37,58,58,29,75,29,29,"Pilot 9","Pilot 9: bigger feedback + text",10,"high",29
"SUPPRF06342",14,43,49,83,12,62,71,60,"Pilot 9","Pilot 9: bigger feedback + text",10,"high",23
"SUPPRF06342",15,28,67,28,-1,36,29,53,"Pilot 9","Pilot 9: bigger feedback + text",10,"high",-25
"SUPPRF06342",16,33,66,38,-16,61,54,75,"Pilot 9","Pilot 9: bigger feedback + text",10,"high",-37
"SUPPRF06342",17,60,40,81,1,47,80,62,"Pilot 9","Pilot 9: bigger feedback + text",10,"high",19
"SUPPRF06342",18,41,56,41,-13,56,54,60,"Pilot 9","Pilot 9: bigger feedback + text",10,"high",-19
"SUPPRF06342",19,40,59,34,-12,66,46,28,"Pilot 9","Pilot 9: bigger feedback + text",10,"high",6
"SUPPRF06342",20,45,56,67,-13,37,80,38,"Pilot 9","Pilot 9: bigger feedback + text",10,"high",29
"SUPPRF06342",21,25,63,6,-14,58,20,25,"Pilot 9","Pilot 9: bigger feedback + text",10,"high",-19
"SUPPRF06342",22,46,70,80,0,71,80,29,"Pilot 9","Pilot 9: bigger feedback + text",10,"high",51
"SUPPRF06342",23,29,65,55,-16,61,71,31,"Pilot 9","Pilot 9: bigger feedback + text",10,"high",24
"SUPPRF06342",24,52,37,78,24,54,54,54,"Pilot 9","Pilot 9: bigger feedback + text",10,"high",24
"SUPPRF06342",25,57,30,46,0,55,46,35,"Pilot 9","Pilot 9: bigger feedback + text",10,"high",11
"SUPPRF06342",26,27,68,22,-15,60,37,75,"Pilot 9","Pilot 9: bigger feedback + text",10,"high",-53
"SUPPRF06342",27,36,65,33,-13,70,46,12,"Pilot 9","Pilot 9: bigger feedback + text",10,"high",21
"SUPPRF06342",28,17,37,8,-12,36,20,45,"Pilot 9","Pilot 9: bigger feedback + text",10,"high",-37
"SUPPRF06342",29,39,66,29,0,67,29,36,"Pilot 9","Pilot 9: bigger feedback + text",10,"high",-7
"SUPPRF06342",30,32,65,38,1,40,37,45,"Pilot 9","Pilot 9: bigger feedback + text",10,"high",-7
"SUPPRF06342",31,36,53,55,1,30,54,34,"Pilot 9","Pilot 9: bigger feedback + text",10,"high",21
"SUPPRF06342",32,48,61,47,-16,41,63,58,"Pilot 9","Pilot 9: bigger feedback + text",10,"high",-11
"SUPPRF06342",33,44,42,46,17,42,29,43,"Pilot 9","Pilot 9: bigger feedback + text",10,"high",3
"SUPPRF06342",34,43,46,20,0,62,20,20,"Pilot 9","Pilot 9: bigger feedback + text",10,"high",0
"SUPPRF06342",35,56,41,66,12,68,54,45,"Pilot 9","Pilot 9: bigger feedback + text",10,"high",21
"SUPPRF06342",36,55,41,88,25,58,63,21,"Pilot 9","Pilot 9: bigger feedback + text",10,"high",67
"SUPPRF06342",37,58,36,47,27,70,20,18,"Pilot 9","Pilot 9: bigger feedback + text",10,"high",29
"SUPPRF06342",38,64,27,96,16,66,80,32,"Pilot 9","Pilot 9: bigger feedback + text",10,"high",64
"SUPPRF06342",39,52,26,37,0,80,37,34,"Pilot 9","Pilot 9: bigger feedback + text",10,"high",3
"SUPPRF06342",40,55,25,77,14,80,63,64,"Pilot 9","Pilot 9: bigger feedback + text",10,"high",13
"SUPPRF06342",41,51,19,50,-13,82,63,72,"Pilot 9","Pilot 9: bigger feedback + text",10,"high",-22
"SUPPRF06342",42,45,35,19,-1,67,20,32,"Pilot 9","Pilot 9: bigger feedback + text",10,"high",-13
"SUPPRF06342",43,45,50,15,-14,67,29,28,"Pilot 9","Pilot 9: bigger feedback + text",10,"high",-13
"SUPPRF06342",44,51,63,49,12,52,37,19,"Pilot 9","Pilot 9: bigger feedback + text",10,"high",30
"SUPPRF06342",45,52,61,94,23,40,71,25,"Pilot 9","Pilot 9: bigger feedback + text",10,"high",69
"SUPPRF06342",46,49,55,35,15,38,20,45,"Pilot 9","Pilot 9: bigger feedback + text",10,"high",-10
"SUPPRF06342",47,52,56,70,-1,59,71,36,"Pilot 9","Pilot 9: bigger feedback + text",10,"high",34
"SUPPRF06342",48,48,46,75,29,58,46,53,"Pilot 9","Pilot 9: bigger feedback + text",10,"high",22
"SUPPRF06488",1,79,17,48,19,79,29,29,"Pilot 7","Pilot 7: bigger feedback + text",9,"high",19
"SUPPRF06488",2,83,14,34,-12,81,46,29,"Pilot 7","Pilot 7: bigger feedback + text",9,"high",5
"SUPPRF06488",3,47,27,20,0,92,20,41,"Pilot 7","Pilot 7: bigger feedback + text",9,"high",-21
"SUPPRF06488",4,45,27,8,-12,97,20,21,"Pilot 7","Pilot 7: bigger feedback + text",9,"high",-13
"SUPPRF06488",5,58,27,37,17,99,20,13,"Pilot 7","Pilot 7: bigger feedback + text",9,"high",24
"SUPPRF06488",6,72,16,77,14,84,63,62,"Pilot 7","Pilot 7: bigger feedback + text",9,"high",15
"SUPPRF06488",7,85,19,78,15,83,63,82,"Pilot 7","Pilot 7: bigger feedback + text",9,"high",-4
"SUPPRF06488",8,80,20,56,-15,90,71,68,"Pilot 7","Pilot 7: bigger feedback + text",9,"high",-12
"SUPPRF06488",9,47,23,41,-13,77,54,59,"Pilot 7","Pilot 7: bigger feedback + text",9,"high",-18
"SUPPRF06488",10,75,22,84,13,55,71,57,"Pilot 7","Pilot 7: bigger feedback + text",9,"high",27
"SUPPRF06488",11,76,27,45,-1,87,46,49,"Pilot 7","Pilot 7: bigger feedback + text",9,"high",-4
"SUPPRF06488",12,92,13,71,0,88,71,68,"Pilot 7","Pilot 7: bigger feedback + text",9,"high",3
"SUPPRF06488",13,76,25,38,1,82,37,44,"Pilot 7","Pilot 7: bigger feedback + text",9,"high",-6
"SUPPRF06488",14,97,13,97,17,99,80,84,"Pilot 7","Pilot 7: bigger feedback + text",9,"high",13
"SUPPRF06488",15,65,12,19,-1,99,20,9,"Pilot 7","Pilot 7: bigger feedback + text",9,"high",10
"SUPPRF06488",16,82,14,51,14,83,37,36,"Pilot 7","Pilot 7: bigger feedback + text",9,"high",15
"SUPPRF06488",17,42,29,22,-15,96,37,42,"Pilot 7","Pilot 7: bigger feedback + text",9,"high",-20
"SUPPRF06488",18,63,20,33,-13,90,46,32,"Pilot 7","Pilot 7: bigger feedback + text",9,"high",1
"SUPPRF06488",19,59,40,6,-14,91,20,15,"Pilot 7","Pilot 7: bigger feedback + text",9,"high",-9
"SUPPRF06488",20,45,53,67,-13,96,80,82,"Pilot 7","Pilot 7: bigger feedback + text",9,"high",-15
"SUPPRF06488",21,66,34,55,1,77,54,50,"Pilot 7","Pilot 7: bigger feedback + text",9,"high",5
"SUPPRF06488",22,77,16,62,-1,71,63,59,"Pilot 7","Pilot 7: bigger feedback + text",9,"high",3
"SUPPRF06488",23,87,20,96,16,35,80,68,"Pilot 7","Pilot 7: bigger feedback + text",9,"high",28
"SUPPRF06488",24,73,20,58,12,62,46,48,"Pilot 7","Pilot 7: bigger feedback + text",9,"high",10
"SUPPRF06488",25,69,31,68,14,87,54,54,"Pilot 7","Pilot 7: bigger feedback + text",9,"high",14
"SUPPRF06488",26,33,61,24,-13,74,37,48,"Pilot 7","Pilot 7: bigger feedback + text",9,"high",-24
"SUPPRF06488",27,74,33,35,15,86,20,11,"Pilot 7","Pilot 7: bigger feedback + text",9,"high",24
"SUPPRF06488",28,81,16,46,0,80,46,44,"Pilot 7","Pilot 7: bigger feedback + text",9,"high",2
"SUPPRF06488",29,67,33,28,-1,47,29,20,"Pilot 7","Pilot 7: bigger feedback + text",9,"high",8
"SUPPRF06488",30,69,22,37,0,58,37,40,"Pilot 7","Pilot 7: bigger feedback + text",9,"high",-3
"SUPPRF06488",31,85,10,49,12,87,37,33,"Pilot 7","Pilot 7: bigger feedback + text",9,"high",16
"SUPPRF06488",32,75,21,29,0,80,29,34,"Pilot 7","Pilot 7: bigger feedback + text",9,"high",-5
"SUPPRF06488",33,89,12,46,17,76,29,24,"Pilot 7","Pilot 7: bigger feedback + text",9,"high",22
"SUPPRF06488",34,37,56,47,-16,77,63,64,"Pilot 7","Pilot 7: bigger feedback + text",9,"high",-17
"SUPPRF06488",35,65,33,68,-12,54,80,73,"Pilot 7","Pilot 7: bigger feedback + text",9,"high",-5
"SUPPRF06488",36,81,19,81,1,50,80,76,"Pilot 7","Pilot 7: bigger feedback + text",9,"high",5
"SUPPRF06488",37,77,23,70,-1,76,71,73,"Pilot 7","Pilot 7: bigger feedback + text",9,"high",-3
"SUPPRF06488",38,33,57,16,-13,84,29,23,"Pilot 7","Pilot 7: bigger feedback + text",9,"high",-7
"SUPPRF06488",39,33,66,50,-13,69,63,65,"Pilot 7","Pilot 7: bigger feedback + text",9,"high",-15
"SUPPRF06488",40,74,23,80,0,49,80,72,"Pilot 7","Pilot 7: bigger feedback + text",9,"high",8
"SUPPRF06488",41,82,15,54,0,89,54,47,"Pilot 7","Pilot 7: bigger feedback + text",9,"high",7
"SUPPRF06488",42,82,21,83,12,74,71,68,"Pilot 7","Pilot 7: bigger feedback + text",9,"high",15
"SUPPRF06488",43,79,15,66,12,74,54,49,"Pilot 7","Pilot 7: bigger feedback + text",9,"high",17
"SUPPRF06488",44,64,27,63,0,93,63,71,"Pilot 7","Pilot 7: bigger feedback + text",9,"high",-8
"SUPPRF06488",45,64,23,65,19,41,46,55,"Pilot 7","Pilot 7: bigger feedback + text",9,"high",10
"SUPPRF06488",46,26,67,38,-16,69,54,58,"Pilot 7","Pilot 7: bigger feedback + text",9,"high",-20
"SUPPRF06488",47,48,25,15,-14,69,29,16,"Pilot 7","Pilot 7: bigger feedback + text",9,"high",-1
"SUPPRF06488",48,30,63,55,-16,90,71,75,"Pilot 7","Pilot 7: bigger feedback + text",9,"high",-20
"SUPPRF06979",1,46,28,24,-13,46,37,25,"Pilot 7","Pilot 7: bigger feedback + text",8,"high",-1
"SUPPRF06979",2,59,22,47,-16,81,63,65,"Pilot 7","Pilot 7: bigger feedback + text",8,"high",-18
"SUPPRF06979",3,52,27,77,14,53,63,62,"Pilot 7","Pilot 7: bigger feedback + text",8,"high",15
"SUPPRF06979",4,65,37,46,17,62,29,18,"Pilot 7","Pilot 7: bigger feedback + text",8,"high",28
"SUPPRF06979",5,54,25,56,-15,62,71,73,"Pilot 7","Pilot 7: bigger feedback + text",8,"high",-17
"SUPPRF06979",6,68,27,62,-1,84,63,67,"Pilot 7","Pilot 7: bigger feedback + text",8,"high",-5
"SUPPRF06979",7,63,18,19,-1,30,20,53,"Pilot 7","Pilot 7: bigger feedback + text",8,"high",-34
"SUPPRF06979",8,59,19,15,-14,69,29,32,"Pilot 7","Pilot 7: bigger feedback + text",8,"high",-17
"SUPPRF06979",9,62,16,70,-1,48,71,73,"Pilot 7","Pilot 7: bigger feedback + text",8,"high",-3
"SUPPRF06979",10,66,16,84,13,62,71,68,"Pilot 7","Pilot 7: bigger feedback + text",8,"high",16
"SUPPRF06979",11,69,10,37,17,39,20,23,"Pilot 7","Pilot 7: bigger feedback + text",8,"high",14
"SUPPRF06979",12,64,20,34,-12,67,46,55,"Pilot 7","Pilot 7: bigger feedback + text",8,"high",-21
"SUPPRF06979",13,65,19,29,0,51,29,23,"Pilot 7","Pilot 7: bigger feedback + text",8,"high",6
"SUPPRF06979",14,64,17,50,-13,67,63,63,"Pilot 7","Pilot 7: bigger feedback + text",8,"high",-13
"SUPPRF06979",15,55,17,22,-15,23,37,39,"Pilot 7","Pilot 7: bigger feedback + text",8,"high",-17
"SUPPRF06979",16,54,10,38,-16,65,54,48,"Pilot 7","Pilot 7: bigger feedback + text",8,"high",-10
"SUPPRF06979",17,65,21,63,0,55,63,52,"Pilot 7","Pilot 7: bigger feedback + text",8,"high",11
"SUPPRF06979",18,69,14,83,12,64,71,66,"Pilot 7","Pilot 7: bigger feedback + text",8,"high",17
"SUPPRF06979",19,60,18,35,15,60,20,27,"Pilot 7","Pilot 7: bigger feedback + text",8,"high",8
"SUPPRF06979",20,59,16,51,14,66,37,33,"Pilot 7","Pilot 7: bigger feedback + text",8,"high",18
"SUPPRF06979",21,73,10,97,17,62,80,66,"Pilot 7","Pilot 7: bigger feedback + text",8,"high",31
"SUPPRF06979",22,63,12,68,14,64,54,64,"Pilot 7","Pilot 7: bigger feedback + text",8,"high",4
"SUPPRF06979",23,70,13,81,1,55,80,80,"Pilot 7","Pilot 7: bigger feedback + text",8,"high",1
"SUPPRF06979",24,59,16,37,0,55,37,26,"Pilot 7","Pilot 7: bigger feedback + text",8,"high",11
"SUPPRF06979",25,55,27,66,12,30,54,40,"Pilot 7","Pilot 7: bigger feedback + text",8,"high",26
"SUPPRF06979",26,76,10,96,16,63,80,81,"Pilot 7","Pilot 7: bigger feedback + text",8,"high",15
"SUPPRF06979",27,57,19,20,0,37,20,26,"Pilot 7","Pilot 7: bigger feedback + text",8,"high",-6
"SUPPRF06979",28,56,18,46,0,62,46,43,"Pilot 7","Pilot 7: bigger feedback + text",8,"high",3
"SUPPRF06979",29,74,23,58,12,56,46,50,"Pilot 7","Pilot 7: bigger feedback + text",8,"high",8
"SUPPRF06979",30,70,17,38,1,55,37,40,"Pilot 7","Pilot 7: bigger feedback + text",8,"high",-2
"SUPPRF06979",31,70,24,67,-13,78,80,83,"Pilot 7","Pilot 7: bigger feedback + text",8,"high",-16
"SUPPRF06979",32,66,17,54,0,57,54,52,"Pilot 7","Pilot 7: bigger feedback + text",8,"high",2
"SUPPRF06979",33,72,20,49,12,65,37,37,"Pilot 7","Pilot 7: bigger feedback + text",8,"high",12
"SUPPRF06979",34,63,13,80,0,59,80,77,"Pilot 7","Pilot 7: bigger feedback + text",8,"high",3
"SUPPRF06979",35,64,15,45,-1,56,46,60,"Pilot 7","Pilot 7: bigger feedback + text",8,"high",-15
"SUPPRF06979",36,64,19,68,-12,62,80,78,"Pilot 7","Pilot 7: bigger feedback + text",8,"high",-10
"SUPPRF06979",37,64,26,16,-13,62,29,31,"Pilot 7","Pilot 7: bigger feedback + text",8,"high",-15
"SUPPRF06979",38,70,8,65,19,63,46,52,"Pilot 7","Pilot 7: bigger feedback + text",8,"high",13
"SUPPRF06979",39,79,11,71,0,73,71,74,"Pilot 7","Pilot 7: bigger feedback + text",8,"high",-3
"SUPPRF06979",40,80,22,48,19,37,29,23,"Pilot 7","Pilot 7: bigger feedback + text",8,"high",25
"SUPPRF06979",41,56,20,33,-13,77,46,57,"Pilot 7","Pilot 7: bigger feedback + text",8,"high",-24
"SUPPRF06979",42,72,14,78,15,73,63,63,"Pilot 7","Pilot 7: bigger feedback + text",8,"high",15
"SUPPRF06979",43,51,41,55,-16,38,71,68,"Pilot 7","Pilot 7: bigger feedback + text",8,"high",-13
"SUPPRF06979",44,67,17,28,-1,60,29,33,"Pilot 7","Pilot 7: bigger feedback + text",8,"high",-5
"SUPPRF06979",45,51,15,8,-12,64,20,18,"Pilot 7","Pilot 7: bigger feedback + text",8,"high",-10
"SUPPRF06979",46,69,14,55,1,67,54,58,"Pilot 7","Pilot 7: bigger feedback + text",8,"high",-3
"SUPPRF06979",47,59,9,41,-13,63,54,55,"Pilot 7","Pilot 7: bigger feedback + text",8,"high",-14
"SUPPRF06979",48,51,9,6,-14,66,20,20,"Pilot 7","Pilot 7: bigger feedback + text",8,"high",-14
"SUPPRF08067",1,48,46,55,1,50,54,50,"Pilot 11","Pilot 11: bigger feedback + video + socially anxious",3,"low",5
"SUPPRF08067",2,51,40,63,0,49,63,56,"Pilot 11","Pilot 11: bigger feedback + video + socially anxious",3,"low",7
"SUPPRF08067",3,28,29,6,-14,70,20,29,"Pilot 11","Pilot 11: bigger feedback + video + socially anxious",3,"low",-23
"SUPPRF08067",4,72,22,96,16,77,80,84,"Pilot 11","Pilot 11: bigger feedback + video + socially anxious",3,"low",12
"SUPPRF08067",5,49,11,46,0,48,46,57,"Pilot 11","Pilot 11: bigger feedback + video + socially anxious",3,"low",-11
"SUPPRF08067",6,46,14,29,0,48,29,67,"Pilot 11","Pilot 11: bigger feedback + video + socially anxious",3,"low",-38
"SUPPRF08067",7,50,12,67,-13,48,80,47,"Pilot 11","Pilot 11: bigger feedback + video + socially anxious",3,"low",20
"SUPPRF08067",8,49,7,77,14,46,63,50,"Pilot 11","Pilot 11: bigger feedback + video + socially anxious",3,"low",27
"SUPPRF08067",9,60,5,54,0,48,54,47,"Pilot 11","Pilot 11: bigger feedback + video + socially anxious",3,"low",7
"SUPPRF08067",10,59,10,38,-16,48,54,49,"Pilot 11","Pilot 11: bigger feedback + video + socially anxious",3,"low",-11
"SUPPRF08067",11,51,10,45,-1,53,46,30,"Pilot 11","Pilot 11: bigger feedback + video + socially anxious",3,"low",15
"SUPPRF08067",12,20,2,24,-13,43,37,52,"Pilot 11","Pilot 11: bigger feedback + video + socially anxious",3,"low",-28
"SUPPRF08067",13,28,0,35,15,48,20,51,"Pilot 11","Pilot 11: bigger feedback + video + socially anxious",3,"low",-16
"SUPPRF08067",14,25,1,62,-1,37,63,33,"Pilot 11","Pilot 11: bigger feedback + video + socially anxious",3,"low",29
"SUPPRF08067",15,23,0,20,0,49,20,21,"Pilot 11","Pilot 11: bigger feedback + video + socially anxious",3,"low",-1
"SUPPRF08067",16,31,1,37,0,69,37,30,"Pilot 11","Pilot 11: bigger feedback + video + socially anxious",3,"low",7
"SUPPRF08067",17,24,0,41,-13,73,54,57,"Pilot 11","Pilot 11: bigger feedback + video + socially anxious",3,"low",-16
"SUPPRF08067",18,36,1,28,-1,51,29,25,"Pilot 11","Pilot 11: bigger feedback + video + socially anxious",3,"low",3
"SUPPRF08067",19,51,1,70,-1,50,71,40,"Pilot 11","Pilot 11: bigger feedback + video + socially anxious",3,"low",30
"SUPPRF08067",20,32,0,15,-14,62,29,20,"Pilot 11","Pilot 11: bigger feedback + video + socially anxious",3,"low",-5
"SUPPRF08067",21,61,1,58,29,46,29,32,"Pilot 11","Pilot 11: bigger feedback + video + socially anxious",3,"low",26
"SUPPRF08067",22,51,2,83,12,50,71,40,"Pilot 11","Pilot 11: bigger feedback + video + socially anxious",3,"low",43
"SUPPRF08067",23,69,0,47,27,50,20,7,"Pilot 11","Pilot 11: bigger feedback + video + socially anxious",3,"low",40
"SUPPRF08067",24,60,0,68,-12,43,80,39,"Pilot 11","Pilot 11: bigger feedback + video + socially anxious",3,"low",29
"SUPPRF08067",25,52,0,46,17,46,29,48,"Pilot 11","Pilot 11: bigger feedback + video + socially anxious",3,"low",-2
"SUPPRF08067",26,33,5,50,-13,13,63,35,"Pilot 11","Pilot 11: bigger feedback + video + socially anxious",3,"low",15
"SUPPRF08067",27,78,0,100,20,76,80,72,"Pilot 11","Pilot 11: bigger feedback + video + socially anxious",3,"low",28
"SUPPRF08067",28,73,2,8,-12,63,20,29,"Pilot 11","Pilot 11: bigger feedback + video + socially anxious",3,"low",-21
"SUPPRF08067",29,60,0,33,-13,49,46,49,"Pilot 11","Pilot 11: bigger feedback + video + socially anxious",3,"low",-16
"SUPPRF08067",30,35,1,16,-13,49,29,49,"Pilot 11","Pilot 11: bigger feedback + video + socially anxious",3,"low",-33
"SUPPRF08067",31,53,0,71,0,37,71,49,"Pilot 11","Pilot 11: bigger feedback + video + socially anxious",3,"low",22
"SUPPRF08067",32,65,1,81,1,36,80,50,"Pilot 11","Pilot 11: bigger feedback + video + socially anxious",3,"low",31
"SUPPRF08067",33,71,0,61,24,66,37,39,"Pilot 11","Pilot 11: bigger feedback + video + socially anxious",3,"low",22
"SUPPRF08067",34,52,0,75,29,49,46,50,"Pilot 11","Pilot 11: bigger feedback + video + socially anxious",3,"low",25
"SUPPRF08067",35,40,1,49,12,46,37,44,"Pilot 11","Pilot 11: bigger feedback + video + socially anxious",3,"low",5
"SUPPRF08067",36,59,0,34,-12,49,46,49,"Pilot 11","Pilot 11: bigger feedback + video + socially anxious",3,"low",-15
"SUPPRF08067",37,50,1,55,-16,49,71,48,"Pilot 11","Pilot 11: bigger feedback + video + socially anxious",3,"low",7
"SUPPRF08067",38,47,1,94,23,34,71,56,"Pilot 11","Pilot 11: bigger feedback + video + socially anxious",3,"low",38
"SUPPRF08067",39,48,1,56,-15,49,71,50,"Pilot 11","Pilot 11: bigger feedback + video + socially anxious",3,"low",6
"SUPPRF08067",40,37,0,19,-1,61,20,29,"Pilot 11","Pilot 11: bigger feedback + video + socially anxious",3,"low",-10
"SUPPRF08067",41,51,0,80,0,47,80,49,"Pilot 11","Pilot 11: bigger feedback + video + socially anxious",3,"low",31
"SUPPRF08067",42,55,0,66,12,54,54,61,"Pilot 11","Pilot 11: bigger feedback + video + socially anxious",3,"low",5
"SUPPRF08067",43,53,0,47,-16,31,63,44,"Pilot 11","Pilot 11: bigger feedback + video + socially anxious",3,"low",3
"SUPPRF08067",44,52,0,78,24,68,54,61,"Pilot 11","Pilot 11: bigger feedback + video + socially anxious",3,"low",17
"SUPPRF08067",45,57,0,58,12,39,46,49,"Pilot 11","Pilot 11: bigger feedback + video + socially anxious",3,"low",9
"SUPPRF08067",46,56,0,38,1,46,37,38,"Pilot 11","Pilot 11: bigger feedback + video + socially anxious",3,"low",0
"SUPPRF08067",47,76,0,88,25,66,63,46,"Pilot 11","Pilot 11: bigger feedback + video + socially anxious",3,"low",42
"SUPPRF08067",48,54,0,22,-15,47,37,47,"Pilot 11","Pilot 11: bigger feedback + video + socially anxious",3,"low",-25
"SUPPRF08085",1,51,56,56,-15,65,71,65,"Pilot 7","Pilot 7: bigger feedback + text",10,"high",-9
"SUPPRF08085",2,54,43,46,0,40,46,50,"Pilot 7","Pilot 7: bigger feedback + text",10,"high",-4
"SUPPRF08085",3,55,54,63,0,60,63,59,"Pilot 7","Pilot 7: bigger feedback + text",10,"high",4
"SUPPRF08085",4,62,38,35,15,71,20,30,"Pilot 7","Pilot 7: bigger feedback + text",10,"high",5
"SUPPRF08085",5,36,36,38,-16,56,54,65,"Pilot 7","Pilot 7: bigger feedback + text",10,"high",-27
"SUPPRF08085",6,61,40,46,17,36,29,20,"Pilot 7","Pilot 7: bigger feedback + text",10,"high",26
"SUPPRF08085",7,61,36,65,19,59,46,50,"Pilot 7","Pilot 7: bigger feedback + text",10,"high",15
"SUPPRF08085",8,35,42,55,-16,70,71,75,"Pilot 7","Pilot 7: bigger feedback + text",10,"high",-20
"SUPPRF08085",9,57,37,58,12,31,46,50,"Pilot 7","Pilot 7: bigger feedback + text",10,"high",8
"SUPPRF08085",10,74,26,70,-1,37,71,72,"Pilot 7","Pilot 7: bigger feedback + text",10,"high",-2
"SUPPRF08085",11,60,32,71,0,26,71,60,"Pilot 7","Pilot 7: bigger feedback + text",10,"high",11
"SUPPRF08085",12,65,32,29,0,58,29,20,"Pilot 7","Pilot 7: bigger feedback + text",10,"high",9
"SUPPRF08085",13,11,35,6,-14,33,20,35,"Pilot 7","Pilot 7: bigger feedback + text",10,"high",-29
"SUPPRF08085",14,80,35,22,-15,29,37,32,"Pilot 7","Pilot 7: bigger feedback + text",10,"high",-10
"SUPPRF08085",15,74,33,51,14,59,37,39,"Pilot 7","Pilot 7: bigger feedback + text",10,"high",12
"SUPPRF08085",16,56,63,37,17,14,20,17,"Pilot 7","Pilot 7: bigger feedback + text",10,"high",20
"SUPPRF08085",17,77,35,37,0,66,37,45,"Pilot 7","Pilot 7: bigger feedback + text",10,"high",-8
"SUPPRF08085",18,37,46,38,1,67,37,51,"Pilot 7","Pilot 7: bigger feedback + text",10,"high",-13
"SUPPRF08085",19,77,24,15,-14,64,29,17,"Pilot 7","Pilot 7: bigger feedback + text",10,"high",-2
"SUPPRF08085",20,84,33,34,-12,62,46,30,"Pilot 7","Pilot 7: bigger feedback + text",10,"high",4
"SUPPRF08085",21,53,60,78,15,57,63,64,"Pilot 7","Pilot 7: bigger feedback + text",10,"high",14
"SUPPRF08085",22,88,23,96,16,33,80,72,"Pilot 7","Pilot 7: bigger feedback + text",10,"high",24
"SUPPRF08085",23,41,50,50,-13,61,63,62,"Pilot 7","Pilot 7: bigger feedback + text",10,"high",-12
"SUPPRF08085",24,24,71,24,-13,34,37,44,"Pilot 7","Pilot 7: bigger feedback + text",10,"high",-20
"SUPPRF08085",25,73,39,28,-1,67,29,21,"Pilot 7","Pilot 7: bigger feedback + text",10,"high",7
"SUPPRF08085",26,7,63,8,-12,89,20,21,"Pilot 7","Pilot 7: bigger feedback + text",10,"high",-13
"SUPPRF08085",27,91,23,62,-1,25,63,43,"Pilot 7","Pilot 7: bigger feedback + text",10,"high",19
"SUPPRF08085",28,94,5,77,14,56,63,75,"Pilot 7","Pilot 7: bigger feedback + text",10,"high",2
"SUPPRF08085",29,91,24,20,0,64,20,28,"Pilot 7","Pilot 7: bigger feedback + text",10,"high",-8
"SUPPRF08085",30,95,10,68,14,95,54,61,"Pilot 7","Pilot 7: bigger feedback + text",10,"high",7
"SUPPRF08085",31,24,67,68,-12,64,80,82,"Pilot 7","Pilot 7: bigger feedback + text",10,"high",-14
"SUPPRF08085",32,33,60,19,-1,63,20,30,"Pilot 7","Pilot 7: bigger feedback + text",10,"high",-11
"SUPPRF08085",33,73,31,97,17,57,80,86,"Pilot 7","Pilot 7: bigger feedback + text",10,"high",11
"SUPPRF08085",34,15,58,47,-16,37,63,72,"Pilot 7","Pilot 7: bigger feedback + text",10,"high",-25
"SUPPRF08085",35,39,37,49,12,57,37,33,"Pilot 7","Pilot 7: bigger feedback + text",10,"high",16
"SUPPRF08085",36,40,24,83,12,78,71,70,"Pilot 7","Pilot 7: bigger feedback + text",10,"high",13
"SUPPRF08085",37,67,62,81,1,3,80,58,"Pilot 7","Pilot 7: bigger feedback + text",10,"high",23
"SUPPRF08085",38,77,32,84,13,64,71,70,"Pilot 7","Pilot 7: bigger feedback + text",10,"high",14
"SUPPRF08085",39,45,55,67,-13,67,80,80,"Pilot 7","Pilot 7: bigger feedback + text",10,"high",-13
"SUPPRF08085",40,23,30,80,0,41,80,64,"Pilot 7","Pilot 7: bigger feedback + text",10,"high",16
"SUPPRF08085",41,86,22,45,-1,39,46,49,"Pilot 7","Pilot 7: bigger feedback + text",10,"high",-4
"SUPPRF08085",42,58,25,54,0,37,54,60,"Pilot 7","Pilot 7: bigger feedback + text",10,"high",-6
"SUPPRF08085",43,14,59,48,19,77,29,10,"Pilot 7","Pilot 7: bigger feedback + text",10,"high",38
"SUPPRF08085",44,35,57,66,12,33,54,44,"Pilot 7","Pilot 7: bigger feedback + text",10,"high",22
"SUPPRF08085",45,56,34,33,-13,40,46,45,"Pilot 7","Pilot 7: bigger feedback + text",10,"high",-12
"SUPPRF08085",46,33,35,41,-13,51,54,60,"Pilot 7","Pilot 7: bigger feedback + text",10,"high",-19
"SUPPRF08085",47,7,59,16,-13,69,29,31,"Pilot 7","Pilot 7: bigger feedback + text",10,"high",-15
"SUPPRF08085",48,73,25,55,1,63,54,49,"Pilot 7","Pilot 7: bigger feedback + text",10,"high",6
"SUPPRF09587",1,75,1,77,14,71,63,46,"Pilot 7","Pilot 7: bigger feedback + text",0,"low",31
"SUPPRF09587",2,77,2,96,16,88,80,87,"Pilot 7","Pilot 7: bigger feedback + text",0,"low",9
"SUPPRF09587",3,75,3,45,-1,65,46,47,"Pilot 7","Pilot 7: bigger feedback + text",0,"low",-2
"SUPPRF09587",4,72,5,38,-16,90,54,75,"Pilot 7","Pilot 7: bigger feedback + text",0,"low",-37
"SUPPRF09587",5,70,12,29,0,55,29,41,"Pilot 7","Pilot 7: bigger feedback + text",0,"low",-12
"SUPPRF09587",6,67,30,54,0,46,54,52,"Pilot 7","Pilot 7: bigger feedback + text",0,"low",2
"SUPPRF09587",7,79,22,78,15,74,63,84,"Pilot 7","Pilot 7: bigger feedback + text",0,"low",-6
"SUPPRF09587",8,67,50,55,1,71,54,30,"Pilot 7","Pilot 7: bigger feedback + text",0,"low",25
"SUPPRF09587",9,52,48,33,-13,52,46,21,"Pilot 7","Pilot 7: bigger feedback + text",0,"low",12
"SUPPRF09587",10,82,41,70,-1,62,71,68,"Pilot 7","Pilot 7: bigger feedback + text",0,"low",2
"SUPPRF09587",11,71,44,71,0,69,71,54,"Pilot 7","Pilot 7: bigger feedback + text",0,"low",17
"SUPPRF09587",12,54,37,19,-1,64,20,29,"Pilot 7","Pilot 7: bigger feedback + text",0,"low",-10
"SUPPRF09587",13,62,30,81,1,88,80,84,"Pilot 7","Pilot 7: bigger feedback + text",0,"low",-3
"SUPPRF09587",14,53,44,55,-16,95,71,78,"Pilot 7","Pilot 7: bigger feedback + text",0,"low",-23
"SUPPRF09587",15,59,42,41,-13,65,54,54,"Pilot 7","Pilot 7: bigger feedback + text",0,"low",-13
"SUPPRF09587",16,60,36,20,0,70,20,11,"Pilot 7","Pilot 7: bigger feedback + text",0,"low",9
"SUPPRF09587",17,62,34,65,19,50,46,50,"Pilot 7","Pilot 7: bigger feedback + text",0,"low",15
"SUPPRF09587",18,52,39,22,-15,59,37,26,"Pilot 7","Pilot 7: bigger feedback + text",0,"low",-4
"SUPPRF09587",19,83,33,35,15,85,20,12,"Pilot 7","Pilot 7: bigger feedback + text",0,"low",23
"SUPPRF09587",20,62,39,68,-12,79,80,79,"Pilot 7","Pilot 7: bigger feedback + text",0,"low",-11
"SUPPRF09587",21,63,43,16,-13,38,29,46,"Pilot 7","Pilot 7: bigger feedback + text",0,"low",-30
"SUPPRF09587",22,70,39,37,0,84,37,22,"Pilot 7","Pilot 7: bigger feedback + text",0,"low",15
"SUPPRF09587",23,77,18,97,17,69,80,74,"Pilot 7","Pilot 7: bigger feedback + text",0,"low",23
"SUPPRF09587",24,57,47,67,-13,96,80,94,"Pilot 7","Pilot 7: bigger feedback + text",0,"low",-27
"SUPPRF09587",25,49,36,34,-12,85,46,49,"Pilot 7","Pilot 7: bigger feedback + text",0,"low",-15
"SUPPRF09587",26,62,31,50,-13,47,63,56,"Pilot 7","Pilot 7: bigger feedback + text",0,"low",-6
"SUPPRF09587",27,60,58,80,0,61,80,48,"Pilot 7","Pilot 7: bigger feedback + text",0,"low",32
"SUPPRF09587",28,58,42,46,17,91,29,13,"Pilot 7","Pilot 7: bigger feedback + text",0,"low",33
"SUPPRF09587",29,67,45,28,-1,56,29,29,"Pilot 7","Pilot 7: bigger feedback + text",0,"low",-1
"SUPPRF09587",30,47,43,38,1,70,37,64,"Pilot 7","Pilot 7: bigger feedback + text",0,"low",-26
"SUPPRF09587",31,48,51,49,12,69,37,47,"Pilot 7","Pilot 7: bigger feedback + text",0,"low",2
"SUPPRF09587",32,50,50,46,0,50,46,49,"Pilot 7","Pilot 7: bigger feedback + text",0,"low",-3
"SUPPRF09587",33,51,49,56,-15,51,71,43,"Pilot 7","Pilot 7: bigger feedback + text",0,"low",13
"SUPPRF09587",34,42,50,48,19,91,29,26,"Pilot 7","Pilot 7: bigger feedback + text",0,"low",22
"SUPPRF09587",35,46,46,84,13,71,71,55,"Pilot 7","Pilot 7: bigger feedback + text",0,"low",29
"SUPPRF09587",36,45,54,37,17,86,20,21,"Pilot 7","Pilot 7: bigger feedback + text",0,"low",16
"SUPPRF09587",37,48,49,15,-14,76,29,25,"Pilot 7","Pilot 7: bigger feedback + text",0,"low",-10
"SUPPRF09587",38,20,71,8,-12,62,20,12,"Pilot 7","Pilot 7: bigger feedback + text",0,"low",-4
"SUPPRF09587",39,34,53,51,14,24,37,53,"Pilot 7","Pilot 7: bigger feedback + text",0,"low",-2
"SUPPRF09587",40,3,58,6,-14,83,20,17,"Pilot 7","Pilot 7: bigger feedback + text",0,"low",-11
"SUPPRF09587",41,41,52,58,12,82,46,49,"Pilot 7","Pilot 7: bigger feedback + text",0,"low",9
"SUPPRF09587",42,49,53,63,0,66,63,55,"Pilot 7","Pilot 7: bigger feedback + text",0,"low",8
"SUPPRF09587",43,51,50,47,-16,65,63,57,"Pilot 7","Pilot 7: bigger feedback + text",0,"low",-10
"SUPPRF09587",44,57,47,66,12,70,54,36,"Pilot 7","Pilot 7: bigger feedback + text",0,"low",30
"SUPPRF09587",45,14,59,24,-13,80,37,45,"Pilot 7","Pilot 7: bigger feedback + text",0,"low",-21
"SUPPRF09587",46,58,42,62,-1,54,63,64,"Pilot 7","Pilot 7: bigger feedback + text",0,"low",-2
"SUPPRF09587",47,22,56,68,14,52,54,48,"Pilot 7","Pilot 7: bigger feedback + text",0,"low",20
"SUPPRF09587",48,23,64,83,12,76,71,32,"Pilot 7","Pilot 7: bigger feedback + text",0,"low",51
"SUPPRF09619",1,68,74,54,0,81,54,75,"Pilot 11","Pilot 11: bigger feedback + video + socially anxious",10,"high",-21
"SUPPRF09619",2,76,57,77,14,64,63,64,"Pilot 11","Pilot 11: bigger feedback + video + socially anxious",10,"high",13
"SUPPRF09619",3,70,53,80,0,65,80,54,"Pilot 11","Pilot 11: bigger feedback + video + socially anxious",10,"high",26
"SUPPRF09619",4,69,78,75,29,63,46,73,"Pilot 11","Pilot 11: bigger feedback + video + socially anxious",10,"high",2
"SUPPRF09619",5,59,63,47,27,82,20,38,"Pilot 11","Pilot 11: bigger feedback + video + socially anxious",10,"high",9
"SUPPRF09619",6,64,80,88,25,77,63,98,"Pilot 11","Pilot 11: bigger feedback + video + socially anxious",10,"high",-10
"SUPPRF09619",7,72,69,81,1,85,80,79,"Pilot 11","Pilot 11: bigger feedback + video + socially anxious",10,"high",2
"SUPPRF09619",8,24,36,15,-14,74,29,91,"Pilot 11","Pilot 11: bigger feedback + video + socially anxious",10,"high",-76
"SUPPRF09619",9,82,82,46,0,88,46,68,"Pilot 11","Pilot 11: bigger feedback + video + socially anxious",10,"high",-22
"SUPPRF09619",10,71,74,38,-16,56,54,38,"Pilot 11","Pilot 11: bigger feedback + video + socially anxious",10,"high",0
"SUPPRF09619",11,69,80,67,-13,69,80,75,"Pilot 11","Pilot 11: bigger feedback + video + socially anxious",10,"high",-8
"SUPPRF09619",12,74,81,49,12,86,37,79,"Pilot 11","Pilot 11: bigger feedback + video + socially anxious",10,"high",-30
"SUPPRF09619",13,51,66,24,-13,63,37,71,"Pilot 11","Pilot 11: bigger feedback + video + socially anxious",10,"high",-47
"SUPPRF09619",14,81,96,94,23,83,71,98,"Pilot 11","Pilot 11: bigger feedback + video + socially anxious",10,"high",-4
"SUPPRF09619",15,84,82,45,-1,80,46,88,"Pilot 11","Pilot 11: bigger feedback + video + socially anxious",10,"high",-43
"SUPPRF09619",16,59,62,68,-12,57,80,60,"Pilot 11","Pilot 11: bigger feedback + video + socially anxious",10,"high",8
"SUPPRF09619",17,59,62,56,-15,55,71,90,"Pilot 11","Pilot 11: bigger feedback + video + socially anxious",10,"high",-34
"SUPPRF09619",18,75,97,83,12,45,71,43,"Pilot 11","Pilot 11: bigger feedback + video + socially anxious",10,"high",40
"SUPPRF09619",19,89,88,6,-14,69,20,78,"Pilot 11","Pilot 11: bigger feedback + video + socially anxious",10,"high",-72
"SUPPRF09619",20,69,73,55,1,87,54,86,"Pilot 11","Pilot 11: bigger feedback + video + socially anxious",10,"high",-31
"SUPPRF09619",21,80,63,66,12,79,54,85,"Pilot 11","Pilot 11: bigger feedback + video + socially anxious",10,"high",-19
"SUPPRF09619",22,54,80,33,-13,87,46,85,"Pilot 11","Pilot 11: bigger feedback + video + socially anxious",10,"high",-52
"SUPPRF09619",23,64,58,37,0,69,37,74,"Pilot 11","Pilot 11: bigger feedback + video + socially anxious",10,"high",-37
"SUPPRF09619",24,60,70,28,-1,58,29,64,"Pilot 11","Pilot 11: bigger feedback + video + socially anxious",10,"high",-36
"SUPPRF09619",25,55,48,41,-13,35,54,17,"Pilot 11","Pilot 11: bigger feedback + video + socially anxious",10,"high",24
"SUPPRF09619",26,55,55,46,17,46,29,39,"Pilot 11","Pilot 11: bigger feedback + video + socially anxious",10,"high",7
"SUPPRF09619",27,77,49,55,-16,59,71,91,"Pilot 11","Pilot 11: bigger feedback + video + socially anxious",10,"high",-36
"SUPPRF09619",28,46,34,58,29,76,29,69,"Pilot 11","Pilot 11: bigger feedback + video + socially anxious",10,"high",-11
"SUPPRF09619",29,62,68,70,-1,76,71,67,"Pilot 11","Pilot 11: bigger feedback + video + socially anxious",10,"high",3
"SUPPRF09619",30,55,64,78,24,73,54,75,"Pilot 11","Pilot 11: bigger feedback + video + socially anxious",10,"high",3
"SUPPRF09619",31,57,74,29,0,64,29,65,"Pilot 11","Pilot 11: bigger feedback + video + socially anxious",10,"high",-36
"SUPPRF09619",32,75,71,63,0,70,63,64,"Pilot 11","Pilot 11: bigger feedback + video + socially anxious",10,"high",-1
"SUPPRF09619",33,75,55,100,20,65,80,63,"Pilot 11","Pilot 11: bigger feedback + video + socially anxious",10,"high",37
"SUPPRF09619",34,44,51,8,-12,53,20,23,"Pilot 11","Pilot 11: bigger feedback + video + socially anxious",10,"high",-15
"SUPPRF09619",35,63,74,71,0,84,71,89,"Pilot 11","Pilot 11: bigger feedback + video + socially anxious",10,"high",-18
"SUPPRF09619",36,69,60,20,0,54,20,59,"Pilot 11","Pilot 11: bigger feedback + video + socially anxious",10,"high",-39
"SUPPRF09619",37,80,81,35,15,85,20,99,"Pilot 11","Pilot 11: bigger feedback + video + socially anxious",10,"high",-64
"SUPPRF09619",38,76,74,34,-12,57,46,95,"Pilot 11","Pilot 11: bigger feedback + video + socially anxious",10,"high",-61
"SUPPRF09619",39,63,65,62,-1,52,63,94,"Pilot 11","Pilot 11: bigger feedback + video + socially anxious",10,"high",-32
"SUPPRF09619",40,51,79,38,1,60,37,80,"Pilot 11","Pilot 11: bigger feedback + video + socially anxious",10,"high",-42
"SUPPRF09619",41,64,71,50,-13,82,63,83,"Pilot 11","Pilot 11: bigger feedback + video + socially anxious",10,"high",-33
"SUPPRF09619",42,58,60,61,24,69,37,57,"Pilot 11","Pilot 11: bigger feedback + video + socially anxious",10,"high",4
"SUPPRF09619",43,66,83,96,16,80,80,89,"Pilot 11","Pilot 11: bigger feedback + video + socially anxious",10,"high",7
"SUPPRF09619",44,47,70,47,-16,58,63,97,"Pilot 11","Pilot 11: bigger feedback + video + socially anxious",10,"high",-50
"SUPPRF09619",45,62,68,58,12,57,46,86,"Pilot 11","Pilot 11: bigger feedback + video + socially anxious",10,"high",-28
"SUPPRF09619",46,77,41,22,-15,74,37,70,"Pilot 11","Pilot 11: bigger feedback + video + socially anxious",10,"high",-48
"SUPPRF09619",47,76,74,19,-1,57,20,92,"Pilot 11","Pilot 11: bigger feedback + video + socially anxious",10,"high",-73
"SUPPRF09619",48,52,51,16,-13,85,29,85,"Pilot 11","Pilot 11: bigger feedback + video + socially anxious",10,"high",-69
"SUPPRF10753",1,83,9,15,-14,69,29,39,"Pilot 7","Pilot 7: bigger feedback + text",3,"low",-24
"SUPPRF10753",2,78,10,83,12,49,71,69,"Pilot 7","Pilot 7: bigger feedback + text",3,"low",14
"SUPPRF10753",3,81,15,51,14,49,37,44,"Pilot 7","Pilot 7: bigger feedback + text",3,"low",7
"SUPPRF10753",4,79,13,68,14,46,54,51,"Pilot 7","Pilot 7: bigger feedback + text",3,"low",17
"SUPPRF10753",5,80,12,71,0,50,71,58,"Pilot 7","Pilot 7: bigger feedback + text",3,"low",13
"SUPPRF10753",6,77,16,70,-1,14,71,56,"Pilot 7","Pilot 7: bigger feedback + text",3,"low",14
"SUPPRF10753",7,81,19,38,1,52,37,47,"Pilot 7","Pilot 7: bigger feedback + text",3,"low",-9
"SUPPRF10753",8,74,16,16,-13,51,29,46,"Pilot 7","Pilot 7: bigger feedback + text",3,"low",-30
"SUPPRF10753",9,80,18,24,-13,47,37,41,"Pilot 7","Pilot 7: bigger feedback + text",3,"low",-17
"SUPPRF10753",10,82,18,29,0,45,29,69,"Pilot 7","Pilot 7: bigger feedback + text",3,"low",-40
"SUPPRF10753",11,79,16,45,-1,48,46,47,"Pilot 7","Pilot 7: bigger feedback + text",3,"low",-2
"SUPPRF10753",12,72,17,35,15,52,20,41,"Pilot 7","Pilot 7: bigger feedback + text",3,"low",-6
"SUPPRF10753",13,74,19,28,-1,50,29,39,"Pilot 7","Pilot 7: bigger feedback + text",3,"low",-11
"SUPPRF10753",14,77,14,20,0,49,20,41,"Pilot 7","Pilot 7: bigger feedback + text",3,"low",-21
"SUPPRF10753",15,83,22,22,-15,49,37,43,"Pilot 7","Pilot 7: bigger feedback + text",3,"low",-21
"SUPPRF10753",16,73,18,48,19,51,29,38,"Pilot 7","Pilot 7: bigger feedback + text",3,"low",10
"SUPPRF10753",17,79,16,19,-1,49,20,41,"Pilot 7","Pilot 7: bigger feedback + text",3,"low",-22
"SUPPRF10753",18,75,16,8,-12,18,20,24,"Pilot 7","Pilot 7: bigger feedback + text",3,"low",-16
"SUPPRF10753",19,79,19,62,-1,48,63,70,"Pilot 7","Pilot 7: bigger feedback + text",3,"low",-8
"SUPPRF10753",20,76,16,37,0,50,37,50,"Pilot 7","Pilot 7: bigger feedback + text",3,"low",-13
"SUPPRF10753",21,78,24,37,17,51,20,30,"Pilot 7","Pilot 7: bigger feedback + text",3,"low",7
"SUPPRF10753",22,80,20,33,-13,49,46,49,"Pilot 7","Pilot 7: bigger feedback + text",3,"low",-16
"SUPPRF10753",23,81,22,6,-14,55,20,36,"Pilot 7","Pilot 7: bigger feedback + text",3,"low",-30
"SUPPRF10753",24,81,20,67,-13,50,80,75,"Pilot 7","Pilot 7: bigger feedback + text",3,"low",-8
"SUPPRF10753",25,81,17,50,-13,63,63,74,"Pilot 7","Pilot 7: bigger feedback + text",3,"low",-24
"SUPPRF10753",26,78,21,38,-16,48,54,62,"Pilot 7","Pilot 7: bigger feedback + text",3,"low",-24
"SUPPRF10753",27,18,23,81,1,56,80,67,"Pilot 7","Pilot 7: bigger feedback + text",3,"low",14
"SUPPRF10753",28,79,22,55,-16,48,71,57,"Pilot 7","Pilot 7: bigger feedback + text",3,"low",-2
"SUPPRF10753",29,73,19,41,-13,30,54,57,"Pilot 7","Pilot 7: bigger feedback + text",3,"low",-16
"SUPPRF10753",30,82,15,65,19,49,46,51,"Pilot 7","Pilot 7: bigger feedback + text",3,"low",14
"SUPPRF10753",31,77,21,96,16,48,80,70,"Pilot 7","Pilot 7: bigger feedback + text",3,"low",26
"SUPPRF10753",32,72,16,49,12,49,37,33,"Pilot 7","Pilot 7: bigger feedback + text",3,"low",16
"SUPPRF10753",33,78,22,54,0,46,54,41,"Pilot 7","Pilot 7: bigger feedback + text",3,"low",13
"SUPPRF10753",34,78,21,55,1,49,54,51,"Pilot 7","Pilot 7: bigger feedback + text",3,"low",4
"SUPPRF10753",35,74,19,58,12,23,46,53,"Pilot 7","Pilot 7: bigger feedback + text",3,"low",5
"SUPPRF10753",36,74,26,78,15,23,63,41,"Pilot 7","Pilot 7: bigger feedback + text",3,"low",37
"SUPPRF10753",37,76,46,80,0,38,80,74,"Pilot 7","Pilot 7: bigger feedback + text",3,"low",6
"SUPPRF10753",38,77,20,46,17,22,29,56,"Pilot 7","Pilot 7: bigger feedback + text",3,"low",-10
"SUPPRF10753",39,75,27,77,14,27,63,54,"Pilot 7","Pilot 7: bigger feedback + text",3,"low",23
"SUPPRF10753",40,74,25,56,-15,17,71,66,"Pilot 7","Pilot 7: bigger feedback + text",3,"low",-10
"SUPPRF10753",41,76,15,66,12,23,54,53,"Pilot 7","Pilot 7: bigger feedback + text",3,"low",13
"SUPPRF10753",42,78,20,47,-16,48,63,58,"Pilot 7","Pilot 7: bigger feedback + text",3,"low",-11
"SUPPRF10753",43,76,20,68,-12,50,80,74,"Pilot 7","Pilot 7: bigger feedback + text",3,"low",-6
"SUPPRF10753",44,80,47,46,0,19,46,50,"Pilot 7","Pilot 7: bigger feedback + text",3,"low",-4
"SUPPRF10753",45,78,21,63,0,46,63,56,"Pilot 7","Pilot 7: bigger feedback + text",3,"low",7
"SUPPRF10753",46,78,26,97,17,48,80,69,"Pilot 7","Pilot 7: bigger feedback + text",3,"low",28
"SUPPRF10753",47,75,19,34,-12,21,46,57,"Pilot 7","Pilot 7: bigger feedback + text",3,"low",-23
"SUPPRF10753",48,82,24,84,13,47,71,57,"Pilot 7","Pilot 7: bigger feedback + text",3,"low",27
"SUPPRF10856",1,67,37,80,0,65,80,75,"Pilot 9","Pilot 9: bigger feedback + text",10,"high",5
"SUPPRF10856",2,68,53,62,-1,74,63,31,"Pilot 9","Pilot 9: bigger feedback + text",10,"high",31
"SUPPRF10856",3,62,46,47,-16,75,63,68,"Pilot 9","Pilot 9: bigger feedback + text",10,"high",-21
"SUPPRF10856",4,60,41,22,-15,40,37,45,"Pilot 9","Pilot 9: bigger feedback + text",10,"high",-23
"SUPPRF10856",5,46,60,58,12,70,46,45,"Pilot 9","Pilot 9: bigger feedback + text",10,"high",13
"SUPPRF10856",6,61,46,24,-13,75,37,40,"Pilot 9","Pilot 9: bigger feedback + text",10,"high",-16
"SUPPRF10856",7,60,39,68,-12,75,80,80,"Pilot 9","Pilot 9: bigger feedback + text",10,"high",-12
"SUPPRF10856",8,54,43,46,17,75,29,33,"Pilot 9","Pilot 9: bigger feedback + text",10,"high",13
"SUPPRF10856",9,60,46,55,-16,75,71,70,"Pilot 9","Pilot 9: bigger feedback + text",10,"high",-15
"SUPPRF10856",10,64,44,96,16,70,80,77,"Pilot 9","Pilot 9: bigger feedback + text",10,"high",19
"SUPPRF10856",11,45,39,33,-13,70,46,40,"Pilot 9","Pilot 9: bigger feedback + text",10,"high",-7
"SUPPRF10856",12,57,44,34,-12,70,46,40,"Pilot 9","Pilot 9: bigger feedback + text",10,"high",-6
"SUPPRF10856",13,57,45,67,-13,40,80,65,"Pilot 9","Pilot 9: bigger feedback + text",10,"high",2
"SUPPRF10856",14,63,41,29,0,70,29,30,"Pilot 9","Pilot 9: bigger feedback + text",10,"high",-1
"SUPPRF10856",15,64,42,77,14,60,63,75,"Pilot 9","Pilot 9: bigger feedback + text",10,"high",2
"SUPPRF10856",16,62,43,19,-1,29,20,22,"Pilot 9","Pilot 9: bigger feedback + text",10,"high",-3
"SUPPRF10856",17,57,43,56,-15,75,71,70,"Pilot 9","Pilot 9: bigger feedback + text",10,"high",-14
"SUPPRF10856",18,58,43,15,-14,75,29,28,"Pilot 9","Pilot 9: bigger feedback + text",10,"high",-13
"SUPPRF10856",19,60,41,66,12,35,54,55,"Pilot 9","Pilot 9: bigger feedback + text",10,"high",11
"SUPPRF10856",20,59,43,41,-13,60,54,58,"Pilot 9","Pilot 9: bigger feedback + text",10,"high",-17
"SUPPRF10856",21,58,39,6,-14,55,20,18,"Pilot 9","Pilot 9: bigger feedback + text",10,"high",-12
"SUPPRF10856",22,65,42,83,12,80,71,65,"Pilot 9","Pilot 9: bigger feedback + text",10,"high",18
"SUPPRF10856",23,62,39,47,27,65,20,30,"Pilot 9","Pilot 9: bigger feedback + text",10,"high",17
"SUPPRF10856",24,60,46,8,-12,60,20,35,"Pilot 9","Pilot 9: bigger feedback + text",10,"high",-27
"SUPPRF10856",25,62,39,63,0,70,63,65,"Pilot 9","Pilot 9: bigger feedback + text",10,"high",-2
"SUPPRF10856",26,59,48,55,1,40,54,60,"Pilot 9","Pilot 9: bigger feedback + text",10,"high",-5
"SUPPRF10856",27,56,42,75,29,70,46,61,"Pilot 9","Pilot 9: bigger feedback + text",10,"high",14
"SUPPRF10856",28,59,42,46,0,75,46,60,"Pilot 9","Pilot 9: bigger feedback + text",10,"high",-14
"SUPPRF10856",29,61,39,58,29,60,29,15,"Pilot 9","Pilot 9: bigger feedback + text",10,"high",43
"SUPPRF10856",30,62,37,71,0,65,71,65,"Pilot 9","Pilot 9: bigger feedback + text",10,"high",6
"SUPPRF10856",31,60,40,16,-13,75,29,26,"Pilot 9","Pilot 9: bigger feedback + text",10,"high",-10
"SUPPRF10856",32,61,43,70,-1,70,71,55,"Pilot 9","Pilot 9: bigger feedback + text",10,"high",15
"SUPPRF10856",33,57,41,38,-16,51,54,58,"Pilot 9","Pilot 9: bigger feedback + text",10,"high",-20
"SUPPRF10856",34,60,39,50,-13,55,63,70,"Pilot 9","Pilot 9: bigger feedback + text",10,"high",-20
"SUPPRF10856",35,64,42,94,23,80,71,70,"Pilot 9","Pilot 9: bigger feedback + text",10,"high",24
"SUPPRF10856",36,62,40,45,-1,50,46,40,"Pilot 9","Pilot 9: bigger feedback + text",10,"high",5
"SUPPRF10856",37,60,46,49,12,35,37,56,"Pilot 9","Pilot 9: bigger feedback + text",10,"high",-7
"SUPPRF10856",38,61,40,100,20,70,80,79,"Pilot 9","Pilot 9: bigger feedback + text",10,"high",21
"SUPPRF10856",39,58,44,54,0,75,54,67,"Pilot 9","Pilot 9: bigger feedback + text",10,"high",-13
"SUPPRF10856",40,62,38,20,0,57,20,20,"Pilot 9","Pilot 9: bigger feedback + text",10,"high",0
"SUPPRF10856",41,61,42,28,-1,37,29,40,"Pilot 9","Pilot 9: bigger feedback + text",10,"high",-12
"SUPPRF10856",42,58,40,38,1,70,37,40,"Pilot 9","Pilot 9: bigger feedback + text",10,"high",-2
"SUPPRF10856",43,61,43,37,0,39,37,30,"Pilot 9","Pilot 9: bigger feedback + text",10,"high",7
"SUPPRF10856",44,59,42,61,24,60,37,40,"Pilot 9","Pilot 9: bigger feedback + text",10,"high",21
"SUPPRF10856",45,58,40,35,15,65,20,20,"Pilot 9","Pilot 9: bigger feedback + text",10,"high",15
"SUPPRF10856",46,58,43,88,25,51,63,55,"Pilot 9","Pilot 9: bigger feedback + text",10,"high",33
"SUPPRF10856",47,61,43,81,1,70,80,77,"Pilot 9","Pilot 9: bigger feedback + text",10,"high",4
"SUPPRF10856",48,56,44,78,24,37,54,55,"Pilot 9","Pilot 9: bigger feedback + text",10,"high",23
"SUPPRF11139",1,31,65,29,0,18,29,44,"Pilot 7","Pilot 7: bigger feedback + text",5,"low",-15
"SUPPRF11139",2,84,59,96,16,52,80,66,"Pilot 7","Pilot 7: bigger feedback + text",5,"low",30
"SUPPRF11139",3,41,58,67,-13,53,80,84,"Pilot 7","Pilot 7: bigger feedback + text",5,"low",-17
"SUPPRF11139",4,48,74,20,0,30,20,19,"Pilot 7","Pilot 7: bigger feedback + text",5,"low",1
"SUPPRF11139",5,24,86,24,-13,29,37,48,"Pilot 7","Pilot 7: bigger feedback + text",5,"low",-24
"SUPPRF11139",6,65,57,56,-15,31,71,46,"Pilot 7","Pilot 7: bigger feedback + text",5,"low",10
"SUPPRF11139",7,57,47,49,12,52,37,38,"Pilot 7","Pilot 7: bigger feedback + text",5,"low",11
"SUPPRF11139",8,20,57,28,-1,52,29,39,"Pilot 7","Pilot 7: bigger feedback + text",5,"low",-11
"SUPPRF11139",9,50,54,46,17,49,29,28,"Pilot 7","Pilot 7: bigger feedback + text",5,"low",18
"SUPPRF11139",10,42,79,16,-13,27,29,27,"Pilot 7","Pilot 7: bigger feedback + text",5,"low",-11
"SUPPRF11139",11,58,43,68,14,52,54,61,"Pilot 7","Pilot 7: bigger feedback + text",5,"low",7
"SUPPRF11139",12,45,50,47,-16,34,63,65,"Pilot 7","Pilot 7: bigger feedback + text",5,"low",-18
"SUPPRF11139",13,42,57,51,14,44,37,37,"Pilot 7","Pilot 7: bigger feedback + text",5,"low",14
"SUPPRF11139",14,37,52,66,12,45,54,42,"Pilot 7","Pilot 7: bigger feedback + text",5,"low",24
"SUPPRF11139",15,61,48,78,15,42,63,50,"Pilot 7","Pilot 7: bigger feedback + text",5,"low",28
"SUPPRF11139",16,59,63,54,0,42,54,59,"Pilot 7","Pilot 7: bigger feedback + text",5,"low",-5
"SUPPRF11139",17,78,62,80,0,27,80,67,"Pilot 7","Pilot 7: bigger feedback + text",5,"low",13
"SUPPRF11139",18,43,50,46,0,49,46,57,"Pilot 7","Pilot 7: bigger feedback + text",5,"low",-11
"SUPPRF11139",19,64,63,71,0,33,71,51,"Pilot 7","Pilot 7: bigger feedback + text",5,"low",20
"SUPPRF11139",20,51,57,63,0,38,63,53,"Pilot 7","Pilot 7: bigger feedback + text",5,"low",10
"SUPPRF11139",21,68,56,55,1,42,54,60,"Pilot 7","Pilot 7: bigger feedback + text",5,"low",-5
"SUPPRF11139",22,52,37,41,-13,35,54,50,"Pilot 7","Pilot 7: bigger feedback + text",5,"low",-9
"SUPPRF11139",23,21,63,33,-13,63,46,42,"Pilot 7","Pilot 7: bigger feedback + text",5,"low",-9
"SUPPRF11139",24,8,63,8,-12,63,20,10,"Pilot 7","Pilot 7: bigger feedback + text",5,"low",-2
"SUPPRF11139",25,51,48,70,-1,37,71,68,"Pilot 7","Pilot 7: bigger feedback + text",5,"low",2
"SUPPRF11139",26,19,69,55,-16,55,71,75,"Pilot 7","Pilot 7: bigger feedback + text",5,"low",-20
"SUPPRF11139",27,60,32,81,1,57,80,76,"Pilot 7","Pilot 7: bigger feedback + text",5,"low",5
"SUPPRF11139",28,36,56,50,-13,27,63,55,"Pilot 7","Pilot 7: bigger feedback + text",5,"low",-5
"SUPPRF11139",29,59,47,77,14,66,63,53,"Pilot 7","Pilot 7: bigger feedback + text",5,"low",24
"SUPPRF11139",30,59,51,62,-1,49,63,69,"Pilot 7","Pilot 7: bigger feedback + text",5,"low",-7
"SUPPRF11139",31,47,62,97,17,48,80,67,"Pilot 7","Pilot 7: bigger feedback + text",5,"low",30
"SUPPRF11139",32,7,77,38,1,13,37,65,"Pilot 7","Pilot 7: bigger feedback + text",5,"low",-27
"SUPPRF11139",33,42,54,45,-1,27,46,31,"Pilot 7","Pilot 7: bigger feedback + text",5,"low",14
"SUPPRF11139",34,0,88,6,-14,54,20,25,"Pilot 7","Pilot 7: bigger feedback + text",5,"low",-19
"SUPPRF11139",35,59,39,48,19,37,29,20,"Pilot 7","Pilot 7: bigger feedback + text",5,"low",28
"SUPPRF11139",36,55,46,35,15,16,20,17,"Pilot 7","Pilot 7: bigger feedback + text",5,"low",18
"SUPPRF11139",37,54,62,19,-1,39,20,18,"Pilot 7","Pilot 7: bigger feedback + text",5,"low",1
"SUPPRF11139",38,54,43,83,12,48,71,75,"Pilot 7","Pilot 7: bigger feedback + text",5,"low",8
"SUPPRF11139",39,52,63,37,17,18,20,20,"Pilot 7","Pilot 7: bigger feedback + text",5,"low",17
"SUPPRF11139",40,48,56,34,-12,15,46,30,"Pilot 7","Pilot 7: bigger feedback + text",5,"low",4
"SUPPRF11139",41,53,31,84,13,45,71,73,"Pilot 7","Pilot 7: bigger feedback + text",5,"low",11
"SUPPRF11139",42,53,67,65,19,17,46,41,"Pilot 7","Pilot 7: bigger feedback + text",5,"low",24
"SUPPRF11139",43,29,61,38,-16,51,54,55,"Pilot 7","Pilot 7: bigger feedback + text",5,"low",-17
"SUPPRF11139",44,32,70,22,-15,30,37,46,"Pilot 7","Pilot 7: bigger feedback + text",5,"low",-24
"SUPPRF11139",45,40,49,58,12,28,46,49,"Pilot 7","Pilot 7: bigger feedback + text",5,"low",9
"SUPPRF11139",46,39,34,68,-12,36,80,72,"Pilot 7","Pilot 7: bigger feedback + text",5,"low",-4
"SUPPRF11139",47,53,45,37,0,38,37,46,"Pilot 7","Pilot 7: bigger feedback + text",5,"low",-9
"SUPPRF11139",48,30,44,15,-14,34,29,13,"Pilot 7","Pilot 7: bigger feedback + text",5,"low",2
"SUPPRF12547",1,68,67,81,1,80,80,75,"Pilot 10","Pilot 10: bigger feedback + video",4,"low",6
"SUPPRF12547",2,66,53,6,-14,88,20,25,"Pilot 10","Pilot 10: bigger feedback + video",4,"low",-19
"SUPPRF12547",3,65,51,77,14,62,63,60,"Pilot 10","Pilot 10: bigger feedback + video",4,"low",17
"SUPPRF12547",4,68,52,67,-13,60,80,77,"Pilot 10","Pilot 10: bigger feedback + video",4,"low",-10
"SUPPRF12547",5,51,37,8,-12,22,20,15,"Pilot 10","Pilot 10: bigger feedback + video",4,"low",-7
"SUPPRF12547",6,53,36,83,12,30,71,70,"Pilot 10","Pilot 10: bigger feedback + video",4,"low",13
"SUPPRF12547",7,51,24,46,17,35,29,35,"Pilot 10","Pilot 10: bigger feedback + video",4,"low",11
"SUPPRF12547",8,62,12,88,25,60,63,65,"Pilot 10","Pilot 10: bigger feedback + video",4,"low",23
"SUPPRF12547",9,68,13,94,23,73,71,70,"Pilot 10","Pilot 10: bigger feedback + video",4,"low",24
"SUPPRF12547",10,60,1,33,-13,50,46,50,"Pilot 10","Pilot 10: bigger feedback + video",4,"low",-17
"SUPPRF12547",11,52,3,37,0,31,37,40,"Pilot 10","Pilot 10: bigger feedback + video",4,"low",-3
"SUPPRF12547",12,62,7,50,-13,69,63,75,"Pilot 10","Pilot 10: bigger feedback + video",4,"low",-25
"SUPPRF12547",13,69,1,100,20,75,80,80,"Pilot 10","Pilot 10: bigger feedback + video",4,"low",20
"SUPPRF12547",14,63,0,24,-13,66,37,20,"Pilot 10","Pilot 10: bigger feedback + video",4,"low",4
"SUPPRF12547",15,67,0,45,-1,80,46,24,"Pilot 10","Pilot 10: bigger feedback + video",4,"low",21
"SUPPRF12547",16,66,3,41,-13,80,54,50,"Pilot 10","Pilot 10: bigger feedback + video",4,"low",-9
"SUPPRF12547",17,59,0,47,-16,68,63,67,"Pilot 10","Pilot 10: bigger feedback + video",4,"low",-20
"SUPPRF12547",18,54,0,46,0,66,46,43,"Pilot 10","Pilot 10: bigger feedback + video",4,"low",3
"SUPPRF12547",19,53,0,22,-15,74,37,27,"Pilot 10","Pilot 10: bigger feedback + video",4,"low",-5
"SUPPRF12547",20,68,0,78,24,65,54,57,"Pilot 10","Pilot 10: bigger feedback + video",4,"low",21
"SUPPRF12547",21,55,0,29,0,70,29,37,"Pilot 10","Pilot 10: bigger feedback + video",4,"low",-8
"SUPPRF12547",22,52,0,49,12,73,37,15,"Pilot 10","Pilot 10: bigger feedback + video",4,"low",34
"SUPPRF12547",23,51,0,62,-1,61,63,65,"Pilot 10","Pilot 10: bigger feedback + video",4,"low",-3
"SUPPRF12547",24,50,1,55,-16,56,71,65,"Pilot 10","Pilot 10: bigger feedback + video",4,"low",-10
"SUPPRF12547",25,49,0,54,0,70,54,70,"Pilot 10","Pilot 10: bigger feedback + video",4,"low",-16
"SUPPRF12547",26,53,0,61,24,75,37,25,"Pilot 10","Pilot 10: bigger feedback + video",4,"low",36
"SUPPRF12547",27,58,0,58,12,69,46,55,"Pilot 10","Pilot 10: bigger feedback + video",4,"low",3
"SUPPRF12547",28,50,0,20,0,86,20,8,"Pilot 10","Pilot 10: bigger feedback + video",4,"low",12
"SUPPRF12547",29,52,0,28,-1,70,29,30,"Pilot 10","Pilot 10: bigger feedback + video",4,"low",-2
"SUPPRF12547",30,51,1,56,-15,80,71,75,"Pilot 10","Pilot 10: bigger feedback + video",4,"low",-19
"SUPPRF12547",31,51,1,75,29,27,46,28,"Pilot 10","Pilot 10: bigger feedback + video",4,"low",47
"SUPPRF12547",32,52,1,63,0,78,63,65,"Pilot 10","Pilot 10: bigger feedback + video",4,"low",-2
"SUPPRF12547",33,45,0,70,-1,87,71,54,"Pilot 10","Pilot 10: bigger feedback + video",4,"low",16
"SUPPRF12547",34,48,0,16,-13,60,29,36,"Pilot 10","Pilot 10: bigger feedback + video",4,"low",-20
"SUPPRF12547",35,56,1,71,0,98,71,70,"Pilot 10","Pilot 10: bigger feedback + video",4,"low",1
"SUPPRF12547",36,48,0,34,-12,25,46,37,"Pilot 10","Pilot 10: bigger feedback + video",4,"low",-3
"SUPPRF12547",37,50,0,55,1,51,54,55,"Pilot 10","Pilot 10: bigger feedback + video",4,"low",0
"SUPPRF12547",38,45,0,19,-1,61,20,20,"Pilot 10","Pilot 10: bigger feedback + video",4,"low",-1
"SUPPRF12547",39,40,1,68,-12,51,80,65,"Pilot 10","Pilot 10: bigger feedback + video",4,"low",3
"SUPPRF12547",40,47,0,38,1,75,37,36,"Pilot 10","Pilot 10: bigger feedback + video",4,"low",2
"SUPPRF12547",41,51,1,58,29,77,29,27,"Pilot 10","Pilot 10: bigger feedback + video",4,"low",31
"SUPPRF12547",42,53,1,80,0,72,80,70,"Pilot 10","Pilot 10: bigger feedback + video",4,"low",10
"SUPPRF12547",43,51,1,96,16,79,80,80,"Pilot 10","Pilot 10: bigger feedback + video",4,"low",16
"SUPPRF12547",44,52,1,66,12,71,54,56,"Pilot 10","Pilot 10: bigger feedback + video",4,"low",10
"SUPPRF12547",45,50,0,35,15,80,20,20,"Pilot 10","Pilot 10: bigger feedback + video",4,"low",15
"SUPPRF12547",46,46,3,15,-14,50,29,50,"Pilot 10","Pilot 10: bigger feedback + video",4,"low",-35
"SUPPRF12547",47,49,6,38,-16,76,54,60,"Pilot 10","Pilot 10: bigger feedback + video",4,"low",-22
"SUPPRF12547",48,50,10,47,27,82,20,15,"Pilot 10","Pilot 10: bigger feedback + video",4,"low",32
"SUPPRF12592",1,72,20,80,0,62,80,63,"Pilot 10","Pilot 10: bigger feedback + video",2,"low",17
"SUPPRF12592",2,61,27,77,14,64,63,52,"Pilot 10","Pilot 10: bigger feedback + video",2,"low",25
"SUPPRF12592",3,89,12,96,16,62,80,80,"Pilot 10","Pilot 10: bigger feedback + video",2,"low",16
"SUPPRF12592",4,81,16,33,-13,45,46,53,"Pilot 10","Pilot 10: bigger feedback + video",2,"low",-20
"SUPPRF12592",5,93,4,88,25,24,63,56,"Pilot 10","Pilot 10: bigger feedback + video",2,"low",32
"SUPPRF12592",6,89,5,68,-12,81,80,83,"Pilot 10","Pilot 10: bigger feedback + video",2,"low",-15
"SUPPRF12592",7,84,7,38,1,35,37,22,"Pilot 10","Pilot 10: bigger feedback + video",2,"low",16
"SUPPRF12592",8,91,7,78,24,65,54,67,"Pilot 10","Pilot 10: bigger feedback + video",2,"low",11
"SUPPRF12592",9,98,2,100,20,28,80,57,"Pilot 10","Pilot 10: bigger feedback + video",2,"low",43
"SUPPRF12592",10,94,6,71,0,62,71,61,"Pilot 10","Pilot 10: bigger feedback + video",2,"low",10
"SUPPRF12592",11,96,1,58,29,24,29,43,"Pilot 10","Pilot 10: bigger feedback + video",2,"low",15
"SUPPRF12592",12,94,4,56,-15,78,71,66,"Pilot 10","Pilot 10: bigger feedback + video",2,"low",-10
"SUPPRF12592",13,99,2,83,12,86,71,66,"Pilot 10","Pilot 10: bigger feedback + video",2,"low",17
"SUPPRF12592",14,90,5,22,-15,8,37,36,"Pilot 10","Pilot 10: bigger feedback + video",2,"low",-14
"SUPPRF12592",15,94,3,63,0,31,63,50,"Pilot 10","Pilot 10: bigger feedback + video",2,"low",13
"SUPPRF12592",16,95,3,15,-14,73,29,55,"Pilot 10","Pilot 10: bigger feedback + video",2,"low",-40
"SUPPRF12592",17,92,3,47,-16,19,63,31,"Pilot 10","Pilot 10: bigger feedback + video",2,"low",16
"SUPPRF12592",18,79,3,19,-1,32,20,61,"Pilot 10","Pilot 10: bigger feedback + video",2,"low",-42
"SUPPRF12592",19,90,1,20,0,93,20,22,"Pilot 10","Pilot 10: bigger feedback + video",2,"low",-2
"SUPPRF12592",20,90,3,24,-13,12,37,37,"Pilot 10","Pilot 10: bigger feedback + video",2,"low",-13
"SUPPRF12592",21,84,0,81,1,92,80,93,"Pilot 10","Pilot 10: bigger feedback + video",2,"low",-12
"SUPPRF12592",22,69,1,8,-12,90,20,16,"Pilot 10","Pilot 10: bigger feedback + video",2,"low",-8
"SUPPRF12592",23,72,5,28,-1,32,29,62,"Pilot 10","Pilot 10: bigger feedback + video",2,"low",-34
"SUPPRF12592",24,97,0,61,24,82,37,22,"Pilot 10","Pilot 10: bigger feedback + video",2,"low",39
"SUPPRF12592",25,88,4,75,29,60,46,61,"Pilot 10","Pilot 10: bigger feedback + video",2,"low",14
"SUPPRF12592",26,90,2,46,0,80,46,47,"Pilot 10","Pilot 10: bigger feedback + video",2,"low",-1
"SUPPRF12592",27,94,1,35,15,81,20,37,"Pilot 10","Pilot 10: bigger feedback + video",2,"low",-2
"SUPPRF12592",28,95,0,66,12,73,54,77,"Pilot 10","Pilot 10: bigger feedback + video",2,"low",-11
"SUPPRF12592",29,83,3,16,-13,36,29,38,"Pilot 10","Pilot 10: bigger feedback + video",2,"low",-22
"SUPPRF12592",30,87,3,70,-1,76,71,71,"Pilot 10","Pilot 10: bigger feedback + video",2,"low",-1
"SUPPRF12592",31,95,2,62,-1,17,63,38,"Pilot 10","Pilot 10: bigger feedback + video",2,"low",24
"SUPPRF12592",32,93,1,55,-16,85,71,76,"Pilot 10","Pilot 10: bigger feedback + video",2,"low",-21
"SUPPRF12592",33,93,2,37,0,40,37,55,"Pilot 10","Pilot 10: bigger feedback + video",2,"low",-18
"SUPPRF12592",34,95,1,47,27,80,20,27,"Pilot 10","Pilot 10: bigger feedback + video",2,"low",20
"SUPPRF12592",35,94,3,29,0,60,29,56,"Pilot 10","Pilot 10: bigger feedback + video",2,"low",-27
"SUPPRF12592",36,88,3,38,-16,71,54,48,"Pilot 10","Pilot 10: bigger feedback + video",2,"low",-10
"SUPPRF12592",37,100,0,94,23,34,71,50,"Pilot 10","Pilot 10: bigger feedback + video",2,"low",44
"SUPPRF12592",38,87,0,50,-13,21,63,55,"Pilot 10","Pilot 10: bigger feedback + video",2,"low",-5
"SUPPRF12592",39,86,0,45,-1,35,46,61,"Pilot 10","Pilot 10: bigger feedback + video",2,"low",-16
"SUPPRF12592",40,80,0,55,1,84,54,65,"Pilot 10","Pilot 10: bigger feedback + video",2,"low",-10
"SUPPRF12592",41,75,2,46,17,80,29,32,"Pilot 10","Pilot 10: bigger feedback + video",2,"low",14
"SUPPRF12592",42,73,0,49,12,65,37,38,"Pilot 10","Pilot 10: bigger feedback + video",2,"low",11
"SUPPRF12592",43,75,6,58,12,73,46,42,"Pilot 10","Pilot 10: bigger feedback + video",2,"low",16
"SUPPRF12592",44,75,4,34,-12,71,46,49,"Pilot 10","Pilot 10: bigger feedback + video",2,"low",-15
"SUPPRF12592",45,84,0,6,-14,82,20,32,"Pilot 10","Pilot 10: bigger feedback + video",2,"low",-26
"SUPPRF12592",46,88,0,41,-13,75,54,50,"Pilot 10","Pilot 10: bigger feedback + video",2,"low",-9
"SUPPRF12592",47,75,5,54,0,65,54,45,"Pilot 10","Pilot 10: bigger feedback + video",2,"low",9
"SUPPRF12592",48,80,0,67,-13,74,80,77,"Pilot 10","Pilot 10: bigger feedback + video",2,"low",-10
"SUPPRF12765",1,75,1,68,-12,50,80,70,"Pilot 8","Pilot 8: max feedback + text",5,"low",-2
"SUPPRF12765",2,76,0,24,-13,50,37,44,"Pilot 8","Pilot 8: max feedback + text",5,"low",-20
"SUPPRF12765",3,76,0,55,1,50,54,66,"Pilot 8","Pilot 8: max feedback + text",5,"low",-11
"SUPPRF12765",4,80,75,8,-12,0,20,20,"Pilot 8","Pilot 8: max feedback + text",5,"low",-12
"SUPPRF12765",5,76,0,38,1,0,37,28,"Pilot 8","Pilot 8: max feedback + text",5,"low",10
"SUPPRF12765",6,72,0,47,-16,0,63,65,"Pilot 8","Pilot 8: max feedback + text",5,"low",-18
"SUPPRF12765",7,70,0,28,-1,0,29,12,"Pilot 8","Pilot 8: max feedback + text",5,"low",16
"SUPPRF12765",8,78,0,20,0,100,20,20,"Pilot 8","Pilot 8: max feedback + text",5,"low",0
"SUPPRF12765",9,73,0,62,-1,0,63,65,"Pilot 8","Pilot 8: max feedback + text",5,"low",-3
"SUPPRF12765",10,78,0,22,-15,50,37,48,"Pilot 8","Pilot 8: max feedback + text",5,"low",-26
"SUPPRF12765",11,70,0,41,-13,17,54,61,"Pilot 8","Pilot 8: max feedback + text",5,"low",-20
"SUPPRF12765",12,71,0,100,20,0,80,59,"Pilot 8","Pilot 8: max feedback + text",5,"low",41
"SUPPRF12765",13,84,0,77,14,0,63,58,"Pilot 8","Pilot 8: max feedback + text",5,"low",19
"SUPPRF12765",14,79,0,61,24,0,37,33,"Pilot 8","Pilot 8: max feedback + text",5,"low",28
"SUPPRF12765",15,64,0,37,0,50,37,63,"Pilot 8","Pilot 8: max feedback + text",5,"low",-26
"SUPPRF12765",16,73,0,58,12,0,46,57,"Pilot 8","Pilot 8: max feedback + text",5,"low",1
"SUPPRF12765",17,73,0,46,17,50,29,60,"Pilot 8","Pilot 8: max feedback + text",5,"low",-14
"SUPPRF12765",18,79,0,16,-13,2,29,19,"Pilot 8","Pilot 8: max feedback + text",5,"low",-3
"SUPPRF12765",19,81,0,71,0,0,71,78,"Pilot 8","Pilot 8: max feedback + text",5,"low",-7
"SUPPRF12765",20,73,0,58,29,0,29,71,"Pilot 8","Pilot 8: max feedback + text",5,"low",-13
"SUPPRF12765",21,76,1,33,-13,68,46,66,"Pilot 8","Pilot 8: max feedback + text",5,"low",-33
"SUPPRF12765",22,71,0,15,-14,100,29,33,"Pilot 8","Pilot 8: max feedback + text",5,"low",-18
"SUPPRF12765",23,81,4,34,-12,2,46,43,"Pilot 8","Pilot 8: max feedback + text",5,"low",-9
"SUPPRF12765",24,78,0,96,16,50,80,79,"Pilot 8","Pilot 8: max feedback + text",5,"low",17
"SUPPRF12765",25,72,2,46,0,100,46,23,"Pilot 8","Pilot 8: max feedback + text",5,"low",23
"SUPPRF12765",26,64,0,35,15,100,20,19,"Pilot 8","Pilot 8: max feedback + text",5,"low",16
"SUPPRF12765",27,68,0,49,12,0,37,51,"Pilot 8","Pilot 8: max feedback + text",5,"low",-2
"SUPPRF12765",28,73,0,75,29,55,46,63,"Pilot 8","Pilot 8: max feedback + text",5,"low",12
"SUPPRF12765",29,80,0,47,27,100,20,23,"Pilot 8","Pilot 8: max feedback + text",5,"low",24
"SUPPRF12765",30,75,0,56,-15,95,71,85,"Pilot 8","Pilot 8: max feedback + text",5,"low",-29
"SUPPRF12765",31,72,0,80,0,74,80,83,"Pilot 8","Pilot 8: max feedback + text",5,"low",-3
"SUPPRF12765",32,70,0,54,0,0,54,0,"Pilot 8","Pilot 8: max feedback + text",5,"low",54
"SUPPRF12765",33,65,0,63,0,21,63,61,"Pilot 8","Pilot 8: max feedback + text",5,"low",2
"SUPPRF12765",34,73,0,81,1,11,80,77,"Pilot 8","Pilot 8: max feedback + text",5,"low",4
"SUPPRF12765",35,70,0,67,-13,75,80,57,"Pilot 8","Pilot 8: max feedback + text",5,"low",10
"SUPPRF12765",36,78,0,6,-14,100,20,32,"Pilot 8","Pilot 8: max feedback + text",5,"low",-26
"SUPPRF12765",37,74,3,83,12,100,71,36,"Pilot 8","Pilot 8: max feedback + text",5,"low",47
"SUPPRF12765",38,67,0,38,-16,74,54,61,"Pilot 8","Pilot 8: max feedback + text",5,"low",-23
"SUPPRF12765",39,76,0,50,-13,94,63,30,"Pilot 8","Pilot 8: max feedback + text",5,"low",20
"SUPPRF12765",40,73,0,66,12,0,54,77,"Pilot 8","Pilot 8: max feedback + text",5,"low",-11
"SUPPRF12765",41,77,0,55,-16,73,71,82,"Pilot 8","Pilot 8: max feedback + text",5,"low",-27
"SUPPRF12765",42,77,0,88,25,0,63,54,"Pilot 8","Pilot 8: max feedback + text",5,"low",34
"SUPPRF12765",43,65,1,29,0,77,29,64,"Pilot 8","Pilot 8: max feedback + text",5,"low",-35
"SUPPRF12765",44,74,0,78,24,100,54,55,"Pilot 8","Pilot 8: max feedback + text",5,"low",23
"SUPPRF12765",45,72,0,19,-1,100,20,28,"Pilot 8","Pilot 8: max feedback + text",5,"low",-9
"SUPPRF12765",46,75,0,70,-1,0,71,61,"Pilot 8","Pilot 8: max feedback + text",5,"low",9
"SUPPRF12765",47,74,0,94,23,100,71,72,"Pilot 8","Pilot 8: max feedback + text",5,"low",22
"SUPPRF12765",48,73,0,45,-1,0,46,42,"Pilot 8","Pilot 8: max feedback + text",5,"low",3
"SUPPRF12856",1,49,54,46,17,60,29,40,"Pilot 10","Pilot 10: bigger feedback + video",1,"low",6
"SUPPRF12856",2,52,47,54,0,43,54,48,"Pilot 10","Pilot 10: bigger feedback + video",1,"low",6
"SUPPRF12856",3,39,62,38,-16,68,54,52,"Pilot 10","Pilot 10: bigger feedback + video",1,"low",-14
"SUPPRF12856",4,51,55,71,0,55,71,60,"Pilot 10","Pilot 10: bigger feedback + video",1,"low",11
"SUPPRF12856",5,37,65,55,1,32,54,70,"Pilot 10","Pilot 10: bigger feedback + video",1,"low",-15
"SUPPRF12856",6,40,63,68,-12,32,80,80,"Pilot 10","Pilot 10: bigger feedback + video",1,"low",-12
"SUPPRF12856",7,19,72,6,-14,62,20,30,"Pilot 10","Pilot 10: bigger feedback + video",1,"low",-24
"SUPPRF12856",8,42,73,56,-15,68,71,75,"Pilot 10","Pilot 10: bigger feedback + video",1,"low",-19
"SUPPRF12856",9,41,63,63,0,39,63,75,"Pilot 10","Pilot 10: bigger feedback + video",1,"low",-12
"SUPPRF12856",10,39,48,80,0,35,80,65,"Pilot 10","Pilot 10: bigger feedback + video",1,"low",15
"SUPPRF12856",11,40,43,45,-1,49,46,56,"Pilot 10","Pilot 10: bigger feedback + video",1,"low",-11
"SUPPRF12856",12,43,48,58,12,37,46,50,"Pilot 10","Pilot 10: bigger feedback + video",1,"low",8
"SUPPRF12856",13,37,59,38,1,31,37,33,"Pilot 10","Pilot 10: bigger feedback + video",1,"low",5
"SUPPRF12856",14,38,54,61,24,38,37,26,"Pilot 10","Pilot 10: bigger feedback + video",1,"low",35
"SUPPRF12856",15,47,51,81,1,60,80,67,"Pilot 10","Pilot 10: bigger feedback + video",1,"low",14
"SUPPRF12856",16,43,66,34,-12,16,46,21,"Pilot 10","Pilot 10: bigger feedback + video",1,"low",13
"SUPPRF12856",17,45,55,41,-13,52,54,53,"Pilot 10","Pilot 10: bigger feedback + video",1,"low",-12
"SUPPRF12856",18,56,43,88,25,60,63,60,"Pilot 10","Pilot 10: bigger feedback + video",1,"low",28
"SUPPRF12856",19,37,59,8,-12,75,20,10,"Pilot 10","Pilot 10: bigger feedback + video",1,"low",-2
"SUPPRF12856",20,46,51,47,-16,33,63,63,"Pilot 10","Pilot 10: bigger feedback + video",1,"low",-16
"SUPPRF12856",21,50,39,46,0,52,46,56,"Pilot 10","Pilot 10: bigger feedback + video",1,"low",-10
"SUPPRF12856",22,43,56,28,-1,62,29,50,"Pilot 10","Pilot 10: bigger feedback + video",1,"low",-22
"SUPPRF12856",23,53,59,62,-1,54,63,45,"Pilot 10","Pilot 10: bigger feedback + video",1,"low",17
"SUPPRF12856",24,39,43,33,-13,44,46,60,"Pilot 10","Pilot 10: bigger feedback + video",1,"low",-27
"SUPPRF12856",25,34,37,37,0,22,37,42,"Pilot 10","Pilot 10: bigger feedback + video",1,"low",-5
"SUPPRF12856",26,38,59,55,-16,65,71,70,"Pilot 10","Pilot 10: bigger feedback + video",1,"low",-15
"SUPPRF12856",27,42,57,49,12,27,37,39,"Pilot 10","Pilot 10: bigger feedback + video",1,"low",10
"SUPPRF12856",28,55,49,100,20,60,80,60,"Pilot 10","Pilot 10: bigger feedback + video",1,"low",40
"SUPPRF12856",29,48,64,67,-13,74,80,85,"Pilot 10","Pilot 10: bigger feedback + video",1,"low",-18
"SUPPRF12856",30,38,54,50,-13,39,63,50,"Pilot 10","Pilot 10: bigger feedback + video",1,"low",0
"SUPPRF12856",31,57,51,94,23,65,71,68,"Pilot 10","Pilot 10: bigger feedback + video",1,"low",26
"SUPPRF12856",32,56,50,77,14,28,63,40,"Pilot 10","Pilot 10: bigger feedback + video",1,"low",37
"SUPPRF12856",33,41,41,29,0,67,29,35,"Pilot 10","Pilot 10: bigger feedback + video",1,"low",-6
"SUPPRF12856",34,41,42,70,-1,46,71,60,"Pilot 10","Pilot 10: bigger feedback + video",1,"low",10
"SUPPRF12856",35,40,44,78,24,28,54,50,"Pilot 10","Pilot 10: bigger feedback + video",1,"low",28
"SUPPRF12856",36,39,47,66,12,62,54,60,"Pilot 10","Pilot 10: bigger feedback + video",1,"low",6
"SUPPRF12856",37,33,41,35,15,71,20,16,"Pilot 10","Pilot 10: bigger feedback + video",1,"low",19
"SUPPRF12856",38,45,39,75,29,39,46,54,"Pilot 10","Pilot 10: bigger feedback + video",1,"low",21
"SUPPRF12856",39,58,47,96,16,79,80,80,"Pilot 10","Pilot 10: bigger feedback + video",1,"low",16
"SUPPRF12856",40,38,52,19,-1,69,20,15,"Pilot 10","Pilot 10: bigger feedback + video",1,"low",4
"SUPPRF12856",41,36,40,15,-14,72,29,20,"Pilot 10","Pilot 10: bigger feedback + video",1,"low",-5
"SUPPRF12856",42,42,41,47,27,75,20,11,"Pilot 10","Pilot 10: bigger feedback + video",1,"low",36
"SUPPRF12856",43,33,61,24,-13,17,37,57,"Pilot 10","Pilot 10: bigger feedback + video",1,"low",-33
"SUPPRF12856",44,42,61,58,29,56,29,32,"Pilot 10","Pilot 10: bigger feedback + video",1,"low",26
"SUPPRF12856",45,54,59,83,12,65,71,82,"Pilot 10","Pilot 10: bigger feedback + video",1,"low",1
"SUPPRF12856",46,43,60,16,-13,39,29,30,"Pilot 10","Pilot 10: bigger feedback + video",1,"low",-14
"SUPPRF12856",47,39,66,22,-15,40,37,70,"Pilot 10","Pilot 10: bigger feedback + video",1,"low",-48
"SUPPRF12856",48,41,51,20,0,73,20,7,"Pilot 10","Pilot 10: bigger feedback + video",1,"low",13
"SUPPRF13138",1,62,57,97,17,69,80,72,"Pilot 6","Pilot 6: feedback + text",7,"high",25
"SUPPRF13138",2,57,51,55,1,64,54,42,"Pilot 6","Pilot 6: feedback + text",7,"high",13
"SUPPRF13138",3,47,52,68,14,65,54,56,"Pilot 6","Pilot 6: feedback + text",7,"high",12
"SUPPRF13138",4,49,58,50,-13,59,63,55,"Pilot 6","Pilot 6: feedback + text",7,"high",-5
"SUPPRF13138",5,48,45,48,19,59,29,35,"Pilot 6","Pilot 6: feedback + text",7,"high",13
"SUPPRF13138",6,40,71,20,0,100,20,99,"Pilot 6","Pilot 6: feedback + text",7,"high",-79
"SUPPRF13138",7,45,57,51,14,53,37,39,"Pilot 6","Pilot 6: feedback + text",7,"high",12
"SUPPRF13138",8,44,44,34,-12,60,46,58,"Pilot 6","Pilot 6: feedback + text",7,"high",-24
"SUPPRF13138",9,51,39,80,0,85,80,84,"Pilot 6","Pilot 6: feedback + text",7,"high",-4
"SUPPRF13138",10,50,36,77,14,57,63,55,"Pilot 6","Pilot 6: feedback + text",7,"high",22
"SUPPRF13138",11,48,41,58,12,84,46,60,"Pilot 6","Pilot 6: feedback + text",7,"high",-2
"SUPPRF13138",12,50,40,15,-14,90,29,8,"Pilot 6","Pilot 6: feedback + text",7,"high",7
"SUPPRF13138",13,51,37,70,-1,53,71,65,"Pilot 6","Pilot 6: feedback + text",7,"high",5
"SUPPRF13138",14,43,34,35,15,58,20,66,"Pilot 6","Pilot 6: feedback + text",7,"high",-31
"SUPPRF13138",15,40,27,49,12,59,37,28,"Pilot 6","Pilot 6: feedback + text",7,"high",21
"SUPPRF13138",16,51,28,41,-13,80,54,66,"Pilot 6","Pilot 6: feedback + text",7,"high",-25
"SUPPRF13138",17,53,34,81,1,64,80,55,"Pilot 6","Pilot 6: feedback + text",7,"high",26
"SUPPRF13138",18,50,36,65,19,95,46,44,"Pilot 6","Pilot 6: feedback + text",7,"high",21
"SUPPRF13138",19,50,20,46,17,43,29,40,"Pilot 6","Pilot 6: feedback + text",7,"high",6
"SUPPRF13138",20,47,21,38,-16,58,54,60,"Pilot 6","Pilot 6: feedback + text",7,"high",-22
"SUPPRF13138",21,56,16,67,-13,76,80,70,"Pilot 6","Pilot 6: feedback + text",7,"high",-3
"SUPPRF13138",22,36,24,46,0,55,46,50,"Pilot 6","Pilot 6: feedback + text",7,"high",-4
"SUPPRF13138",23,33,34,78,15,53,63,49,"Pilot 6","Pilot 6: feedback + text",7,"high",29
"SUPPRF13138",24,22,20,24,-13,79,37,34,"Pilot 6","Pilot 6: feedback + text",7,"high",-10
"SUPPRF13138",25,63,19,28,-1,76,29,30,"Pilot 6","Pilot 6: feedback + text",7,"high",-2
"SUPPRF13138",26,50,41,56,-15,87,71,71,"Pilot 6","Pilot 6: feedback + text",7,"high",-15
"SUPPRF13138",27,62,25,66,12,85,54,58,"Pilot 6","Pilot 6: feedback + text",7,"high",8
"SUPPRF13138",28,34,22,71,0,27,71,52,"Pilot 6","Pilot 6: feedback + text",7,"high",19
"SUPPRF13138",29,37,23,38,1,55,37,36,"Pilot 6","Pilot 6: feedback + text",7,"high",2
"SUPPRF13138",30,26,5,47,-16,79,63,60,"Pilot 6","Pilot 6: feedback + text",7,"high",-13
"SUPPRF13138",31,11,7,6,-14,62,20,10,"Pilot 6","Pilot 6: feedback + text",7,"high",-4
"SUPPRF13138",32,7,18,54,0,18,54,45,"Pilot 6","Pilot 6: feedback + text",7,"high",9
"SUPPRF13138",33,15,0,68,-12,83,80,86,"Pilot 6","Pilot 6: feedback + text",7,"high",-18
"SUPPRF13138",34,0,8,29,0,34,29,14,"Pilot 6","Pilot 6: feedback + text",7,"high",15
"SUPPRF13138",35,0,1,96,16,40,80,70,"Pilot 6","Pilot 6: feedback + text",7,"high",26
"SUPPRF13138",36,0,12,62,-1,48,63,49,"Pilot 6","Pilot 6: feedback + text",7,"high",13
"SUPPRF13138",37,0,22,19,-1,53,20,4,"Pilot 6","Pilot 6: feedback + text",7,"high",15
"SUPPRF13138",38,0,24,33,-13,60,46,47,"Pilot 6","Pilot 6: feedback + text",7,"high",-14
"SUPPRF13138",39,0,31,63,0,69,63,51,"Pilot 6","Pilot 6: feedback + text",7,"high",12
"SUPPRF13138",40,0,34,37,0,88,37,55,"Pilot 6","Pilot 6: feedback + text",7,"high",-18
"SUPPRF13138",41,0,43,37,17,88,20,12,"Pilot 6","Pilot 6: feedback + text",7,"high",25
"SUPPRF13138",42,0,50,55,-16,7,71,51,"Pilot 6","Pilot 6: feedback + text",7,"high",4
"SUPPRF13138",43,0,61,22,-15,72,37,19,"Pilot 6","Pilot 6: feedback + text",7,"high",3
"SUPPRF13138",44,0,66,83,12,0,71,50,"Pilot 6","Pilot 6: feedback + text",7,"high",33
"SUPPRF13138",45,0,66,84,13,88,71,65,"Pilot 6","Pilot 6: feedback + text",7,"high",19
"SUPPRF13138",46,0,71,8,-12,2,20,50,"Pilot 6","Pilot 6: feedback + text",7,"high",-42
"SUPPRF13138",47,0,74,45,-1,81,46,48,"Pilot 6","Pilot 6: feedback + text",7,"high",-3
"SUPPRF13138",48,0,77,16,-13,0,29,52,"Pilot 6","Pilot 6: feedback + text",7,"high",-36
"SUPPRF13297",1,3,100,34,-12,28,46,34,"Pilot 11","Pilot 11: bigger feedback + video + socially anxious",11,"high",0
"SUPPRF13297",2,0,100,20,0,87,20,8,"Pilot 11","Pilot 11: bigger feedback + video + socially anxious",11,"high",12
"SUPPRF13297",3,0,100,56,-15,37,71,72,"Pilot 11","Pilot 11: bigger feedback + video + socially anxious",11,"high",-16
"SUPPRF13297",4,0,100,41,-13,38,54,53,"Pilot 11","Pilot 11: bigger feedback + video + socially anxious",11,"high",-12
"SUPPRF13297",5,35,78,83,12,2,71,43,"Pilot 11","Pilot 11: bigger feedback + video + socially anxious",11,"high",40
"SUPPRF13297",6,50,41,77,14,0,63,69,"Pilot 11","Pilot 11: bigger feedback + video + socially anxious",11,"high",8
"SUPPRF13297",7,85,17,47,27,76,20,0,"Pilot 11","Pilot 11: bigger feedback + video + socially anxious",11,"high",47
"SUPPRF13297",8,9,95,8,-12,80,20,13,"Pilot 11","Pilot 11: bigger feedback + video + socially anxious",11,"high",-5
"SUPPRF13297",9,0,100,6,-14,100,20,14,"Pilot 11","Pilot 11: bigger feedback + video + socially anxious",11,"high",-8
"SUPPRF13297",10,12,82,19,-1,99,20,1,"Pilot 11","Pilot 11: bigger feedback + video + socially anxious",11,"high",18
"SUPPRF13297",11,6,100,50,-13,89,63,73,"Pilot 11","Pilot 11: bigger feedback + video + socially anxious",11,"high",-23
"SUPPRF13297",12,100,0,100,20,92,80,100,"Pilot 11","Pilot 11: bigger feedback + video + socially anxious",11,"high",0
"SUPPRF13297",13,81,26,46,17,73,29,25,"Pilot 11","Pilot 11: bigger feedback + video + socially anxious",11,"high",21
"SUPPRF13297",14,3,100,16,-13,34,29,46,"Pilot 11","Pilot 11: bigger feedback + video + socially anxious",11,"high",-30
"SUPPRF13297",15,19,85,35,15,94,20,3,"Pilot 11","Pilot 11: bigger feedback + video + socially anxious",11,"high",32
"SUPPRF13297",16,1,98,58,12,92,46,82,"Pilot 11","Pilot 11: bigger feedback + video + socially anxious",11,"high",-24
"SUPPRF13297",17,9,84,45,-1,74,46,43,"Pilot 11","Pilot 11: bigger feedback + video + socially anxious",11,"high",2
"SUPPRF13297",18,0,100,55,-16,97,71,76,"Pilot 11","Pilot 11: bigger feedback + video + socially anxious",11,"high",-21
"SUPPRF13297",19,18,95,67,-13,92,80,76,"Pilot 11","Pilot 11: bigger feedback + video + socially anxious",11,"high",-9
"SUPPRF13297",20,36,81,70,-1,42,71,73,"Pilot 11","Pilot 11: bigger feedback + video + socially anxious",11,"high",-3
"SUPPRF13297",21,0,100,15,-14,23,29,59,"Pilot 11","Pilot 11: bigger feedback + video + socially anxious",11,"high",-44
"SUPPRF13297",22,0,100,68,-12,99,80,86,"Pilot 11","Pilot 11: bigger feedback + video + socially anxious",11,"high",-18
"SUPPRF13297",23,76,49,78,24,36,54,74,"Pilot 11","Pilot 11: bigger feedback + video + socially anxious",11,"high",4
"SUPPRF13297",24,15,93,37,0,94,37,29,"Pilot 11","Pilot 11: bigger feedback + video + socially anxious",11,"high",8
"SUPPRF13297",25,84,37,62,-1,24,63,49,"Pilot 11","Pilot 11: bigger feedback + video + socially anxious",11,"high",13
"SUPPRF13297",26,92,6,94,23,72,71,59,"Pilot 11","Pilot 11: bigger feedback + video + socially anxious",11,"high",35
"SUPPRF13297",27,0,100,38,-16,56,54,71,"Pilot 11","Pilot 11: bigger feedback + video + socially anxious",11,"high",-33
"SUPPRF13297",28,14,84,29,0,35,29,58,"Pilot 11","Pilot 11: bigger feedback + video + socially anxious",11,"high",-29
"SUPPRF13297",29,0,100,22,-15,36,37,55,"Pilot 11","Pilot 11: bigger feedback + video + socially anxious",11,"high",-33
"SUPPRF13297",30,34,70,49,12,95,37,34,"Pilot 11","Pilot 11: bigger feedback + video + socially anxious",11,"high",15
"SUPPRF13297",31,10,85,28,-1,9,29,26,"Pilot 11","Pilot 11: bigger feedback + video + socially anxious",11,"high",2
"SUPPRF13297",32,66,33,63,0,32,63,44,"Pilot 11","Pilot 11: bigger feedback + video + socially anxious",11,"high",19
"SUPPRF13297",33,42,47,46,0,23,46,52,"Pilot 11","Pilot 11: bigger feedback + video + socially anxious",11,"high",-6
"SUPPRF13297",34,55,35,75,29,56,46,69,"Pilot 11","Pilot 11: bigger feedback + video + socially anxious",11,"high",6
"SUPPRF13297",35,0,97,24,-13,39,37,68,"Pilot 11","Pilot 11: bigger feedback + video + socially anxious",11,"high",-44
"SUPPRF13297",36,91,21,96,16,79,80,77,"Pilot 11","Pilot 11: bigger feedback + video + socially anxious",11,"high",19
"SUPPRF13297",37,85,21,80,0,79,80,65,"Pilot 11","Pilot 11: bigger feedback + video + socially anxious",11,"high",15
"SUPPRF13297",38,67,35,58,29,90,29,37,"Pilot 11","Pilot 11: bigger feedback + video + socially anxious",11,"high",21
"SUPPRF13297",39,79,33,66,12,18,54,52,"Pilot 11","Pilot 11: bigger feedback + video + socially anxious",11,"high",14
"SUPPRF13297",40,49,44,47,-16,25,63,57,"Pilot 11","Pilot 11: bigger feedback + video + socially anxious",11,"high",-10
"SUPPRF13297",41,77,26,81,1,97,80,88,"Pilot 11","Pilot 11: bigger feedback + video + socially anxious",11,"high",-7
"SUPPRF13297",42,71,6,88,25,37,63,52,"Pilot 11","Pilot 11: bigger feedback + video + socially anxious",11,"high",36
"SUPPRF13297",43,63,36,61,24,31,37,59,"Pilot 11","Pilot 11: bigger feedback + video + socially anxious",11,"high",2
"SUPPRF13297",44,32,76,38,1,8,37,24,"Pilot 11","Pilot 11: bigger feedback + video + socially anxious",11,"high",14
"SUPPRF13297",45,68,28,54,0,16,54,61,"Pilot 11","Pilot 11: bigger feedback + video + socially anxious",11,"high",-7
"SUPPRF13297",46,67,40,55,1,25,54,57,"Pilot 11","Pilot 11: bigger feedback + video + socially anxious",11,"high",-2
"SUPPRF13297",47,25,91,33,-13,35,46,55,"Pilot 11","Pilot 11: bigger feedback + video + socially anxious",11,"high",-22
"SUPPRF13297",48,63,48,71,0,18,71,60,"Pilot 11","Pilot 11: bigger feedback + video + socially anxious",11,"high",11
"SUPPRF13951",1,54,13,94,23,88,71,70,"Pilot 10","Pilot 10: bigger feedback + video",9,"high",24
"SUPPRF13951",2,58,11,96,16,78,80,75,"Pilot 10","Pilot 10: bigger feedback + video",9,"high",21
"SUPPRF13951",3,55,5,62,-1,80,63,60,"Pilot 10","Pilot 10: bigger feedback + video",9,"high",2
"SUPPRF13951",4,58,5,58,12,83,46,48,"Pilot 10","Pilot 10: bigger feedback + video",9,"high",10
"SUPPRF13951",5,57,2,75,29,83,46,53,"Pilot 10","Pilot 10: bigger feedback + video",9,"high",22
"SUPPRF13951",6,59,0,47,27,91,20,25,"Pilot 10","Pilot 10: bigger feedback + video",9,"high",22
"SUPPRF13951",7,57,0,70,-1,15,71,50,"Pilot 10","Pilot 10: bigger feedback + video",9,"high",20
"SUPPRF13951",8,59,0,29,0,75,29,35,"Pilot 10","Pilot 10: bigger feedback + video",9,"high",-6
"SUPPRF13951",9,55,0,68,-12,80,80,80,"Pilot 10","Pilot 10: bigger feedback + video",9,"high",-12
"SUPPRF13951",10,55,0,16,-13,58,29,35,"Pilot 10","Pilot 10: bigger feedback + video",9,"high",-19
"SUPPRF13951",11,50,0,50,-13,64,63,78,"Pilot 10","Pilot 10: bigger feedback + video",9,"high",-28
"SUPPRF13951",12,51,0,38,-16,74,54,56,"Pilot 10","Pilot 10: bigger feedback + video",9,"high",-18
"SUPPRF13951",13,50,0,35,15,62,20,23,"Pilot 10","Pilot 10: bigger feedback + video",9,"high",12
"SUPPRF13951",14,50,0,34,-12,29,46,59,"Pilot 10","Pilot 10: bigger feedback + video",9,"high",-25
"SUPPRF13951",15,50,0,19,-1,41,20,28,"Pilot 10","Pilot 10: bigger feedback + video",9,"high",-9
"SUPPRF13951",16,50,0,6,-14,30,20,25,"Pilot 10","Pilot 10: bigger feedback + video",9,"high",-19
"SUPPRF13951",17,50,0,71,0,7,71,68,"Pilot 10","Pilot 10: bigger feedback + video",9,"high",3
"SUPPRF13951",18,51,0,67,-13,21,80,79,"Pilot 10","Pilot 10: bigger feedback + video",9,"high",-12
"SUPPRF13951",19,50,0,38,1,15,37,52,"Pilot 10","Pilot 10: bigger feedback + video",9,"high",-14
"SUPPRF13951",20,49,0,46,0,19,46,51,"Pilot 10","Pilot 10: bigger feedback + video",9,"high",-5
"SUPPRF13951",21,48,0,49,12,15,37,43,"Pilot 10","Pilot 10: bigger feedback + video",9,"high",6
"SUPPRF13951",22,47,0,58,29,7,29,27,"Pilot 10","Pilot 10: bigger feedback + video",9,"high",31
"SUPPRF13951",23,48,0,54,0,28,54,56,"Pilot 10","Pilot 10: bigger feedback + video",9,"high",-2
"SUPPRF13951",24,45,0,56,-15,23,71,70,"Pilot 10","Pilot 10: bigger feedback + video",9,"high",-14
"SUPPRF13951",25,48,0,28,-1,20,29,26,"Pilot 10","Pilot 10: bigger feedback + video",9,"high",2
"SUPPRF13951",26,48,0,100,20,26,80,25,"Pilot 10","Pilot 10: bigger feedback + video",9,"high",75
"SUPPRF13951",27,46,0,33,-13,17,46,44,"Pilot 10","Pilot 10: bigger feedback + video",9,"high",-11
"SUPPRF13951",28,46,0,47,-16,22,63,54,"Pilot 10","Pilot 10: bigger feedback + video",9,"high",-7
"SUPPRF13951",29,46,0,63,0,19,63,55,"Pilot 10","Pilot 10: bigger feedback + video",9,"high",8
"SUPPRF13951",30,45,0,22,-15,23,37,59,"Pilot 10","Pilot 10: bigger feedback + video",9,"high",-37
"SUPPRF13951",31,45,0,78,24,21,54,32,"Pilot 10","Pilot 10: bigger feedback + video",9,"high",46
"SUPPRF13951",32,43,0,45,-1,25,46,46,"Pilot 10","Pilot 10: bigger feedback + video",9,"high",-1
"SUPPRF13951",33,43,0,46,17,29,29,29,"Pilot 10","Pilot 10: bigger feedback + video",9,"high",17
"SUPPRF13951",34,44,0,15,-14,22,29,30,"Pilot 10","Pilot 10: bigger feedback + video",9,"high",-15
"SUPPRF13951",35,42,0,77,14,6,63,67,"Pilot 10","Pilot 10: bigger feedback + video",9,"high",10
"SUPPRF13951",36,44,0,61,24,3,37,42,"Pilot 10","Pilot 10: bigger feedback + video",9,"high",19
"SUPPRF13951",37,41,0,80,0,9,80,82,"Pilot 10","Pilot 10: bigger feedback + video",9,"high",-2
"SUPPRF13951",38,43,0,20,0,16,20,25,"Pilot 10","Pilot 10: bigger feedback + video",9,"high",-5
"SUPPRF13951",39,42,0,81,1,21,80,80,"Pilot 10","Pilot 10: bigger feedback + video",9,"high",1
"SUPPRF13951",40,38,0,37,0,8,37,63,"Pilot 10","Pilot 10: bigger feedback + video",9,"high",-26
"SUPPRF13951",41,42,0,41,-13,14,54,64,"Pilot 10","Pilot 10: bigger feedback + video",9,"high",-23
"SUPPRF13951",42,43,0,83,12,16,71,64,"Pilot 10","Pilot 10: bigger feedback + video",9,"high",19
"SUPPRF13951",43,42,0,88,25,4,63,70,"Pilot 10","Pilot 10: bigger feedback + video",9,"high",18
"SUPPRF13951",44,42,0,24,-13,16,37,56,"Pilot 10","Pilot 10: bigger feedback + video",9,"high",-32
"SUPPRF13951",45,40,0,66,12,13,54,58,"Pilot 10","Pilot 10: bigger feedback + video",9,"high",8
"SUPPRF13951",46,42,0,55,1,14,54,60,"Pilot 10","Pilot 10: bigger feedback + video",9,"high",-5
"SUPPRF13951",47,40,0,8,-12,15,20,27,"Pilot 10","Pilot 10: bigger feedback + video",9,"high",-19
"SUPPRF13951",48,37,0,55,-16,17,71,68,"Pilot 10","Pilot 10: bigger feedback + video",9,"high",-13
"SUPPRF14083",1,53,65,15,-14,70,29,32,"Pilot 7","Pilot 7: bigger feedback + text",6,"high",-17
"SUPPRF14083",2,46,64,46,0,55,46,54,"Pilot 7","Pilot 7: bigger feedback + text",6,"high",-8
"SUPPRF14083",3,51,59,70,-1,48,71,75,"Pilot 7","Pilot 7: bigger feedback + text",6,"high",-5
"SUPPRF14083",4,42,63,24,-13,3,37,19,"Pilot 7","Pilot 7: bigger feedback + text",6,"high",5
"SUPPRF14083",5,45,53,22,-15,43,37,28,"Pilot 7","Pilot 7: bigger feedback + text",6,"high",-6
"SUPPRF14083",6,48,57,65,19,59,46,44,"Pilot 7","Pilot 7: bigger feedback + text",6,"high",21
"SUPPRF14083",7,45,53,55,-16,78,71,86,"Pilot 7","Pilot 7: bigger feedback + text",6,"high",-31
"SUPPRF14083",8,61,52,84,13,61,71,70,"Pilot 7","Pilot 7: bigger feedback + text",6,"high",14
"SUPPRF14083",9,54,55,29,0,61,29,42,"Pilot 7","Pilot 7: bigger feedback + text",6,"high",-13
"SUPPRF14083",10,58,48,68,-12,74,80,75,"Pilot 7","Pilot 7: bigger feedback + text",6,"high",-7
"SUPPRF14083",11,64,44,54,0,31,54,60,"Pilot 7","Pilot 7: bigger feedback + text",6,"high",-6
"SUPPRF14083",12,32,58,6,-14,62,20,29,"Pilot 7","Pilot 7: bigger feedback + text",6,"high",-23
"SUPPRF14083",13,43,50,38,-16,56,54,50,"Pilot 7","Pilot 7: bigger feedback + text",6,"high",-12
"SUPPRF14083",14,59,54,67,-13,68,80,61,"Pilot 7","Pilot 7: bigger feedback + text",6,"high",6
"SUPPRF14083",15,67,48,80,0,62,80,52,"Pilot 7","Pilot 7: bigger feedback + text",6,"high",28
"SUPPRF14083",16,23,47,8,-12,70,20,18,"Pilot 7","Pilot 7: bigger feedback + text",6,"high",-10
"SUPPRF14083",17,52,44,77,14,83,63,19,"Pilot 7","Pilot 7: bigger feedback + text",6,"high",58
"SUPPRF14083",18,56,46,46,17,40,29,48,"Pilot 7","Pilot 7: bigger feedback + text",6,"high",-2
"SUPPRF14083",19,58,48,49,12,58,37,52,"Pilot 7","Pilot 7: bigger feedback + text",6,"high",-3
"SUPPRF14083",20,58,57,35,15,95,20,5,"Pilot 7","Pilot 7: bigger feedback + text",6,"high",30
"SUPPRF14083",21,61,36,83,12,66,71,75,"Pilot 7","Pilot 7: bigger feedback + text",6,"high",8
"SUPPRF14083",22,59,44,19,-1,76,20,12,"Pilot 7","Pilot 7: bigger feedback + text",6,"high",7
"SUPPRF14083",23,51,59,56,-15,70,71,62,"Pilot 7","Pilot 7: bigger feedback + text",6,"high",-6
"SUPPRF14083",24,56,44,50,-13,71,63,63,"Pilot 7","Pilot 7: bigger feedback + text",6,"high",-13
"SUPPRF14083",25,70,37,48,19,74,29,27,"Pilot 7","Pilot 7: bigger feedback + text",6,"high",21
"SUPPRF14083",26,68,36,55,1,63,54,41,"Pilot 7","Pilot 7: bigger feedback + text",6,"high",14
"SUPPRF14083",27,57,45,45,-1,40,46,24,"Pilot 7","Pilot 7: bigger feedback + text",6,"high",21
"SUPPRF14083",28,49,49,16,-13,85,29,17,"Pilot 7","Pilot 7: bigger feedback + text",6,"high",-1
"SUPPRF14083",29,39,58,41,-13,78,54,73,"Pilot 7","Pilot 7: bigger feedback + text",6,"high",-32
"SUPPRF14083",30,56,44,63,0,54,63,61,"Pilot 7","Pilot 7: bigger feedback + text",6,"high",2
"SUPPRF14083",31,56,49,62,-1,77,63,68,"Pilot 7","Pilot 7: bigger feedback + text",6,"high",-6
"SUPPRF14083",32,58,48,66,12,64,54,51,"Pilot 7","Pilot 7: bigger feedback + text",6,"high",15
"SUPPRF14083",33,52,49,20,0,66,20,9,"Pilot 7","Pilot 7: bigger feedback + text",6,"high",11
"SUPPRF14083",34,63,43,37,17,73,20,10,"Pilot 7","Pilot 7: bigger feedback + text",6,"high",27
"SUPPRF14083",35,68,45,97,17,84,80,70,"Pilot 7","Pilot 7: bigger feedback + text",6,"high",27
"SUPPRF14083",36,54,45,51,14,48,37,60,"Pilot 7","Pilot 7: bigger feedback + text",6,"high",-9
"SUPPRF14083",37,57,44,58,12,80,46,52,"Pilot 7","Pilot 7: bigger feedback + text",6,"high",6
"SUPPRF14083",38,60,41,71,0,77,71,69,"Pilot 7","Pilot 7: bigger feedback + text",6,"high",2
"SUPPRF14083",39,61,42,68,14,72,54,61,"Pilot 7","Pilot 7: bigger feedback + text",6,"high",7
"SUPPRF14083",40,65,44,81,1,71,80,63,"Pilot 7","Pilot 7: bigger feedback + text",6,"high",18
"SUPPRF14083",41,52,46,34,-12,61,46,64,"Pilot 7","Pilot 7: bigger feedback + text",6,"high",-30
"SUPPRF14083",42,54,50,33,-13,70,46,33,"Pilot 7","Pilot 7: bigger feedback + text",6,"high",0
"SUPPRF14083",43,52,50,38,1,61,37,50,"Pilot 7","Pilot 7: bigger feedback + text",6,"high",-12
"SUPPRF14083",44,68,43,96,16,79,80,83,"Pilot 7","Pilot 7: bigger feedback + text",6,"high",13
"SUPPRF14083",45,50,47,28,-1,61,29,46,"Pilot 7","Pilot 7: bigger feedback + text",6,"high",-18
"SUPPRF14083",46,53,48,37,0,61,37,52,"Pilot 7","Pilot 7: bigger feedback + text",6,"high",-15
"SUPPRF14083",47,54,41,47,-16,47,63,39,"Pilot 7","Pilot 7: bigger feedback + text",6,"high",8
"SUPPRF14083",48,56,46,78,15,56,63,44,"Pilot 7","Pilot 7: bigger feedback + text",6,"high",34
"SUPPRF14173",1,53,53,54,0,77,54,54,"Pilot 10","Pilot 10: bigger feedback + video",2,"low",0
"SUPPRF14173",2,54,50,71,0,52,71,73,"Pilot 10","Pilot 10: bigger feedback + video",2,"low",-2
"SUPPRF14173",3,52,53,94,23,73,71,80,"Pilot 10","Pilot 10: bigger feedback + video",2,"low",14
"SUPPRF14173",4,52,53,66,12,64,54,75,"Pilot 10","Pilot 10: bigger feedback + video",2,"low",-9
"SUPPRF14173",5,51,52,15,-14,78,29,30,"Pilot 10","Pilot 10: bigger feedback + video",2,"low",-15
"SUPPRF14173",6,51,51,62,-1,59,63,48,"Pilot 10","Pilot 10: bigger feedback + video",2,"low",14
"SUPPRF14173",7,52,51,46,17,56,29,23,"Pilot 10","Pilot 10: bigger feedback + video",2,"low",23
"SUPPRF14173",8,50,53,41,-13,58,54,58,"Pilot 10","Pilot 10: bigger feedback + video",2,"low",-17
"SUPPRF14173",9,50,43,63,0,74,63,55,"Pilot 10","Pilot 10: bigger feedback + video",2,"low",8
"SUPPRF14173",10,61,49,61,24,21,37,73,"Pilot 10","Pilot 10: bigger feedback + video",2,"low",-12
"SUPPRF14173",11,59,45,47,27,36,20,49,"Pilot 10","Pilot 10: bigger feedback + video",2,"low",-2
"SUPPRF14173",12,58,41,56,-15,46,71,55,"Pilot 10","Pilot 10: bigger feedback + video",2,"low",1
"SUPPRF14173",13,65,41,70,-1,47,71,63,"Pilot 10","Pilot 10: bigger feedback + video",2,"low",7
"SUPPRF14173",14,66,43,58,12,66,46,54,"Pilot 10","Pilot 10: bigger feedback + video",2,"low",4
"SUPPRF14173",15,58,37,28,-1,74,29,26,"Pilot 10","Pilot 10: bigger feedback + video",2,"low",2
"SUPPRF14173",16,51,52,45,-1,74,46,85,"Pilot 10","Pilot 10: bigger feedback + video",2,"low",-40
"SUPPRF14173",17,67,35,83,12,63,71,53,"Pilot 10","Pilot 10: bigger feedback + video",2,"low",30
"SUPPRF14173",18,53,49,67,-13,77,80,67,"Pilot 10","Pilot 10: bigger feedback + video",2,"low",0
"SUPPRF14173",19,36,60,22,-15,37,37,64,"Pilot 10","Pilot 10: bigger feedback + video",2,"low",-42
"SUPPRF14173",20,65,40,81,1,79,80,82,"Pilot 10","Pilot 10: bigger feedback + video",2,"low",-1
"SUPPRF14173",21,50,63,24,-13,75,37,71,"Pilot 10","Pilot 10: bigger feedback + video",2,"low",-47
"SUPPRF14173",22,51,50,46,0,69,46,73,"Pilot 10","Pilot 10: bigger feedback + video",2,"low",-27
"SUPPRF14173",23,33,47,38,-16,63,54,75,"Pilot 10","Pilot 10: bigger feedback + video",2,"low",-37
"SUPPRF14173",24,44,54,8,-12,85,20,20,"Pilot 10","Pilot 10: bigger feedback + video",2,"low",-12
"SUPPRF14173",25,47,51,20,0,75,20,17,"Pilot 10","Pilot 10: bigger feedback + video",2,"low",3
"SUPPRF14173",26,42,62,16,-13,52,29,49,"Pilot 10","Pilot 10: bigger feedback + video",2,"low",-33
"SUPPRF14173",27,67,52,77,14,69,63,74,"Pilot 10","Pilot 10: bigger feedback + video",2,"low",3
"SUPPRF14173",28,61,41,78,24,59,54,61,"Pilot 10","Pilot 10: bigger feedback + video",2,"low",17
"SUPPRF14173",29,59,41,49,12,57,37,37,"Pilot 10","Pilot 10: bigger feedback + video",2,"low",12
"SUPPRF14173",30,44,40,33,-13,46,46,49,"Pilot 10","Pilot 10: bigger feedback + video",2,"low",-16
"SUPPRF14173",31,64,43,75,29,53,46,68,"Pilot 10","Pilot 10: bigger feedback + video",2,"low",7
"SUPPRF14173",32,52,62,68,-12,74,80,68,"Pilot 10","Pilot 10: bigger feedback + video",2,"low",0
"SUPPRF14173",33,53,47,47,-16,68,63,60,"Pilot 10","Pilot 10: bigger feedback + video",2,"low",-13
"SUPPRF14173",34,44,53,34,-12,62,46,62,"Pilot 10","Pilot 10: bigger feedback + video",2,"low",-28
"SUPPRF14173",35,47,67,6,-14,49,20,15,"Pilot 10","Pilot 10: bigger feedback + video",2,"low",-9
"SUPPRF14173",36,50,55,58,29,65,29,63,"Pilot 10","Pilot 10: bigger feedback + video",2,"low",-5
"SUPPRF14173",37,51,39,35,15,49,20,25,"Pilot 10","Pilot 10: bigger feedback + video",2,"low",10
"SUPPRF14173",38,71,42,96,16,72,80,62,"Pilot 10","Pilot 10: bigger feedback + video",2,"low",34
"SUPPRF14173",39,63,40,55,1,61,54,70,"Pilot 10","Pilot 10: bigger feedback + video",2,"low",-15
"SUPPRF14173",40,53,51,37,0,61,37,56,"Pilot 10","Pilot 10: bigger feedback + video",2,"low",-19
"SUPPRF14173",41,51,52,55,-16,30,71,55,"Pilot 10","Pilot 10: bigger feedback + video",2,"low",0
"SUPPRF14173",42,53,56,50,-13,38,63,42,"Pilot 10","Pilot 10: bigger feedback + video",2,"low",8
"SUPPRF14173",43,43,65,38,1,66,37,22,"Pilot 10","Pilot 10: bigger feedback + video",2,"low",16
"SUPPRF14173",44,31,63,19,-1,53,20,23,"Pilot 10","Pilot 10: bigger feedback + video",2,"low",-4
"SUPPRF14173",45,52,51,29,0,69,29,52,"Pilot 10","Pilot 10: bigger feedback + video",2,"low",-23
"SUPPRF14173",46,36,48,100,20,68,80,58,"Pilot 10","Pilot 10: bigger feedback + video",2,"low",42
"SUPPRF14173",47,57,51,80,0,61,80,75,"Pilot 10","Pilot 10: bigger feedback + video",2,"low",5
"SUPPRF14173",48,52,48,88,25,32,63,53,"Pilot 10","Pilot 10: bigger feedback + video",2,"low",35
"SUPPRF14681",1,60,74,88,25,68,63,24,"Pilot 8","Pilot 8: max feedback + text",11,"high",64
"SUPPRF14681",2,50,78,49,12,57,37,51,"Pilot 8","Pilot 8: max feedback + text",11,"high",-2
"SUPPRF14681",3,66,63,61,24,47,37,26,"Pilot 8","Pilot 8: max feedback + text",11,"high",35
"SUPPRF14681",4,51,91,34,-12,54,46,37,"Pilot 8","Pilot 8: max feedback + text",11,"high",-3
"SUPPRF14681",5,51,73,62,-1,69,63,48,"Pilot 8","Pilot 8: max feedback + text",11,"high",14
"SUPPRF14681",6,57,82,71,0,20,71,31,"Pilot 8","Pilot 8: max feedback + text",11,"high",40
"SUPPRF14681",7,63,72,83,12,21,71,51,"Pilot 8","Pilot 8: max feedback + text",11,"high",32
"SUPPRF14681",8,57,74,46,0,69,46,32,"Pilot 8","Pilot 8: max feedback + text",11,"high",14
"SUPPRF14681",9,54,72,78,24,27,54,58,"Pilot 8","Pilot 8: max feedback + text",11,"high",20
"SUPPRF14681",10,57,76,46,17,86,29,20,"Pilot 8","Pilot 8: max feedback + text",11,"high",26
"SUPPRF14681",11,31,88,16,-13,49,29,38,"Pilot 8","Pilot 8: max feedback + text",11,"high",-22
"SUPPRF14681",12,52,80,29,0,90,29,9,"Pilot 8","Pilot 8: max feedback + text",11,"high",20
"SUPPRF14681",13,54,56,75,29,89,46,30,"Pilot 8","Pilot 8: max feedback + text",11,"high",45
"SUPPRF14681",14,52,60,47,27,87,20,17,"Pilot 8","Pilot 8: max feedback + text",11,"high",30
"SUPPRF14681",15,49,89,77,14,55,63,33,"Pilot 8","Pilot 8: max feedback + text",11,"high",44
"SUPPRF14681",16,51,79,58,29,13,29,31,"Pilot 8","Pilot 8: max feedback + text",11,"high",27
"SUPPRF14681",17,23,94,67,-13,8,80,75,"Pilot 8","Pilot 8: max feedback + text",11,"high",-8
"SUPPRF14681",18,53,50,35,15,89,20,8,"Pilot 8","Pilot 8: max feedback + text",11,"high",27
"SUPPRF14681",19,48,87,19,-1,96,20,19,"Pilot 8","Pilot 8: max feedback + text",11,"high",0
"SUPPRF14681",20,53,76,20,0,79,20,19,"Pilot 8","Pilot 8: max feedback + text",11,"high",1
"SUPPRF14681",21,50,80,68,-12,42,80,68,"Pilot 8","Pilot 8: max feedback + text",11,"high",0
"SUPPRF14681",22,13,98,38,-16,93,54,8,"Pilot 8","Pilot 8: max feedback + text",11,"high",30
"SUPPRF14681",23,28,74,15,-14,91,29,31,"Pilot 8","Pilot 8: max feedback + text",11,"high",-16
"SUPPRF14681",24,51,81,50,-13,64,63,38,"Pilot 8","Pilot 8: max feedback + text",11,"high",12
"SUPPRF14681",25,31,75,24,-13,21,37,31,"Pilot 8","Pilot 8: max feedback + text",11,"high",-7
"SUPPRF14681",26,51,83,47,-16,55,63,40,"Pilot 8","Pilot 8: max feedback + text",11,"high",7
"SUPPRF14681",27,46,65,55,1,71,54,43,"Pilot 8","Pilot 8: max feedback + text",11,"high",12
"SUPPRF14681",28,32,59,66,12,19,54,28,"Pilot 8","Pilot 8: max feedback + text",11,"high",38
"SUPPRF14681",29,67,65,22,-15,78,37,29,"Pilot 8","Pilot 8: max feedback + text",11,"high",-7
"SUPPRF14681",30,49,63,70,-1,80,71,53,"Pilot 8","Pilot 8: max feedback + text",11,"high",17
"SUPPRF14681",31,57,53,55,-16,71,71,54,"Pilot 8","Pilot 8: max feedback + text",11,"high",1
"SUPPRF14681",32,74,75,45,-1,99,46,16,"Pilot 8","Pilot 8: max feedback + text",11,"high",29
"SUPPRF14681",33,82,58,58,12,82,46,32,"Pilot 8","Pilot 8: max feedback + text",11,"high",26
"SUPPRF14681",34,52,74,56,-15,45,71,58,"Pilot 8","Pilot 8: max feedback + text",11,"high",-2
"SUPPRF14681",35,58,52,54,0,72,54,32,"Pilot 8","Pilot 8: max feedback + text",11,"high",22
"SUPPRF14681",36,82,73,63,0,18,63,53,"Pilot 8","Pilot 8: max feedback + text",11,"high",10
"SUPPRF14681",37,83,50,94,23,81,71,49,"Pilot 8","Pilot 8: max feedback + text",11,"high",45
"SUPPRF14681",38,49,57,33,-13,87,46,31,"Pilot 8","Pilot 8: max feedback + text",11,"high",2
"SUPPRF14681",39,77,56,28,-1,77,29,22,"Pilot 8","Pilot 8: max feedback + text",11,"high",6
"SUPPRF14681",40,53,72,81,1,58,80,56,"Pilot 8","Pilot 8: max feedback + text",11,"high",25
"SUPPRF14681",41,52,72,80,0,7,80,30,"Pilot 8","Pilot 8: max feedback + text",11,"high",50
"SUPPRF14681",42,42,70,38,1,10,37,17,"Pilot 8","Pilot 8: max feedback + text",11,"high",21
"SUPPRF14681",43,67,50,8,-12,94,20,15,"Pilot 8","Pilot 8: max feedback + text",11,"high",-7
"SUPPRF14681",44,91,67,96,16,85,80,51,"Pilot 8","Pilot 8: max feedback + text",11,"high",45
"SUPPRF14681",45,36,54,41,-13,75,54,47,"Pilot 8","Pilot 8: max feedback + text",11,"high",-6
"SUPPRF14681",46,92,17,100,20,22,80,65,"Pilot 8","Pilot 8: max feedback + text",11,"high",35
"SUPPRF14681",47,55,74,37,0,93,37,20,"Pilot 8","Pilot 8: max feedback + text",11,"high",17
"SUPPRF14681",48,74,91,6,-14,9,20,4,"Pilot 8","Pilot 8: max feedback + text",11,"high",2
"SUPPRF15709",1,51,42,68,-12,16,80,37,"Pilot 9","Pilot 9: bigger feedback + text",7,"high",31
"SUPPRF15709",2,28,35,63,0,17,63,32,"Pilot 9","Pilot 9: bigger feedback + text",7,"high",31
"SUPPRF15709",3,44,63,46,0,13,46,27,"Pilot 9","Pilot 9: bigger feedback + text",7,"high",19
"SUPPRF15709",4,44,24,80,0,16,80,18,"Pilot 9","Pilot 9: bigger feedback + text",7,"high",62
"SUPPRF15709",5,43,36,47,-16,32,63,25,"Pilot 9","Pilot 9: bigger feedback + text",7,"high",22
"SUPPRF15709",6,45,46,22,-15,55,37,15,"Pilot 9","Pilot 9: bigger feedback + text",7,"high",7
"SUPPRF15709",7,42,36,55,1,19,54,22,"Pilot 9","Pilot 9: bigger feedback + text",7,"high",33
"SUPPRF15709",8,33,34,49,12,13,37,29,"Pilot 9","Pilot 9: bigger feedback + text",7,"high",20
"SUPPRF15709",9,39,41,50,-13,12,63,27,"Pilot 9","Pilot 9: bigger feedback + text",7,"high",23
"SUPPRF15709",10,46,44,100,20,14,80,36,"Pilot 9","Pilot 9: bigger feedback + text",7,"high",64
"SUPPRF15709",11,41,46,34,-12,74,46,21,"Pilot 9","Pilot 9: bigger feedback + text",7,"high",13
"SUPPRF15709",12,45,41,77,14,67,63,29,"Pilot 9","Pilot 9: bigger feedback + text",7,"high",48
"SUPPRF15709",13,35,46,24,-13,42,37,32,"Pilot 9","Pilot 9: bigger feedback + text",7,"high",-8
"SUPPRF15709",14,46,37,71,0,70,71,26,"Pilot 9","Pilot 9: bigger feedback + text",7,"high",45
"SUPPRF15709",15,28,29,67,-13,26,80,22,"Pilot 9","Pilot 9: bigger feedback + text",7,"high",45
"SUPPRF15709",16,36,36,16,-13,22,29,28,"Pilot 9","Pilot 9: bigger feedback + text",7,"high",-12
"SUPPRF15709",17,27,28,46,17,27,29,32,"Pilot 9","Pilot 9: bigger feedback + text",7,"high",14
"SUPPRF15709",18,39,30,55,-16,37,71,24,"Pilot 9","Pilot 9: bigger feedback + text",7,"high",31
"SUPPRF15709",19,30,40,33,-13,45,46,30,"Pilot 9","Pilot 9: bigger feedback + text",7,"high",3
"SUPPRF15709",20,20,53,47,27,7,20,33,"Pilot 9","Pilot 9: bigger feedback + text",7,"high",14
"SUPPRF15709",21,20,34,88,25,77,63,19,"Pilot 9","Pilot 9: bigger feedback + text",7,"high",69
"SUPPRF15709",22,17,46,38,1,9,37,27,"Pilot 9","Pilot 9: bigger feedback + text",7,"high",11
"SUPPRF15709",23,17,44,38,-16,55,54,23,"Pilot 9","Pilot 9: bigger feedback + text",7,"high",15
"SUPPRF15709",24,34,43,66,12,4,54,27,"Pilot 9","Pilot 9: bigger feedback + text",7,"high",39
"SUPPRF15709",25,33,43,41,-13,20,54,35,"Pilot 9","Pilot 9: bigger feedback + text",7,"high",6
"SUPPRF15709",26,41,28,94,23,7,71,17,"Pilot 9","Pilot 9: bigger feedback + text",7,"high",77
"SUPPRF15709",27,11,33,56,-15,7,71,22,"Pilot 9","Pilot 9: bigger feedback + text",7,"high",34
"SUPPRF15709",28,15,20,20,0,54,20,15,"Pilot 9","Pilot 9: bigger feedback + text",7,"high",5
"SUPPRF15709",29,18,66,81,1,65,80,40,"Pilot 9","Pilot 9: bigger feedback + text",7,"high",41
"SUPPRF15709",30,25,46,58,29,9,29,35,"Pilot 9","Pilot 9: bigger feedback + text",7,"high",23
"SUPPRF15709",31,34,22,28,-1,16,29,37,"Pilot 9","Pilot 9: bigger feedback + text",7,"high",-9
"SUPPRF15709",32,23,60,61,24,19,37,34,"Pilot 9","Pilot 9: bigger feedback + text",7,"high",27
"SUPPRF15709",33,23,56,8,-12,55,20,20,"Pilot 9","Pilot 9: bigger feedback + text",7,"high",-12
"SUPPRF15709",34,33,33,70,-1,14,71,41,"Pilot 9","Pilot 9: bigger feedback + text",7,"high",29
"SUPPRF15709",35,26,56,45,-1,11,46,28,"Pilot 9","Pilot 9: bigger feedback + text",7,"high",17
"SUPPRF15709",36,25,28,29,0,14,29,33,"Pilot 9","Pilot 9: bigger feedback + text",7,"high",-4
"SUPPRF15709",37,46,27,58,12,80,46,18,"Pilot 9","Pilot 9: bigger feedback + text",7,"high",40
"SUPPRF15709",38,33,29,54,0,42,54,26,"Pilot 9","Pilot 9: bigger feedback + text",7,"high",28
"SUPPRF15709",39,35,31,83,12,14,71,24,"Pilot 9","Pilot 9: bigger feedback + text",7,"high",59
"SUPPRF15709",40,24,22,15,-14,15,29,22,"Pilot 9","Pilot 9: bigger feedback + text",7,"high",-7
"SUPPRF15709",41,46,38,35,15,75,20,15,"Pilot 9","Pilot 9: bigger feedback + text",7,"high",20
"SUPPRF15709",42,27,26,6,-14,35,20,38,"Pilot 9","Pilot 9: bigger feedback + text",7,"high",-32
"SUPPRF15709",43,35,37,75,29,9,46,31,"Pilot 9","Pilot 9: bigger feedback + text",7,"high",44
"SUPPRF15709",44,32,33,96,16,11,80,22,"Pilot 9","Pilot 9: bigger feedback + text",7,"high",74
"SUPPRF15709",45,28,31,37,0,12,37,26,"Pilot 9","Pilot 9: bigger feedback + text",7,"high",11
"SUPPRF15709",46,45,24,19,-1,36,20,37,"Pilot 9","Pilot 9: bigger feedback + text",7,"high",-18
"SUPPRF15709",47,42,30,78,24,6,54,29,"Pilot 9","Pilot 9: bigger feedback + text",7,"high",49
"SUPPRF15709",48,34,33,62,-1,39,63,30,"Pilot 9","Pilot 9: bigger feedback + text",7,"high",32
"SUPPRF16716",1,1,56,96,16,54,80,83,"Pilot 6","Pilot 6: feedback + text",8,"high",13
"SUPPRF16716",2,1,54,24,-13,44,37,30,"Pilot 6","Pilot 6: feedback + text",8,"high",-6
"SUPPRF16716",3,1,47,8,-12,41,20,15,"Pilot 6","Pilot 6: feedback + text",8,"high",-7
"SUPPRF16716",4,1,47,78,15,56,63,75,"Pilot 6","Pilot 6: feedback + text",8,"high",3
"SUPPRF16716",5,2,42,58,12,57,46,50,"Pilot 6","Pilot 6: feedback + text",8,"high",8
"SUPPRF16716",6,1,42,66,12,64,54,52,"Pilot 6","Pilot 6: feedback + text",8,"high",14
"SUPPRF16716",7,1,55,67,-13,72,80,89,"Pilot 6","Pilot 6: feedback + text",8,"high",-22
"SUPPRF16716",8,2,47,77,14,59,63,52,"Pilot 6","Pilot 6: feedback + text",8,"high",25
"SUPPRF16716",9,1,36,62,-1,38,63,58,"Pilot 6","Pilot 6: feedback + text",8,"high",4
"SUPPRF16716",10,0,28,19,-1,66,20,16,"Pilot 6","Pilot 6: feedback + text",8,"high",3
"SUPPRF16716",11,0,37,29,0,58,29,30,"Pilot 6","Pilot 6: feedback + text",8,"high",-1
"SUPPRF16716",12,2,37,63,0,45,63,70,"Pilot 6","Pilot 6: feedback + text",8,"high",-7
"SUPPRF16716",13,1,40,20,0,55,20,19,"Pilot 6","Pilot 6: feedback + text",8,"high",1
"SUPPRF16716",14,1,21,68,14,72,54,65,"Pilot 6","Pilot 6: feedback + text",8,"high",3
"SUPPRF16716",15,0,35,28,-1,55,29,30,"Pilot 6","Pilot 6: feedback + text",8,"high",-2
"SUPPRF16716",16,0,38,33,-13,63,46,40,"Pilot 6","Pilot 6: feedback + text",8,"high",-7
"SUPPRF16716",17,0,26,46,17,56,29,32,"Pilot 6","Pilot 6: feedback + text",8,"high",14
"SUPPRF16716",18,1,41,65,19,68,46,35,"Pilot 6","Pilot 6: feedback + text",8,"high",30
"SUPPRF16716",19,0,28,45,-1,57,46,47,"Pilot 6","Pilot 6: feedback + text",8,"high",-2
"SUPPRF16716",20,1,28,41,-13,62,54,51,"Pilot 6","Pilot 6: feedback + text",8,"high",-10
"SUPPRF16716",21,1,35,38,-16,75,54,59,"Pilot 6","Pilot 6: feedback + text",8,"high",-21
"SUPPRF16716",22,1,30,34,-12,59,46,38,"Pilot 6","Pilot 6: feedback + text",8,"high",-4
"SUPPRF16716",23,1,31,22,-15,66,37,27,"Pilot 6","Pilot 6: feedback + text",8,"high",-5
"SUPPRF16716",24,1,33,38,1,66,37,35,"Pilot 6","Pilot 6: feedback + text",8,"high",3
"SUPPRF16716",25,1,36,48,19,65,29,32,"Pilot 6","Pilot 6: feedback + text",8,"high",16
"SUPPRF16716",26,1,29,55,-16,77,71,80,"Pilot 6","Pilot 6: feedback + text",8,"high",-25
"SUPPRF16716",27,0,25,54,0,78,54,61,"Pilot 6","Pilot 6: feedback + text",8,"high",-7
"SUPPRF16716",28,1,38,16,-13,57,29,26,"Pilot 6","Pilot 6: feedback + text",8,"high",-10
"SUPPRF16716",29,1,41,97,17,60,80,87,"Pilot 6","Pilot 6: feedback + text",8,"high",10
"SUPPRF16716",30,1,42,68,-12,73,80,88,"Pilot 6","Pilot 6: feedback + text",8,"high",-20
"SUPPRF16716",31,1,26,70,-1,66,71,75,"Pilot 6","Pilot 6: feedback + text",8,"high",-5
"SUPPRF16716",32,0,34,50,-13,54,63,35,"Pilot 6","Pilot 6: feedback + text",8,"high",15
"SUPPRF16716",33,1,48,81,1,54,80,71,"Pilot 6","Pilot 6: feedback + text",8,"high",10
"SUPPRF16716",34,1,29,35,15,50,20,21,"Pilot 6","Pilot 6: feedback + text",8,"high",14
"SUPPRF16716",35,2,30,71,0,61,71,62,"Pilot 6","Pilot 6: feedback + text",8,"high",9
"SUPPRF16716",36,1,25,15,-14,59,29,14,"Pilot 6","Pilot 6: feedback + text",8,"high",1
"SUPPRF16716",37,1,36,49,12,66,37,42,"Pilot 6","Pilot 6: feedback + text",8,"high",7
"SUPPRF16716",38,0,34,46,0,66,46,47,"Pilot 6","Pilot 6: feedback + text",8,"high",-1
"SUPPRF16716",39,0,33,80,0,56,80,82,"Pilot 6","Pilot 6: feedback + text",8,"high",-2
"SUPPRF16716",40,1,34,47,-16,55,63,61,"Pilot 6","Pilot 6: feedback + text",8,"high",-14
"SUPPRF16716",41,1,33,56,-15,79,71,63,"Pilot 6","Pilot 6: feedback + text",8,"high",-7
"SUPPRF16716",42,1,21,37,0,62,37,46,"Pilot 6","Pilot 6: feedback + text",8,"high",-9
"SUPPRF16716",43,1,54,6,-14,49,20,28,"Pilot 6","Pilot 6: feedback + text",8,"high",-22
"SUPPRF16716",44,0,57,51,14,43,37,53,"Pilot 6","Pilot 6: feedback + text",8,"high",-2
"SUPPRF16716",45,0,63,55,1,60,54,52,"Pilot 6","Pilot 6: feedback + text",8,"high",3
"SUPPRF16716",46,2,38,83,12,74,71,65,"Pilot 6","Pilot 6: feedback + text",8,"high",18
"SUPPRF16716",47,1,26,84,13,58,71,70,"Pilot 6","Pilot 6: feedback + text",8,"high",14
"SUPPRF16716",48,0,21,37,17,69,20,13,"Pilot 6","Pilot 6: feedback + text",8,"high",24
"SUPPRF17225",1,65,13,61,24,66,37,42,"Pilot 10","Pilot 10: bigger feedback + video",1,"low",19
"SUPPRF17225",2,73,7,80,0,76,80,88,"Pilot 10","Pilot 10: bigger feedback + video",1,"low",-8
"SUPPRF17225",3,80,11,77,14,54,63,65,"Pilot 10","Pilot 10: bigger feedback + video",1,"low",12
"SUPPRF17225",4,84,10,56,-15,65,71,73,"Pilot 10","Pilot 10: bigger feedback + video",1,"low",-17
"SUPPRF17225",5,80,8,37,0,76,37,32,"Pilot 10","Pilot 10: bigger feedback + video",1,"low",5
"SUPPRF17225",6,86,5,55,-16,71,71,83,"Pilot 10","Pilot 10: bigger feedback + video",1,"low",-28
"SUPPRF17225",7,84,7,46,17,55,29,40,"Pilot 10","Pilot 10: bigger feedback + video",1,"low",6
"SUPPRF17225",8,86,5,63,0,51,63,71,"Pilot 10","Pilot 10: bigger feedback + video",1,"low",-8
"SUPPRF17225",9,86,5,50,-13,50,63,54,"Pilot 10","Pilot 10: bigger feedback + video",1,"low",-4
"SUPPRF17225",10,89,8,83,12,55,71,78,"Pilot 10","Pilot 10: bigger feedback + video",1,"low",5
"SUPPRF17225",11,89,11,96,16,54,80,87,"Pilot 10","Pilot 10: bigger feedback + video",1,"low",9
"SUPPRF17225",12,90,7,15,-14,52,29,28,"Pilot 10","Pilot 10: bigger feedback + video",1,"low",-13
"SUPPRF17225",13,78,18,46,0,54,46,52,"Pilot 10","Pilot 10: bigger feedback + video",1,"low",-6
"SUPPRF17225",14,82,18,54,0,52,54,44,"Pilot 10","Pilot 10: bigger feedback + video",1,"low",10
"SUPPRF17225",15,84,18,29,0,50,29,22,"Pilot 10","Pilot 10: bigger feedback + video",1,"low",7
"SUPPRF17225",16,92,8,24,-13,52,37,44,"Pilot 10","Pilot 10: bigger feedback + video",1,"low",-20
"SUPPRF17225",17,76,18,58,29,31,29,30,"Pilot 10","Pilot 10: bigger feedback + video",1,"low",28
"SUPPRF17225",18,84,19,22,-15,35,37,36,"Pilot 10","Pilot 10: bigger feedback + video",1,"low",-14
"SUPPRF17225",19,80,26,70,-1,30,71,45,"Pilot 10","Pilot 10: bigger feedback + video",1,"low",25
"SUPPRF17225",20,81,21,33,-13,37,46,47,"Pilot 10","Pilot 10: bigger feedback + video",1,"low",-14
"SUPPRF17225",21,86,16,58,12,31,46,36,"Pilot 10","Pilot 10: bigger feedback + video",1,"low",22
"SUPPRF17225",22,86,16,6,-14,25,20,23,"Pilot 10","Pilot 10: bigger feedback + video",1,"low",-17
"SUPPRF17225",23,85,19,75,29,25,46,49,"Pilot 10","Pilot 10: bigger feedback + video",1,"low",26
"SUPPRF17225",24,87,17,67,-13,21,80,82,"Pilot 10","Pilot 10: bigger feedback + video",1,"low",-15
"SUPPRF17225",25,84,16,62,-1,23,63,62,"Pilot 10","Pilot 10: bigger feedback + video",1,"low",0
"SUPPRF17225",26,87,18,47,-16,23,63,52,"Pilot 10","Pilot 10: bigger feedback + video",1,"low",-5
"SUPPRF17225",27,88,13,100,20,20,80,77,"Pilot 10","Pilot 10: bigger feedback + video",1,"low",23
"SUPPRF17225",28,90,16,49,12,20,37,35,"Pilot 10","Pilot 10: bigger feedback + video",1,"low",14
"SUPPRF17225",29,87,12,78,24,23,54,57,"Pilot 10","Pilot 10: bigger feedback + video",1,"low",21
"SUPPRF17225",30,89,17,19,-1,19,20,26,"Pilot 10","Pilot 10: bigger feedback + video",1,"low",-7
"SUPPRF17225",31,87,13,38,1,23,37,41,"Pilot 10","Pilot 10: bigger feedback + video",1,"low",-3
"SUPPRF17225",32,87,16,16,-13,19,29,32,"Pilot 10","Pilot 10: bigger feedback + video",1,"low",-16
"SUPPRF17225",33,86,12,68,-12,11,80,81,"Pilot 10","Pilot 10: bigger feedback + video",1,"low",-13
"SUPPRF17225",34,77,34,45,-1,15,46,36,"Pilot 10","Pilot 10: bigger feedback + video",1,"low",9
"SUPPRF17225",35,66,23,28,-1,18,29,32,"Pilot 10","Pilot 10: bigger feedback + video",1,"low",-4
"SUPPRF17225",36,69,34,66,12,19,54,52,"Pilot 10","Pilot 10: bigger feedback + video",1,"low",14
"SUPPRF17225",37,81,36,34,-12,19,46,49,"Pilot 10","Pilot 10: bigger feedback + video",1,"low",-15
"SUPPRF17225",38,75,28,20,0,29,20,33,"Pilot 10","Pilot 10: bigger feedback + video",1,"low",-13
"SUPPRF17225",39,76,31,55,1,16,54,56,"Pilot 10","Pilot 10: bigger feedback + video",1,"low",-1
"SUPPRF17225",40,69,34,38,-16,15,54,59,"Pilot 10","Pilot 10: bigger feedback + video",1,"low",-21
"SUPPRF17225",41,68,28,71,0,23,71,46,"Pilot 10","Pilot 10: bigger feedback + video",1,"low",25
"SUPPRF17225",42,69,31,81,1,16,80,86,"Pilot 10","Pilot 10: bigger feedback + video",1,"low",-5
"SUPPRF17225",43,60,47,35,15,13,20,23,"Pilot 10","Pilot 10: bigger feedback + video",1,"low",12
"SUPPRF17225",44,63,21,88,25,13,63,58,"Pilot 10","Pilot 10: bigger feedback + video",1,"low",30
"SUPPRF17225",45,71,32,94,23,15,71,83,"Pilot 10","Pilot 10: bigger feedback + video",1,"low",11
"SUPPRF17225",46,84,28,8,-12,15,20,37,"Pilot 10","Pilot 10: bigger feedback + video",1,"low",-29
"SUPPRF17225",47,83,21,41,-13,18,54,62,"Pilot 10","Pilot 10: bigger feedback + video",1,"low",-21
"SUPPRF17225",48,85,14,47,27,16,20,21,"Pilot 10","Pilot 10: bigger feedback + video",1,"low",26
"SUPPRF17949",1,93,5,33,-13,7,46,44,"Pilot 9","Pilot 9: bigger feedback + text",3,"low",-11
"SUPPRF17949",2,89,6,16,-13,21,29,35,"Pilot 9","Pilot 9: bigger feedback + text",3,"low",-19
"SUPPRF17949",3,89,7,38,1,6,37,28,"Pilot 9","Pilot 9: bigger feedback + text",3,"low",10
"SUPPRF17949",4,94,7,49,12,14,37,33,"Pilot 9","Pilot 9: bigger feedback + text",3,"low",16
"SUPPRF17949",5,94,6,28,-1,30,29,20,"Pilot 9","Pilot 9: bigger feedback + text",3,"low",8
"SUPPRF17949",6,89,10,55,-16,50,71,75,"Pilot 9","Pilot 9: bigger feedback + text",3,"low",-20
"SUPPRF17949",7,96,7,55,1,20,54,55,"Pilot 9","Pilot 9: bigger feedback + text",3,"low",0
"SUPPRF17949",8,94,4,34,-12,15,46,30,"Pilot 9","Pilot 9: bigger feedback + text",3,"low",4
"SUPPRF17949",9,94,5,58,29,21,29,15,"Pilot 9","Pilot 9: bigger feedback + text",3,"low",43
"SUPPRF17949",10,94,7,56,-15,29,71,60,"Pilot 9","Pilot 9: bigger feedback + text",3,"low",-4
"SUPPRF17949",11,93,6,45,-1,30,46,50,"Pilot 9","Pilot 9: bigger feedback + text",3,"low",-5
"SUPPRF17949",12,95,5,77,14,28,63,64,"Pilot 9","Pilot 9: bigger feedback + text",3,"low",13
"SUPPRF17949",13,94,9,15,-14,29,29,50,"Pilot 9","Pilot 9: bigger feedback + text",3,"low",-35
"SUPPRF17949",14,90,9,29,0,19,29,25,"Pilot 9","Pilot 9: bigger feedback + text",3,"low",4
"SUPPRF17949",15,86,9,67,-13,17,80,51,"Pilot 9","Pilot 9: bigger feedback + text",3,"low",16
"SUPPRF17949",16,83,12,38,-16,70,54,46,"Pilot 9","Pilot 9: bigger feedback + text",3,"low",-8
"SUPPRF17949",17,84,16,71,0,82,71,49,"Pilot 9","Pilot 9: bigger feedback + text",3,"low",22
"SUPPRF17949",18,67,22,88,25,33,63,48,"Pilot 9","Pilot 9: bigger feedback + text",3,"low",40
"SUPPRF17949",19,72,22,35,15,25,20,50,"Pilot 9","Pilot 9: bigger feedback + text",3,"low",-15
"SUPPRF17949",20,65,33,83,12,33,71,57,"Pilot 9","Pilot 9: bigger feedback + text",3,"low",26
"SUPPRF17949",21,62,34,63,0,25,63,61,"Pilot 9","Pilot 9: bigger feedback + text",3,"low",2
"SUPPRF17949",22,77,38,66,12,23,54,36,"Pilot 9","Pilot 9: bigger feedback + text",3,"low",30
"SUPPRF17949",23,60,38,96,16,43,80,48,"Pilot 9","Pilot 9: bigger feedback + text",3,"low",48
"SUPPRF17949",24,68,28,81,1,64,80,75,"Pilot 9","Pilot 9: bigger feedback + text",3,"low",6
"SUPPRF17949",25,71,34,22,-15,47,37,55,"Pilot 9","Pilot 9: bigger feedback + text",3,"low",-33
"SUPPRF17949",26,59,40,8,-12,81,20,15,"Pilot 9","Pilot 9: bigger feedback + text",3,"low",-7
"SUPPRF17949",27,53,40,80,0,57,80,23,"Pilot 9","Pilot 9: bigger feedback + text",3,"low",57
"SUPPRF17949",28,64,30,54,0,34,54,42,"Pilot 9","Pilot 9: bigger feedback + text",3,"low",12
"SUPPRF17949",29,54,47,47,-16,49,63,42,"Pilot 9","Pilot 9: bigger feedback + text",3,"low",5
"SUPPRF17949",30,62,44,50,-13,35,63,54,"Pilot 9","Pilot 9: bigger feedback + text",3,"low",-4
"SUPPRF17949",31,51,51,61,24,16,37,32,"Pilot 9","Pilot 9: bigger feedback + text",3,"low",29
"SUPPRF17949",32,52,46,62,-1,17,63,49,"Pilot 9","Pilot 9: bigger feedback + text",3,"low",13
"SUPPRF17949",33,50,50,47,27,35,20,46,"Pilot 9","Pilot 9: bigger feedback + text",3,"low",1
"SUPPRF17949",34,56,41,78,24,17,54,47,"Pilot 9","Pilot 9: bigger feedback + text",3,"low",31
"SUPPRF17949",35,48,53,100,20,34,80,52,"Pilot 9","Pilot 9: bigger feedback + text",3,"low",48
"SUPPRF17949",36,45,51,41,-13,60,54,54,"Pilot 9","Pilot 9: bigger feedback + text",3,"low",-13
"SUPPRF17949",37,45,60,20,0,23,20,38,"Pilot 9","Pilot 9: bigger feedback + text",3,"low",-18
"SUPPRF17949",38,39,56,24,-13,26,37,32,"Pilot 9","Pilot 9: bigger feedback + text",3,"low",-8
"SUPPRF17949",39,44,47,46,0,78,46,74,"Pilot 9","Pilot 9: bigger feedback + text",3,"low",-28
"SUPPRF17949",40,82,48,37,0,66,37,35,"Pilot 9","Pilot 9: bigger feedback + text",3,"low",2
"SUPPRF17949",41,100,30,94,23,69,71,68,"Pilot 9","Pilot 9: bigger feedback + text",3,"low",26
"SUPPRF17949",42,49,30,58,12,57,46,26,"Pilot 9","Pilot 9: bigger feedback + text",3,"low",32
"SUPPRF17949",43,51,48,46,17,30,29,60,"Pilot 9","Pilot 9: bigger feedback + text",3,"low",-14
"SUPPRF17949",44,33,79,75,29,86,46,35,"Pilot 9","Pilot 9: bigger feedback + text",3,"low",40
"SUPPRF17949",45,46,51,70,-1,57,71,78,"Pilot 9","Pilot 9: bigger feedback + text",3,"low",-8
"SUPPRF17949",46,52,31,6,-14,7,20,26,"Pilot 9","Pilot 9: bigger feedback + text",3,"low",-20
"SUPPRF17949",47,52,50,19,-1,94,20,14,"Pilot 9","Pilot 9: bigger feedback + text",3,"low",5
"SUPPRF17949",48,57,49,68,-12,70,80,89,"Pilot 9","Pilot 9: bigger feedback + text",3,"low",-21
"SUPPRF18559",1,53,45,34,-12,59,46,47,"Pilot 8","Pilot 8: max feedback + text",9,"high",-13
"SUPPRF18559",2,56,44,96,16,35,80,58,"Pilot 8","Pilot 8: max feedback + text",9,"high",38
"SUPPRF18559",3,50,40,58,12,41,46,35,"Pilot 8","Pilot 8: max feedback + text",9,"high",23
"SUPPRF18559",4,51,43,38,1,34,37,50,"Pilot 8","Pilot 8: max feedback + text",9,"high",-12
"SUPPRF18559",5,56,37,47,27,48,20,27,"Pilot 8","Pilot 8: max feedback + text",9,"high",20
"SUPPRF18559",6,50,37,75,29,31,46,42,"Pilot 8","Pilot 8: max feedback + text",9,"high",33
"SUPPRF18559",7,51,41,19,-1,31,20,40,"Pilot 8","Pilot 8: max feedback + text",9,"high",-21
"SUPPRF18559",8,49,32,50,-13,47,63,53,"Pilot 8","Pilot 8: max feedback + text",9,"high",-3
"SUPPRF18559",9,49,33,41,-13,35,54,49,"Pilot 8","Pilot 8: max feedback + text",9,"high",-8
"SUPPRF18559",10,64,30,94,23,58,71,54,"Pilot 8","Pilot 8: max feedback + text",9,"high",40
"SUPPRF18559",11,53,26,24,-13,28,37,49,"Pilot 8","Pilot 8: max feedback + text",9,"high",-25
"SUPPRF18559",12,54,27,66,12,35,54,56,"Pilot 8","Pilot 8: max feedback + text",9,"high",10
"SUPPRF18559",13,56,27,81,1,58,80,64,"Pilot 8","Pilot 8: max feedback + text",9,"high",17
"SUPPRF18559",14,62,26,63,0,49,63,36,"Pilot 8","Pilot 8: max feedback + text",9,"high",27
"SUPPRF18559",15,53,25,45,-1,29,46,52,"Pilot 8","Pilot 8: max feedback + text",9,"high",-7
"SUPPRF18559",16,58,28,47,-16,36,63,48,"Pilot 8","Pilot 8: max feedback + text",9,"high",-1
"SUPPRF18559",17,55,30,88,25,48,63,33,"Pilot 8","Pilot 8: max feedback + text",9,"high",55
"SUPPRF18559",18,58,35,15,-14,36,29,52,"Pilot 8","Pilot 8: max feedback + text",9,"high",-37
"SUPPRF18559",19,53,26,46,0,58,46,60,"Pilot 8","Pilot 8: max feedback + text",9,"high",-14
"SUPPRF18559",20,60,25,29,0,64,29,21,"Pilot 8","Pilot 8: max feedback + text",9,"high",8
"SUPPRF18559",21,58,27,20,0,59,20,17,"Pilot 8","Pilot 8: max feedback + text",9,"high",3
"SUPPRF18559",22,57,23,70,-1,61,71,78,"Pilot 8","Pilot 8: max feedback + text",9,"high",-8
"SUPPRF18559",23,58,23,16,-13,59,29,17,"Pilot 8","Pilot 8: max feedback + text",9,"high",-1
"SUPPRF18559",24,61,28,28,-1,53,29,24,"Pilot 8","Pilot 8: max feedback + text",9,"high",4
"SUPPRF18559",25,61,25,78,24,38,54,61,"Pilot 8","Pilot 8: max feedback + text",9,"high",17
"SUPPRF18559",26,62,26,61,24,26,37,51,"Pilot 8","Pilot 8: max feedback + text",9,"high",10
"SUPPRF18559",27,58,26,56,-15,70,71,69,"Pilot 8","Pilot 8: max feedback + text",9,"high",-13
"SUPPRF18559",28,64,20,71,0,62,71,66,"Pilot 8","Pilot 8: max feedback + text",9,"high",5
"SUPPRF18559",29,58,14,67,-13,68,80,70,"Pilot 8","Pilot 8: max feedback + text",9,"high",-3
"SUPPRF18559",30,54,28,22,-15,25,37,54,"Pilot 8","Pilot 8: max feedback + text",9,"high",-32
"SUPPRF18559",31,57,17,100,20,52,80,76,"Pilot 8","Pilot 8: max feedback + text",9,"high",24
"SUPPRF18559",32,59,17,33,-13,31,46,50,"Pilot 8","Pilot 8: max feedback + text",9,"high",-17
"SUPPRF18559",33,54,24,8,-12,42,20,18,"Pilot 8","Pilot 8: max feedback + text",9,"high",-10
"SUPPRF18559",34,57,16,37,0,19,37,35,"Pilot 8","Pilot 8: max feedback + text",9,"high",2
"SUPPRF18559",35,58,11,77,14,46,63,35,"Pilot 8","Pilot 8: max feedback + text",9,"high",42
"SUPPRF18559",36,69,10,6,-14,63,20,6,"Pilot 8","Pilot 8: max feedback + text",9,"high",0
"SUPPRF18559",37,61,17,68,-12,62,80,58,"Pilot 8","Pilot 8: max feedback + text",9,"high",10
"SUPPRF18559",38,50,13,83,12,48,71,57,"Pilot 8","Pilot 8: max feedback + text",9,"high",26
"SUPPRF18559",39,58,17,38,-16,23,54,48,"Pilot 8","Pilot 8: max feedback + text",9,"high",-10
"SUPPRF18559",40,59,19,46,17,66,29,23,"Pilot 8","Pilot 8: max feedback + text",9,"high",23
"SUPPRF18559",41,58,20,80,0,58,80,60,"Pilot 8","Pilot 8: max feedback + text",9,"high",20
"SUPPRF18559",42,64,18,55,1,28,54,47,"Pilot 8","Pilot 8: max feedback + text",9,"high",8
"SUPPRF18559",43,63,21,49,12,19,37,38,"Pilot 8","Pilot 8: max feedback + text",9,"high",11
"SUPPRF18559",44,56,17,62,-1,24,63,46,"Pilot 8","Pilot 8: max feedback + text",9,"high",16
"SUPPRF18559",45,55,22,54,0,26,54,47,"Pilot 8","Pilot 8: max feedback + text",9,"high",7
"SUPPRF18559",46,57,25,35,15,31,20,54,"Pilot 8","Pilot 8: max feedback + text",9,"high",-19
"SUPPRF18559",47,57,18,58,29,55,29,21,"Pilot 8","Pilot 8: max feedback + text",9,"high",37
"SUPPRF18559",48,56,22,55,-16,59,71,34,"Pilot 8","Pilot 8: max feedback + text",9,"high",21
"SUPPRF18662",1,67,4,47,27,70,20,20,"Pilot 10","Pilot 10: bigger feedback + video",0,"low",27
"SUPPRF18662",2,49,6,68,-12,80,80,80,"Pilot 10","Pilot 10: bigger feedback + video",0,"low",-12
"SUPPRF18662",3,52,4,62,-1,60,63,55,"Pilot 10","Pilot 10: bigger feedback + video",0,"low",7
"SUPPRF18662",4,49,7,29,0,75,29,20,"Pilot 10","Pilot 10: bigger feedback + video",0,"low",9
"SUPPRF18662",5,50,4,34,-12,70,46,55,"Pilot 10","Pilot 10: bigger feedback + video",0,"low",-21
"SUPPRF18662",6,36,8,8,-12,90,20,22,"Pilot 10","Pilot 10: bigger feedback + video",0,"low",-14
"SUPPRF18662",7,51,4,35,15,72,20,14,"Pilot 10","Pilot 10: bigger feedback + video",0,"low",21
"SUPPRF18662",8,43,22,41,-13,68,54,55,"Pilot 10","Pilot 10: bigger feedback + video",0,"low",-14
"SUPPRF18662",9,53,11,88,25,56,63,60,"Pilot 10","Pilot 10: bigger feedback + video",0,"low",28
"SUPPRF18662",10,49,9,83,12,70,71,80,"Pilot 10","Pilot 10: bigger feedback + video",0,"low",3
"SUPPRF18662",11,53,5,67,-13,65,80,70,"Pilot 10","Pilot 10: bigger feedback + video",0,"low",-3
"SUPPRF18662",12,49,9,77,14,65,63,60,"Pilot 10","Pilot 10: bigger feedback + video",0,"low",17
"SUPPRF18662",13,47,8,46,17,75,29,20,"Pilot 10","Pilot 10: bigger feedback + video",0,"low",26
"SUPPRF18662",14,35,7,38,-16,75,54,60,"Pilot 10","Pilot 10: bigger feedback + video",0,"low",-22
"SUPPRF18662",15,48,10,45,-1,75,46,41,"Pilot 10","Pilot 10: bigger feedback + video",0,"low",4
"SUPPRF18662",16,49,6,61,24,69,37,30,"Pilot 10","Pilot 10: bigger feedback + video",0,"low",31
"SUPPRF18662",17,43,6,38,1,60,37,50,"Pilot 10","Pilot 10: bigger feedback + video",0,"low",-12
"SUPPRF18662",18,51,6,75,29,74,46,38,"Pilot 10","Pilot 10: bigger feedback + video",0,"low",37
"SUPPRF18662",19,49,7,80,0,81,80,80,"Pilot 10","Pilot 10: bigger feedback + video",0,"low",0
"SUPPRF18662",20,50,6,47,-16,65,63,50,"Pilot 10","Pilot 10: bigger feedback + video",0,"low",-3
"SUPPRF18662",21,33,7,16,-13,54,29,33,"Pilot 10","Pilot 10: bigger feedback + video",0,"low",-17
"SUPPRF18662",22,38,5,20,0,74,20,19,"Pilot 10","Pilot 10: bigger feedback + video",0,"low",1
"SUPPRF18662",23,44,6,33,-13,50,46,35,"Pilot 10","Pilot 10: bigger feedback + video",0,"low",-2
"SUPPRF18662",24,50,6,78,24,72,54,50,"Pilot 10","Pilot 10: bigger feedback + video",0,"low",28
"SUPPRF18662",25,49,7,56,-15,70,71,70,"Pilot 10","Pilot 10: bigger feedback + video",0,"low",-14
"SUPPRF18662",26,33,5,6,-14,80,20,18,"Pilot 10","Pilot 10: bigger feedback + video",0,"low",-12
"SUPPRF18662",27,46,6,46,0,73,46,48,"Pilot 10","Pilot 10: bigger feedback + video",0,"low",-2
"SUPPRF18662",28,50,6,49,12,69,37,52,"Pilot 10","Pilot 10: bigger feedback + video",0,"low",-3
"SUPPRF18662",29,51,7,66,12,70,54,55,"Pilot 10","Pilot 10: bigger feedback + video",0,"low",11
"SUPPRF18662",30,45,9,22,-15,76,37,45,"Pilot 10","Pilot 10: bigger feedback + video",0,"low",-23
"SUPPRF18662",31,42,9,15,-14,79,29,35,"Pilot 10","Pilot 10: bigger feedback + video",0,"low",-20
"SUPPRF18662",32,53,7,70,-1,81,71,79,"Pilot 10","Pilot 10: bigger feedback + video",0,"low",-9
"SUPPRF18662",33,50,6,54,0,73,54,56,"Pilot 10","Pilot 10: bigger feedback + video",0,"low",-2
"SUPPRF18662",34,51,6,81,1,80,80,79,"Pilot 10","Pilot 10: bigger feedback + video",0,"low",2
"SUPPRF18662",35,50,9,63,0,75,63,52,"Pilot 10","Pilot 10: bigger feedback + video",0,"low",11
"SUPPRF18662",36,33,5,28,-1,70,29,59,"Pilot 10","Pilot 10: bigger feedback + video",0,"low",-31
"SUPPRF18662",37,52,6,50,-13,80,63,41,"Pilot 10","Pilot 10: bigger feedback + video",0,"low",9
"SUPPRF18662",38,50,5,37,0,81,37,35,"Pilot 10","Pilot 10: bigger feedback + video",0,"low",2
"SUPPRF18662",39,39,9,55,-16,48,71,70,"Pilot 10","Pilot 10: bigger feedback + video",0,"low",-15
"SUPPRF18662",40,64,9,96,16,75,80,75,"Pilot 10","Pilot 10: bigger feedback + video",0,"low",21
"SUPPRF18662",41,51,8,55,1,80,54,55,"Pilot 10","Pilot 10: bigger feedback + video",0,"low",0
"SUPPRF18662",42,59,5,94,23,83,71,80,"Pilot 10","Pilot 10: bigger feedback + video",0,"low",14
"SUPPRF18662",43,45,9,19,-1,76,20,22,"Pilot 10","Pilot 10: bigger feedback + video",0,"low",-3
"SUPPRF18662",44,47,5,24,-13,84,37,25,"Pilot 10","Pilot 10: bigger feedback + video",0,"low",-1
"SUPPRF18662",45,48,9,58,29,85,29,21,"Pilot 10","Pilot 10: bigger feedback + video",0,"low",37
"SUPPRF18662",46,46,6,71,0,80,71,80,"Pilot 10","Pilot 10: bigger feedback + video",0,"low",-9
"SUPPRF18662",47,53,8,58,12,81,46,44,"Pilot 10","Pilot 10: bigger feedback + video",0,"low",14
"SUPPRF18662",48,62,6,100,20,85,80,85,"Pilot 10","Pilot 10: bigger feedback + video",0,"low",15
"SUPPRF18834",1,77,72,67,-13,76,80,65,"Pilot 6","Pilot 6: feedback + text",9,"high",2
"SUPPRF18834",2,86,57,96,16,64,80,60,"Pilot 6","Pilot 6: feedback + text",9,"high",36
"SUPPRF18834",3,53,43,19,-1,46,20,54,"Pilot 6","Pilot 6: feedback + text",9,"high",-35
"SUPPRF18834",4,65,40,68,14,77,54,41,"Pilot 6","Pilot 6: feedback + text",9,"high",27
"SUPPRF18834",5,70,38,80,0,64,80,58,"Pilot 6","Pilot 6: feedback + text",9,"high",22
"SUPPRF18834",6,55,39,65,19,65,46,37,"Pilot 6","Pilot 6: feedback + text",9,"high",28
"SUPPRF18834",7,63,36,51,14,73,37,33,"Pilot 6","Pilot 6: feedback + text",9,"high",18
"SUPPRF18834",8,64,34,56,-15,79,71,61,"Pilot 6","Pilot 6: feedback + text",9,"high",-5
"SUPPRF18834",9,50,33,48,19,69,29,30,"Pilot 6","Pilot 6: feedback + text",9,"high",18
"SUPPRF18834",10,45,22,55,1,74,54,66,"Pilot 6","Pilot 6: feedback + text",9,"high",-11
"SUPPRF18834",11,50,23,78,15,71,63,60,"Pilot 6","Pilot 6: feedback + text",9,"high",18
"SUPPRF18834",12,56,32,37,17,74,20,20,"Pilot 6","Pilot 6: feedback + text",9,"high",17
"SUPPRF18834",13,46,17,33,-13,40,46,40,"Pilot 6","Pilot 6: feedback + text",9,"high",-7
"SUPPRF18834",14,60,22,70,-1,83,71,60,"Pilot 6","Pilot 6: feedback + text",9,"high",10
"SUPPRF18834",15,41,19,77,14,39,63,54,"Pilot 6","Pilot 6: feedback + text",9,"high",23
"SUPPRF18834",16,45,23,83,12,31,71,49,"Pilot 6","Pilot 6: feedback + text",9,"high",34
"SUPPRF18834",17,34,24,34,-12,28,46,49,"Pilot 6","Pilot 6: feedback + text",9,"high",-15
"SUPPRF18834",18,40,8,49,12,63,37,40,"Pilot 6","Pilot 6: feedback + text",9,"high",9
"SUPPRF18834",19,65,20,97,17,62,80,51,"Pilot 6","Pilot 6: feedback + text",9,"high",46
"SUPPRF18834",20,63,15,71,0,65,71,63,"Pilot 6","Pilot 6: feedback + text",9,"high",8
"SUPPRF18834",21,60,17,58,12,75,46,47,"Pilot 6","Pilot 6: feedback + text",9,"high",11
"SUPPRF18834",22,37,15,8,-12,74,20,26,"Pilot 6","Pilot 6: feedback + text",9,"high",-18
"SUPPRF18834",23,56,20,20,0,64,20,26,"Pilot 6","Pilot 6: feedback + text",9,"high",-6
"SUPPRF18834",24,43,15,28,-1,35,29,44,"Pilot 6","Pilot 6: feedback + text",9,"high",-16
"SUPPRF18834",25,51,22,68,-12,35,80,62,"Pilot 6","Pilot 6: feedback + text",9,"high",6
"SUPPRF18834",26,42,24,29,0,45,29,36,"Pilot 6","Pilot 6: feedback + text",9,"high",-7
"SUPPRF18834",27,57,30,41,-13,68,54,45,"Pilot 6","Pilot 6: feedback + text",9,"high",-4
"SUPPRF18834",28,43,24,50,-13,38,63,40,"Pilot 6","Pilot 6: feedback + text",9,"high",10
"SUPPRF18834",29,37,24,46,0,64,46,53,"Pilot 6","Pilot 6: feedback + text",9,"high",-7
"SUPPRF18834",30,58,35,37,0,30,37,31,"Pilot 6","Pilot 6: feedback + text",9,"high",6
"SUPPRF18834",31,36,32,22,-15,61,37,36,"Pilot 6","Pilot 6: feedback + text",9,"high",-14
"SUPPRF18834",32,43,39,38,1,26,37,40,"Pilot 6","Pilot 6: feedback + text",9,"high",-2
"SUPPRF18834",33,33,54,47,-16,84,63,17,"Pilot 6","Pilot 6: feedback + text",9,"high",30
"SUPPRF18834",34,23,30,16,-13,53,29,26,"Pilot 6","Pilot 6: feedback + text",9,"high",-10
"SUPPRF18834",35,25,30,66,12,35,54,24,"Pilot 6","Pilot 6: feedback + text",9,"high",42
"SUPPRF18834",36,35,35,84,13,77,71,37,"Pilot 6","Pilot 6: feedback + text",9,"high",47
"SUPPRF18834",37,48,30,46,17,84,29,14,"Pilot 6","Pilot 6: feedback + text",9,"high",32
"SUPPRF18834",38,53,38,15,-14,59,29,39,"Pilot 6","Pilot 6: feedback + text",9,"high",-24
"SUPPRF18834",39,33,62,45,-1,64,46,44,"Pilot 6","Pilot 6: feedback + text",9,"high",1
"SUPPRF18834",40,67,36,55,-16,67,71,59,"Pilot 6","Pilot 6: feedback + text",9,"high",-4
"SUPPRF18834",41,52,38,24,-13,28,37,33,"Pilot 6","Pilot 6: feedback + text",9,"high",-9
"SUPPRF18834",42,36,72,54,0,57,54,39,"Pilot 6","Pilot 6: feedback + text",9,"high",15
"SUPPRF18834",43,49,37,63,0,35,63,49,"Pilot 6","Pilot 6: feedback + text",9,"high",14
"SUPPRF18834",44,50,41,81,1,93,80,75,"Pilot 6","Pilot 6: feedback + text",9,"high",6
"SUPPRF18834",45,40,36,6,-14,92,20,16,"Pilot 6","Pilot 6: feedback + text",9,"high",-10
"SUPPRF18834",46,47,35,38,-16,30,54,46,"Pilot 6","Pilot 6: feedback + text",9,"high",-8
"SUPPRF18834",47,55,36,62,-1,30,63,24,"Pilot 6","Pilot 6: feedback + text",9,"high",38
"SUPPRF18834",48,44,38,35,15,92,20,16,"Pilot 6","Pilot 6: feedback + text",9,"high",19
"SUPPRF19517",1,56,20,34,-12,83,46,44,"Pilot 8","Pilot 8: max feedback + text",8,"high",-10
"SUPPRF19517",2,62,9,16,-13,81,29,15,"Pilot 8","Pilot 8: max feedback + text",8,"high",1
"SUPPRF19517",3,76,5,45,-1,19,46,23,"Pilot 8","Pilot 8: max feedback + text",8,"high",22
"SUPPRF19517",4,58,5,63,0,11,63,50,"Pilot 8","Pilot 8: max feedback + text",8,"high",13
"SUPPRF19517",5,51,1,66,12,0,54,40,"Pilot 8","Pilot 8: max feedback + text",8,"high",26
"SUPPRF19517",6,50,0,61,24,0,37,24,"Pilot 8","Pilot 8: max feedback + text",8,"high",37
"SUPPRF19517",7,17,0,94,23,0,71,22,"Pilot 8","Pilot 8: max feedback + text",8,"high",72
"SUPPRF19517",8,6,0,77,14,0,63,36,"Pilot 8","Pilot 8: max feedback + text",8,"high",41
"SUPPRF19517",9,42,0,35,15,0,20,27,"Pilot 8","Pilot 8: max feedback + text",8,"high",8
"SUPPRF19517",10,57,0,46,17,0,29,41,"Pilot 8","Pilot 8: max feedback + text",8,"high",5
"SUPPRF19517",11,57,6,28,-1,0,29,44,"Pilot 8","Pilot 8: max feedback + text",8,"high",-16
"SUPPRF19517",12,57,1,49,12,0,37,25,"Pilot 8","Pilot 8: max feedback + text",8,"high",24
"SUPPRF19517",13,56,6,47,27,0,20,38,"Pilot 8","Pilot 8: max feedback + text",8,"high",9
"SUPPRF19517",14,80,9,83,12,0,71,63,"Pilot 8","Pilot 8: max feedback + text",8,"high",20
"SUPPRF19517",15,70,5,55,-16,0,71,0,"Pilot 8","Pilot 8: max feedback + text",8,"high",55
"SUPPRF19517",16,78,10,75,29,0,46,48,"Pilot 8","Pilot 8: max feedback + text",8,"high",27
"SUPPRF19517",17,79,16,54,0,71,54,41,"Pilot 8","Pilot 8: max feedback + text",8,"high",13
"SUPPRF19517",18,82,12,50,-13,67,63,48,"Pilot 8","Pilot 8: max feedback + text",8,"high",2
"SUPPRF19517",19,83,14,56,-15,79,71,49,"Pilot 8","Pilot 8: max feedback + text",8,"high",7
"SUPPRF19517",20,80,0,58,12,10,46,51,"Pilot 8","Pilot 8: max feedback + text",8,"high",7
"SUPPRF19517",21,72,0,20,0,8,20,20,"Pilot 8","Pilot 8: max feedback + text",8,"high",0
"SUPPRF19517",22,67,0,62,-1,10,63,41,"Pilot 8","Pilot 8: max feedback + text",8,"high",21
"SUPPRF19517",23,77,0,29,0,0,29,30,"Pilot 8","Pilot 8: max feedback + text",8,"high",-1
"SUPPRF19517",24,83,0,55,1,2,54,46,"Pilot 8","Pilot 8: max feedback + text",8,"high",9
"SUPPRF19517",25,72,44,96,16,0,80,66,"Pilot 8","Pilot 8: max feedback + text",8,"high",30
"SUPPRF19517",26,91,0,19,-1,0,20,26,"Pilot 8","Pilot 8: max feedback + text",8,"high",-7
"SUPPRF19517",27,74,0,68,-12,0,80,70,"Pilot 8","Pilot 8: max feedback + text",8,"high",-2
"SUPPRF19517",28,74,17,41,-13,4,54,49,"Pilot 8","Pilot 8: max feedback + text",8,"high",-8
"SUPPRF19517",29,74,15,8,-12,0,20,43,"Pilot 8","Pilot 8: max feedback + text",8,"high",-35
"SUPPRF19517",30,83,22,38,1,1,37,30,"Pilot 8","Pilot 8: max feedback + text",8,"high",8
"SUPPRF19517",31,83,14,100,20,8,80,67,"Pilot 8","Pilot 8: max feedback + text",8,"high",33
"SUPPRF19517",32,57,19,38,-16,4,54,61,"Pilot 8","Pilot 8: max feedback + text",8,"high",-23
"SUPPRF19517",33,93,3,47,-16,0,63,39,"Pilot 8","Pilot 8: max feedback + text",8,"high",8
"SUPPRF19517",34,83,6,33,-13,0,46,49,"Pilot 8","Pilot 8: max feedback + text",8,"high",-16
"SUPPRF19517",35,72,18,15,-14,0,29,39,"Pilot 8","Pilot 8: max feedback + text",8,"high",-24
"SUPPRF19517",36,75,17,37,0,0,37,35,"Pilot 8","Pilot 8: max feedback + text",8,"high",2
"SUPPRF19517",37,77,0,71,0,0,71,16,"Pilot 8","Pilot 8: max feedback + text",8,"high",55
"SUPPRF19517",38,90,4,88,25,4,63,46,"Pilot 8","Pilot 8: max feedback + text",8,"high",42
"SUPPRF19517",39,79,3,46,0,0,46,49,"Pilot 8","Pilot 8: max feedback + text",8,"high",-3
"SUPPRF19517",40,84,2,80,0,0,80,39,"Pilot 8","Pilot 8: max feedback + text",8,"high",41
"SUPPRF19517",41,100,0,22,-15,2,37,46,"Pilot 8","Pilot 8: max feedback + text",8,"high",-24
"SUPPRF19517",42,79,0,78,24,0,54,51,"Pilot 8","Pilot 8: max feedback + text",8,"high",27
"SUPPRF19517",43,100,0,58,29,0,29,43,"Pilot 8","Pilot 8: max feedback + text",8,"high",15
"SUPPRF19517",44,99,4,24,-13,0,37,41,"Pilot 8","Pilot 8: max feedback + text",8,"high",-17
"SUPPRF19517",45,80,0,67,-13,0,80,77,"Pilot 8","Pilot 8: max feedback + text",8,"high",-10
"SUPPRF19517",46,98,1,70,-1,4,71,52,"Pilot 8","Pilot 8: max feedback + text",8,"high",18
"SUPPRF19517",47,98,0,81,1,0,80,74,"Pilot 8","Pilot 8: max feedback + text",8,"high",7
"SUPPRF19517",48,66,9,6,-14,1,20,23,"Pilot 8","Pilot 8: max feedback + text",8,"high",-17
"SUPPRF20210",1,85,74,62,-1,67,63,72,"Pilot 10","Pilot 10: bigger feedback + video",3,"low",-10
"SUPPRF20210",2,75,63,56,-15,72,71,75,"Pilot 10","Pilot 10: bigger feedback + video",3,"low",-19
"SUPPRF20210",3,62,68,88,25,55,63,61,"Pilot 10","Pilot 10: bigger feedback + video",3,"low",27
"SUPPRF20210",4,69,74,77,14,73,63,77,"Pilot 10","Pilot 10: bigger feedback + video",3,"low",0
"SUPPRF20210",5,65,71,8,-12,71,20,62,"Pilot 10","Pilot 10: bigger feedback + video",3,"low",-54
"SUPPRF20210",6,71,60,81,1,73,80,81,"Pilot 10","Pilot 10: bigger feedback + video",3,"low",0
"SUPPRF20210",7,80,50,54,0,80,54,66,"Pilot 10","Pilot 10: bigger feedback + video",3,"low",-12
"SUPPRF20210",8,55,63,16,-13,75,29,81,"Pilot 10","Pilot 10: bigger feedback + video",3,"low",-65
"SUPPRF20210",9,49,52,28,-1,45,29,21,"Pilot 10","Pilot 10: bigger feedback + video",3,"low",7
"SUPPRF20210",10,51,55,46,17,54,29,27,"Pilot 10","Pilot 10: bigger feedback + video",3,"low",19
"SUPPRF20210",11,52,70,50,-13,54,63,60,"Pilot 10","Pilot 10: bigger feedback + video",3,"low",-10
"SUPPRF20210",12,52,52,66,12,57,54,46,"Pilot 10","Pilot 10: bigger feedback + video",3,"low",20
"SUPPRF20210",13,57,41,19,-1,60,20,32,"Pilot 10","Pilot 10: bigger feedback + video",3,"low",-13
"SUPPRF20210",14,53,41,61,24,54,37,48,"Pilot 10","Pilot 10: bigger feedback + video",3,"low",13
"SUPPRF20210",15,71,36,100,20,60,80,80,"Pilot 10","Pilot 10: bigger feedback + video",3,"low",20
"SUPPRF20210",16,63,36,70,-1,54,71,55,"Pilot 10","Pilot 10: bigger feedback + video",3,"low",15
"SUPPRF20210",17,50,42,68,-12,61,80,64,"Pilot 10","Pilot 10: bigger feedback + video",3,"low",4
"SUPPRF20210",18,53,55,75,29,57,46,36,"Pilot 10","Pilot 10: bigger feedback + video",3,"low",39
"SUPPRF20210",19,48,52,38,-16,57,54,61,"Pilot 10","Pilot 10: bigger feedback + video",3,"low",-23
"SUPPRF20210",20,62,55,78,24,51,54,41,"Pilot 10","Pilot 10: bigger feedback + video",3,"low",37
"SUPPRF20210",21,69,75,80,0,69,80,80,"Pilot 10","Pilot 10: bigger feedback + video",3,"low",0
"SUPPRF20210",22,66,50,46,0,63,46,53,"Pilot 10","Pilot 10: bigger feedback + video",3,"low",-7
"SUPPRF20210",23,57,50,29,0,54,29,29,"Pilot 10","Pilot 10: bigger feedback + video",3,"low",0
"SUPPRF20210",24,62,49,94,23,61,71,73,"Pilot 10","Pilot 10: bigger feedback + video",3,"low",21
"SUPPRF20210",25,52,52,35,15,57,20,35,"Pilot 10","Pilot 10: bigger feedback + video",3,"low",0
"SUPPRF20210",26,44,46,34,-12,48,46,49,"Pilot 10","Pilot 10: bigger feedback + video",3,"low",-15
"SUPPRF20210",27,54,54,38,1,34,37,38,"Pilot 10","Pilot 10: bigger feedback + video",3,"low",0
"SUPPRF20210",28,67,67,20,0,39,20,23,"Pilot 10","Pilot 10: bigger feedback + video",3,"low",-3
"SUPPRF20210",29,52,51,24,-13,48,37,57,"Pilot 10","Pilot 10: bigger feedback + video",3,"low",-33
"SUPPRF20210",30,58,33,47,27,44,20,23,"Pilot 10","Pilot 10: bigger feedback + video",3,"low",24
"SUPPRF20210",31,55,50,58,29,38,29,38,"Pilot 10","Pilot 10: bigger feedback + video",3,"low",20
"SUPPRF20210",32,48,45,37,0,32,37,43,"Pilot 10","Pilot 10: bigger feedback + video",3,"low",-6
"SUPPRF20210",33,52,48,22,-15,28,37,40,"Pilot 10","Pilot 10: bigger feedback + video",3,"low",-18
"SUPPRF20210",34,53,60,67,-13,74,80,86,"Pilot 10","Pilot 10: bigger feedback + video",3,"low",-19
"SUPPRF20210",35,56,68,33,-13,66,46,42,"Pilot 10","Pilot 10: bigger feedback + video",3,"low",-9
"SUPPRF20210",36,63,16,47,-16,68,63,67,"Pilot 10","Pilot 10: bigger feedback + video",3,"low",-20
"SUPPRF20210",37,65,73,63,0,63,63,81,"Pilot 10","Pilot 10: bigger feedback + video",3,"low",-18
"SUPPRF20210",38,76,26,49,12,52,37,47,"Pilot 10","Pilot 10: bigger feedback + video",3,"low",2
"SUPPRF20210",39,62,20,58,12,63,46,77,"Pilot 10","Pilot 10: bigger feedback + video",3,"low",-19
"SUPPRF20210",40,29,26,83,12,55,71,77,"Pilot 10","Pilot 10: bigger feedback + video",3,"low",6
"SUPPRF20210",41,60,29,55,1,59,54,60,"Pilot 10","Pilot 10: bigger feedback + video",3,"low",-5
"SUPPRF20210",42,29,35,96,16,63,80,77,"Pilot 10","Pilot 10: bigger feedback + video",3,"low",19
"SUPPRF20210",43,47,38,45,-1,44,46,44,"Pilot 10","Pilot 10: bigger feedback + video",3,"low",1
"SUPPRF20210",44,51,25,71,0,50,71,68,"Pilot 10","Pilot 10: bigger feedback + video",3,"low",3
"SUPPRF20210",45,46,14,6,-14,63,20,25,"Pilot 10","Pilot 10: bigger feedback + video",3,"low",-19
"SUPPRF20210",46,38,56,15,-14,54,29,38,"Pilot 10","Pilot 10: bigger feedback + video",3,"low",-23
"SUPPRF20210",47,53,26,55,-16,69,71,70,"Pilot 10","Pilot 10: bigger feedback + video",3,"low",-15
"SUPPRF20210",48,63,46,41,-13,40,54,54,"Pilot 10","Pilot 10: bigger feedback + video",3,"low",-13
"SUPPRF20625",1,79,29,38,1,75,37,40,"Pilot 7","Pilot 7: bigger feedback + text",5,"low",-2
"SUPPRF20625",2,90,9,37,17,90,20,25,"Pilot 7","Pilot 7: bigger feedback + text",5,"low",12
"SUPPRF20625",3,92,26,71,0,70,71,77,"Pilot 7","Pilot 7: bigger feedback + text",5,"low",-6
"SUPPRF20625",4,83,16,81,1,80,80,82,"Pilot 7","Pilot 7: bigger feedback + text",5,"low",-1
"SUPPRF20625",5,83,21,45,-1,60,46,50,"Pilot 7","Pilot 7: bigger feedback + text",5,"low",-5
"SUPPRF20625",6,91,10,96,16,75,80,75,"Pilot 7","Pilot 7: bigger feedback + text",5,"low",21
"SUPPRF20625",7,91,6,65,19,80,46,45,"Pilot 7","Pilot 7: bigger feedback + text",5,"low",20
"SUPPRF20625",8,71,12,22,-15,40,37,45,"Pilot 7","Pilot 7: bigger feedback + text",5,"low",-23
"SUPPRF20625",9,97,10,97,17,60,80,85,"Pilot 7","Pilot 7: bigger feedback + text",5,"low",12
"SUPPRF20625",10,91,10,83,12,60,71,77,"Pilot 7","Pilot 7: bigger feedback + text",5,"low",6
"SUPPRF20625",11,85,20,55,1,40,54,65,"Pilot 7","Pilot 7: bigger feedback + text",5,"low",-10
"SUPPRF20625",12,88,16,49,12,70,37,38,"Pilot 7","Pilot 7: bigger feedback + text",5,"low",11
"SUPPRF20625",13,86,15,63,0,45,63,60,"Pilot 7","Pilot 7: bigger feedback + text",5,"low",3
"SUPPRF20625",14,73,24,56,-15,65,71,75,"Pilot 7","Pilot 7: bigger feedback + text",5,"low",-19
"SUPPRF20625",15,69,31,50,-13,70,63,66,"Pilot 7","Pilot 7: bigger feedback + text",5,"low",-16
"SUPPRF20625",16,71,25,37,0,40,37,35,"Pilot 7","Pilot 7: bigger feedback + text",5,"low",2
"SUPPRF20625",17,84,18,78,15,55,63,70,"Pilot 7","Pilot 7: bigger feedback + text",5,"low",8
"SUPPRF20625",18,84,17,66,12,40,54,60,"Pilot 7","Pilot 7: bigger feedback + text",5,"low",6
"SUPPRF20625",19,66,37,24,-13,60,37,30,"Pilot 7","Pilot 7: bigger feedback + text",5,"low",-6
"SUPPRF20625",20,89,17,77,14,66,63,50,"Pilot 7","Pilot 7: bigger feedback + text",5,"low",27
"SUPPRF20625",21,89,10,51,14,70,37,32,"Pilot 7","Pilot 7: bigger feedback + text",5,"low",19
"SUPPRF20625",22,82,25,48,19,30,29,55,"Pilot 7","Pilot 7: bigger feedback + text",5,"low",-7
"SUPPRF20625",23,41,42,28,-1,60,29,55,"Pilot 7","Pilot 7: bigger feedback + text",5,"low",-27
"SUPPRF20625",24,35,53,15,-14,35,29,35,"Pilot 7","Pilot 7: bigger feedback + text",5,"low",-20
"SUPPRF20625",25,68,26,62,-1,40,63,60,"Pilot 7","Pilot 7: bigger feedback + text",5,"low",2
"SUPPRF20625",26,60,32,20,0,65,20,20,"Pilot 7","Pilot 7: bigger feedback + text",5,"low",0
"SUPPRF20625",27,71,27,29,0,60,29,25,"Pilot 7","Pilot 7: bigger feedback + text",5,"low",4
"SUPPRF20625",28,85,17,84,13,55,71,66,"Pilot 7","Pilot 7: bigger feedback + text",5,"low",18
"SUPPRF20625",29,37,37,38,-16,40,54,70,"Pilot 7","Pilot 7: bigger feedback + text",5,"low",-32
"SUPPRF20625",30,75,25,80,0,70,80,85,"Pilot 7","Pilot 7: bigger feedback + text",5,"low",-5
"SUPPRF20625",31,46,30,33,-13,60,46,47,"Pilot 7","Pilot 7: bigger feedback + text",5,"low",-14
"SUPPRF20625",32,57,26,67,-13,55,80,79,"Pilot 7","Pilot 7: bigger feedback + text",5,"low",-12
"SUPPRF20625",33,70,25,70,-1,66,71,78,"Pilot 7","Pilot 7: bigger feedback + text",5,"low",-8
"SUPPRF20625",34,76,32,35,15,60,20,23,"Pilot 7","Pilot 7: bigger feedback + text",5,"low",12
"SUPPRF20625",35,65,25,16,-13,30,29,0,"Pilot 7","Pilot 7: bigger feedback + text",5,"low",16
"SUPPRF20625",36,61,27,55,-16,70,71,72,"Pilot 7","Pilot 7: bigger feedback + text",5,"low",-17
"SUPPRF20625",37,44,42,6,-14,41,20,22,"Pilot 7","Pilot 7: bigger feedback + text",5,"low",-16
"SUPPRF20625",38,63,30,54,0,40,54,55,"Pilot 7","Pilot 7: bigger feedback + text",5,"low",-1
"SUPPRF20625",39,30,60,8,-12,61,20,25,"Pilot 7","Pilot 7: bigger feedback + text",5,"low",-17
"SUPPRF20625",40,61,27,58,12,55,46,50,"Pilot 7","Pilot 7: bigger feedback + text",5,"low",8
"SUPPRF20625",41,54,24,34,-12,40,46,45,"Pilot 7","Pilot 7: bigger feedback + text",5,"low",-11
"SUPPRF20625",42,75,30,46,17,25,29,50,"Pilot 7","Pilot 7: bigger feedback + text",5,"low",-4
"SUPPRF20625",43,55,35,47,-16,66,63,66,"Pilot 7","Pilot 7: bigger feedback + text",5,"low",-19
"SUPPRF20625",44,53,30,19,-1,60,20,21,"Pilot 7","Pilot 7: bigger feedback + text",5,"low",-2
"SUPPRF20625",45,47,69,46,0,60,46,50,"Pilot 7","Pilot 7: bigger feedback + text",5,"low",-4
"SUPPRF20625",46,61,26,68,-12,60,80,75,"Pilot 7","Pilot 7: bigger feedback + text",5,"low",-7
"SUPPRF20625",47,73,24,68,14,40,54,65,"Pilot 7","Pilot 7: bigger feedback + text",5,"low",3
"SUPPRF20625",48,48,31,41,-13,55,54,55,"Pilot 7","Pilot 7: bigger feedback + text",5,"low",-14
"SUPPRF20648",1,54,31,51,14,89,37,38,"Pilot 6","Pilot 6: feedback + text",11,"high",13
"SUPPRF20648",2,49,35,55,1,64,54,60,"Pilot 6","Pilot 6: feedback + text",11,"high",-5
"SUPPRF20648",3,52,48,66,12,89,54,55,"Pilot 6","Pilot 6: feedback + text",11,"high",11
"SUPPRF20648",4,53,49,68,-12,66,80,80,"Pilot 6","Pilot 6: feedback + text",11,"high",-12
"SUPPRF20648",5,52,51,55,-16,54,71,65,"Pilot 6","Pilot 6: feedback + text",11,"high",-10
"SUPPRF20648",6,50,43,46,0,53,46,70,"Pilot 6","Pilot 6: feedback + text",11,"high",-24
"SUPPRF20648",7,55,50,83,12,53,71,56,"Pilot 6","Pilot 6: feedback + text",11,"high",27
"SUPPRF20648",8,53,44,28,-1,48,29,23,"Pilot 6","Pilot 6: feedback + text",11,"high",5
"SUPPRF20648",9,52,50,78,15,12,63,47,"Pilot 6","Pilot 6: feedback + text",11,"high",31
"SUPPRF20648",10,47,47,47,-16,72,63,63,"Pilot 6","Pilot 6: feedback + text",11,"high",-16
"SUPPRF20648",11,66,47,96,16,55,80,80,"Pilot 6","Pilot 6: feedback + text",11,"high",16
"SUPPRF20648",12,51,40,49,12,50,37,26,"Pilot 6","Pilot 6: feedback + text",11,"high",23
"SUPPRF20648",13,42,30,46,17,0,29,14,"Pilot 6","Pilot 6: feedback + text",11,"high",32
"SUPPRF20648",14,47,25,58,12,77,46,40,"Pilot 6","Pilot 6: feedback + text",11,"high",18
"SUPPRF20648",15,49,37,84,13,71,71,70,"Pilot 6","Pilot 6: feedback + text",11,"high",14
"SUPPRF20648",16,40,22,38,-16,21,54,50,"Pilot 6","Pilot 6: feedback + text",11,"high",-12
"SUPPRF20648",17,50,28,80,0,85,80,84,"Pilot 6","Pilot 6: feedback + text",11,"high",-4
"SUPPRF20648",18,41,24,48,19,11,29,38,"Pilot 6","Pilot 6: feedback + text",11,"high",10
"SUPPRF20648",19,50,31,56,-15,26,71,56,"Pilot 6","Pilot 6: feedback + text",11,"high",0
"SUPPRF20648",20,46,27,77,14,70,63,41,"Pilot 6","Pilot 6: feedback + text",11,"high",36
"SUPPRF20648",21,51,32,37,0,52,37,33,"Pilot 6","Pilot 6: feedback + text",11,"high",4
"SUPPRF20648",22,45,27,81,1,90,80,85,"Pilot 6","Pilot 6: feedback + text",11,"high",-4
"SUPPRF20648",23,49,27,35,15,74,20,14,"Pilot 6","Pilot 6: feedback + text",11,"high",21
"SUPPRF20648",24,41,25,24,-13,69,37,40,"Pilot 6","Pilot 6: feedback + text",11,"high",-16
"SUPPRF20648",25,86,21,97,17,26,80,43,"Pilot 6","Pilot 6: feedback + text",11,"high",54
"SUPPRF20648",26,48,28,29,0,72,29,28,"Pilot 6","Pilot 6: feedback + text",11,"high",1
"SUPPRF20648",27,51,33,22,-15,70,37,33,"Pilot 6","Pilot 6: feedback + text",11,"high",-11
"SUPPRF20648",28,51,28,34,-12,90,46,45,"Pilot 6","Pilot 6: feedback + text",11,"high",-11
"SUPPRF20648",29,74,27,19,-1,85,20,15,"Pilot 6","Pilot 6: feedback + text",11,"high",4
"SUPPRF20648",30,50,36,54,0,85,54,48,"Pilot 6","Pilot 6: feedback + text",11,"high",6
"SUPPRF20648",31,51,35,15,-14,77,29,26,"Pilot 6","Pilot 6: feedback + text",11,"high",-11
"SUPPRF20648",32,52,52,65,19,70,46,40,"Pilot 6","Pilot 6: feedback + text",11,"high",25
"SUPPRF20648",33,50,33,45,-1,74,46,54,"Pilot 6","Pilot 6: feedback + text",11,"high",-9
"SUPPRF20648",34,49,48,38,1,65,37,30,"Pilot 6","Pilot 6: feedback + text",11,"high",8
"SUPPRF20648",35,48,29,50,-13,80,63,60,"Pilot 6","Pilot 6: feedback + text",11,"high",-10
"SUPPRF20648",36,50,34,63,0,71,63,64,"Pilot 6","Pilot 6: feedback + text",11,"high",-1
"SUPPRF20648",37,50,24,62,-1,90,63,68,"Pilot 6","Pilot 6: feedback + text",11,"high",-6
"SUPPRF20648",38,48,31,37,17,76,20,17,"Pilot 6","Pilot 6: feedback + text",11,"high",20
"SUPPRF20648",39,49,35,33,-13,80,46,42,"Pilot 6","Pilot 6: feedback + text",11,"high",-9
"SUPPRF20648",40,50,34,41,-13,70,54,50,"Pilot 6","Pilot 6: feedback + text",11,"high",-9
"SUPPRF20648",41,51,30,67,-13,85,80,88,"Pilot 6","Pilot 6: feedback + text",11,"high",-21
"SUPPRF20648",42,49,27,68,14,90,54,57,"Pilot 6","Pilot 6: feedback + text",11,"high",11
"SUPPRF20648",43,51,30,16,-13,0,29,44,"Pilot 6","Pilot 6: feedback + text",11,"high",-28
"SUPPRF20648",44,50,28,6,-14,65,20,24,"Pilot 6","Pilot 6: feedback + text",11,"high",-18
"SUPPRF20648",45,79,32,70,-1,1,71,20,"Pilot 6","Pilot 6: feedback + text",11,"high",50
"SUPPRF20648",46,47,19,8,-12,94,20,10,"Pilot 6","Pilot 6: feedback + text",11,"high",-2
"SUPPRF20648",47,50,33,20,0,70,20,7,"Pilot 6","Pilot 6: feedback + text",11,"high",13
"SUPPRF20648",48,49,28,71,0,80,71,77,"Pilot 6","Pilot 6: feedback + text",11,"high",-6
"SUPPRF21477",1,75,33,71,0,35,71,53,"Pilot 8","Pilot 8: max feedback + text",9,"high",18
"SUPPRF21477",2,73,24,58,29,68,29,50,"Pilot 8","Pilot 8: max feedback + text",9,"high",8
"SUPPRF21477",3,75,20,55,-16,57,71,47,"Pilot 8","Pilot 8: max feedback + text",9,"high",8
"SUPPRF21477",4,74,22,6,-14,55,20,22,"Pilot 8","Pilot 8: max feedback + text",9,"high",-16
"SUPPRF21477",5,78,35,58,12,73,46,36,"Pilot 8","Pilot 8: max feedback + text",9,"high",22
"SUPPRF21477",6,78,19,16,-13,74,29,17,"Pilot 8","Pilot 8: max feedback + text",9,"high",-1
"SUPPRF21477",7,78,28,70,-1,44,71,63,"Pilot 8","Pilot 8: max feedback + text",9,"high",7
"SUPPRF21477",8,75,29,94,23,67,71,60,"Pilot 8","Pilot 8: max feedback + text",9,"high",34
"SUPPRF21477",9,81,21,46,0,65,46,69,"Pilot 8","Pilot 8: max feedback + text",9,"high",-23
"SUPPRF21477",10,76,24,29,0,68,29,27,"Pilot 8","Pilot 8: max feedback + text",9,"high",2
"SUPPRF21477",11,78,30,28,-1,69,29,24,"Pilot 8","Pilot 8: max feedback + text",9,"high",4
"SUPPRF21477",12,76,12,19,-1,77,20,17,"Pilot 8","Pilot 8: max feedback + text",9,"high",2
"SUPPRF21477",13,84,23,49,12,51,37,55,"Pilot 8","Pilot 8: max feedback + text",9,"high",-6
"SUPPRF21477",14,76,22,80,0,32,80,64,"Pilot 8","Pilot 8: max feedback + text",9,"high",16
"SUPPRF21477",15,78,20,8,-12,70,20,18,"Pilot 8","Pilot 8: max feedback + text",9,"high",-10
"SUPPRF21477",16,76,30,54,0,33,54,59,"Pilot 8","Pilot 8: max feedback + text",9,"high",-5
"SUPPRF21477",17,79,23,88,25,27,63,48,"Pilot 8","Pilot 8: max feedback + text",9,"high",40
"SUPPRF21477",18,79,20,47,-16,39,63,71,"Pilot 8","Pilot 8: max feedback + text",9,"high",-24
"SUPPRF21477",19,82,23,24,-13,66,37,25,"Pilot 8","Pilot 8: max feedback + text",9,"high",-1
"SUPPRF21477",20,79,21,38,1,64,37,32,"Pilot 8","Pilot 8: max feedback + text",9,"high",6
"SUPPRF21477",21,86,24,96,16,68,80,73,"Pilot 8","Pilot 8: max feedback + text",9,"high",23
"SUPPRF21477",22,78,18,20,0,40,20,51,"Pilot 8","Pilot 8: max feedback + text",9,"high",-31
"SUPPRF21477",23,80,22,66,12,32,54,58,"Pilot 8","Pilot 8: max feedback + text",9,"high",8
"SUPPRF21477",24,80,17,22,-15,29,37,67,"Pilot 8","Pilot 8: max feedback + text",9,"high",-45
"SUPPRF21477",25,75,25,45,-1,41,46,62,"Pilot 8","Pilot 8: max feedback + text",9,"high",-17
"SUPPRF21477",26,89,21,67,-13,40,80,67,"Pilot 8","Pilot 8: max feedback + text",9,"high",0
"SUPPRF21477",27,81,18,61,24,45,37,36,"Pilot 8","Pilot 8: max feedback + text",9,"high",25
"SUPPRF21477",28,85,21,81,1,38,80,71,"Pilot 8","Pilot 8: max feedback + text",9,"high",10
"SUPPRF21477",29,85,15,34,-12,24,46,70,"Pilot 8","Pilot 8: max feedback + text",9,"high",-36
"SUPPRF21477",30,77,32,50,-13,35,63,69,"Pilot 8","Pilot 8: max feedback + text",9,"high",-19
"SUPPRF21477",31,78,18,47,27,64,20,18,"Pilot 8","Pilot 8: max feedback + text",9,"high",29
"SUPPRF21477",32,79,16,77,14,27,63,62,"Pilot 8","Pilot 8: max feedback + text",9,"high",15
"SUPPRF21477",33,80,21,55,1,37,54,51,"Pilot 8","Pilot 8: max feedback + text",9,"high",4
"SUPPRF21477",34,82,16,37,0,45,37,39,"Pilot 8","Pilot 8: max feedback + text",9,"high",-2
"SUPPRF21477",35,85,19,68,-12,33,80,77,"Pilot 8","Pilot 8: max feedback + text",9,"high",-9
"SUPPRF21477",36,71,25,56,-15,26,71,68,"Pilot 8","Pilot 8: max feedback + text",9,"high",-12
"SUPPRF21477",37,87,21,15,-14,50,29,20,"Pilot 8","Pilot 8: max feedback + text",9,"high",-5
"SUPPRF21477",38,74,28,38,-16,64,54,38,"Pilot 8","Pilot 8: max feedback + text",9,"high",0
"SUPPRF21477",39,78,14,46,17,25,29,25,"Pilot 8","Pilot 8: max feedback + text",9,"high",21
"SUPPRF21477",40,84,17,35,15,64,20,16,"Pilot 8","Pilot 8: max feedback + text",9,"high",19
"SUPPRF21477",41,81,20,75,29,67,46,41,"Pilot 8","Pilot 8: max feedback + text",9,"high",34
"SUPPRF21477",42,75,15,41,-13,62,54,33,"Pilot 8","Pilot 8: max feedback + text",9,"high",8
"SUPPRF21477",43,79,24,83,12,60,71,31,"Pilot 8","Pilot 8: max feedback + text",9,"high",52
"SUPPRF21477",44,84,18,63,0,71,63,63,"Pilot 8","Pilot 8: max feedback + text",9,"high",0
"SUPPRF21477",45,82,21,62,-1,76,63,67,"Pilot 8","Pilot 8: max feedback + text",9,"high",-5
"SUPPRF21477",46,84,21,33,-13,64,46,28,"Pilot 8","Pilot 8: max feedback + text",9,"high",5
"SUPPRF21477",47,81,25,78,24,60,54,34,"Pilot 8","Pilot 8: max feedback + text",9,"high",44
"SUPPRF21477",48,87,22,100,20,81,80,76,"Pilot 8","Pilot 8: max feedback + text",9,"high",24
"SUPPRF21828",1,50,50,71,0,49,71,54,"Pilot 8","Pilot 8: max feedback + text",3,"low",17
"SUPPRF21828",2,51,48,37,0,50,37,47,"Pilot 8","Pilot 8: max feedback + text",3,"low",-10
"SUPPRF21828",3,47,47,58,29,46,29,48,"Pilot 8","Pilot 8: max feedback + text",3,"low",10
"SUPPRF21828",4,49,49,78,24,49,54,55,"Pilot 8","Pilot 8: max feedback + text",3,"low",23
"SUPPRF21828",5,47,46,47,27,49,20,49,"Pilot 8","Pilot 8: max feedback + text",3,"low",-2
"SUPPRF21828",6,47,47,47,-16,50,63,50,"Pilot 8","Pilot 8: max feedback + text",3,"low",-3
"SUPPRF21828",7,49,49,88,25,51,63,51,"Pilot 8","Pilot 8: max feedback + text",3,"low",37
"SUPPRF21828",8,47,48,58,12,50,46,51,"Pilot 8","Pilot 8: max feedback + text",3,"low",7
"SUPPRF21828",9,49,47,66,12,49,54,47,"Pilot 8","Pilot 8: max feedback + text",3,"low",19
"SUPPRF21828",10,49,49,80,0,49,80,58,"Pilot 8","Pilot 8: max feedback + text",3,"low",22
"SUPPRF21828",11,51,50,49,12,52,37,50,"Pilot 8","Pilot 8: max feedback + text",3,"low",-1
"SUPPRF21828",12,49,50,70,-1,50,71,49,"Pilot 8","Pilot 8: max feedback + text",3,"low",21
"SUPPRF21828",13,49,49,45,-1,50,46,49,"Pilot 8","Pilot 8: max feedback + text",3,"low",-4
"SUPPRF21828",14,48,49,75,29,51,46,50,"Pilot 8","Pilot 8: max feedback + text",3,"low",25
"SUPPRF21828",15,48,47,46,17,48,29,48,"Pilot 8","Pilot 8: max feedback + text",3,"low",-2
"SUPPRF21828",16,50,51,94,23,49,71,48,"Pilot 8","Pilot 8: max feedback + text",3,"low",46
"SUPPRF21828",17,49,47,41,-13,50,54,50,"Pilot 8","Pilot 8: max feedback + text",3,"low",-9
"SUPPRF21828",18,48,47,33,-13,46,46,54,"Pilot 8","Pilot 8: max feedback + text",3,"low",-21
"SUPPRF21828",19,49,48,29,0,48,29,59,"Pilot 8","Pilot 8: max feedback + text",3,"low",-30
"SUPPRF21828",20,50,50,19,-1,45,20,64,"Pilot 8","Pilot 8: max feedback + text",3,"low",-45
"SUPPRF21828",21,50,50,38,-16,51,54,53,"Pilot 8","Pilot 8: max feedback + text",3,"low",-15
"SUPPRF21828",22,49,50,83,12,48,71,52,"Pilot 8","Pilot 8: max feedback + text",3,"low",31
"SUPPRF21828",23,49,49,55,1,49,54,52,"Pilot 8","Pilot 8: max feedback + text",3,"low",3
"SUPPRF21828",24,49,47,38,1,48,37,58,"Pilot 8","Pilot 8: max feedback + text",3,"low",-20
"SUPPRF21828",25,50,50,6,-14,51,20,61,"Pilot 8","Pilot 8: max feedback + text",3,"low",-55
"SUPPRF21828",26,51,51,46,0,51,46,60,"Pilot 8","Pilot 8: max feedback + text",3,"low",-14
"SUPPRF21828",27,51,49,55,-16,50,71,52,"Pilot 8","Pilot 8: max feedback + text",3,"low",3
"SUPPRF21828",28,51,50,34,-12,49,46,65,"Pilot 8","Pilot 8: max feedback + text",3,"low",-31
"SUPPRF21828",29,50,50,62,-1,50,63,54,"Pilot 8","Pilot 8: max feedback + text",3,"low",8
"SUPPRF21828",30,49,48,68,-12,47,80,54,"Pilot 8","Pilot 8: max feedback + text",3,"low",14
"SUPPRF21828",31,48,48,50,-13,48,63,50,"Pilot 8","Pilot 8: max feedback + text",3,"low",0
"SUPPRF21828",32,49,48,54,0,49,54,62,"Pilot 8","Pilot 8: max feedback + text",3,"low",-8
"SUPPRF21828",33,50,50,61,24,57,37,55,"Pilot 8","Pilot 8: max feedback + text",3,"low",6
"SUPPRF21828",34,49,50,24,-13,51,37,59,"Pilot 8","Pilot 8: max feedback + text",3,"low",-35
"SUPPRF21828",35,49,48,56,-15,51,71,52,"Pilot 8","Pilot 8: max feedback + text",3,"low",4
"SUPPRF21828",36,49,48,77,14,48,63,48,"Pilot 8","Pilot 8: max feedback + text",3,"low",29
"SUPPRF21828",37,50,49,20,0,55,20,60,"Pilot 8","Pilot 8: max feedback + text",3,"low",-40
"SUPPRF21828",38,49,50,81,1,49,80,58,"Pilot 8","Pilot 8: max feedback + text",3,"low",23
"SUPPRF21828",39,49,50,96,16,49,80,50,"Pilot 8","Pilot 8: max feedback + text",3,"low",46
"SUPPRF21828",40,48,49,67,-13,49,80,50,"Pilot 8","Pilot 8: max feedback + text",3,"low",17
"SUPPRF21828",41,48,46,35,15,45,20,34,"Pilot 8","Pilot 8: max feedback + text",3,"low",1
"SUPPRF21828",42,49,49,22,-15,52,37,67,"Pilot 8","Pilot 8: max feedback + text",3,"low",-45
"SUPPRF21828",43,50,52,15,-14,49,29,28,"Pilot 8","Pilot 8: max feedback + text",3,"low",-13
"SUPPRF21828",44,48,47,16,-13,48,29,26,"Pilot 8","Pilot 8: max feedback + text",3,"low",-10
"SUPPRF21828",45,49,48,8,-12,48,20,45,"Pilot 8","Pilot 8: max feedback + text",3,"low",-37
"SUPPRF21828",46,48,47,28,-1,49,29,24,"Pilot 8","Pilot 8: max feedback + text",3,"low",4
"SUPPRF21828",47,48,47,63,0,50,63,35,"Pilot 8","Pilot 8: max feedback + text",3,"low",28
"SUPPRF21828",48,47,50,100,20,48,80,84,"Pilot 8","Pilot 8: max feedback + text",3,"low",16
"SUPPRF23161",1,51,74,47,-16,68,63,46,"Pilot 11","Pilot 11: bigger feedback + video + socially anxious",12,"high",1
"SUPPRF23161",2,17,81,16,-13,79,29,26,"Pilot 11","Pilot 11: bigger feedback + video + socially anxious",12,"high",-10
"SUPPRF23161",3,20,79,55,-16,23,71,44,"Pilot 11","Pilot 11: bigger feedback + video + socially anxious",12,"high",11
"SUPPRF23161",4,22,80,54,0,26,54,27,"Pilot 11","Pilot 11: bigger feedback + video + socially anxious",12,"high",27
"SUPPRF23161",5,20,75,38,-16,77,54,41,"Pilot 11","Pilot 11: bigger feedback + video + socially anxious",12,"high",-3
"SUPPRF23161",6,20,77,20,0,58,20,15,"Pilot 11","Pilot 11: bigger feedback + video + socially anxious",12,"high",5
"SUPPRF23161",7,28,78,56,-15,52,71,22,"Pilot 11","Pilot 11: bigger feedback + video + socially anxious",12,"high",34
"SUPPRF23161",8,18,67,83,12,58,71,33,"Pilot 11","Pilot 11: bigger feedback + video + socially anxious",12,"high",50
"SUPPRF23161",9,36,74,63,0,29,63,53,"Pilot 11","Pilot 11: bigger feedback + video + socially anxious",12,"high",10
"SUPPRF23161",10,20,79,62,-1,32,63,35,"Pilot 11","Pilot 11: bigger feedback + video + socially anxious",12,"high",27
"SUPPRF23161",11,8,81,37,0,61,37,63,"Pilot 11","Pilot 11: bigger feedback + video + socially anxious",12,"high",-26
"SUPPRF23161",12,22,85,77,14,59,63,47,"Pilot 11","Pilot 11: bigger feedback + video + socially anxious",12,"high",30
"SUPPRF23161",13,17,81,8,-12,21,20,21,"Pilot 11","Pilot 11: bigger feedback + video + socially anxious",12,"high",-13
"SUPPRF23161",14,22,83,78,24,38,54,56,"Pilot 11","Pilot 11: bigger feedback + video + socially anxious",12,"high",22
"SUPPRF23161",15,15,76,15,-14,55,29,33,"Pilot 11","Pilot 11: bigger feedback + video + socially anxious",12,"high",-18
"SUPPRF23161",16,12,88,70,-1,40,71,30,"Pilot 11","Pilot 11: bigger feedback + video + socially anxious",12,"high",40
"SUPPRF23161",17,14,83,75,29,25,46,51,"Pilot 11","Pilot 11: bigger feedback + video + socially anxious",12,"high",24
"SUPPRF23161",18,25,70,38,1,87,37,30,"Pilot 11","Pilot 11: bigger feedback + video + socially anxious",12,"high",8
"SUPPRF23161",19,16,83,67,-13,28,80,34,"Pilot 11","Pilot 11: bigger feedback + video + socially anxious",12,"high",33
"SUPPRF23161",20,27,85,58,12,23,46,52,"Pilot 11","Pilot 11: bigger feedback + video + socially anxious",12,"high",6
"SUPPRF23161",21,11,91,28,-1,81,29,19,"Pilot 11","Pilot 11: bigger feedback + video + socially anxious",12,"high",9
"SUPPRF23161",22,11,91,6,-14,11,20,36,"Pilot 11","Pilot 11: bigger feedback + video + socially anxious",12,"high",-30
"SUPPRF23161",23,12,85,33,-13,64,46,32,"Pilot 11","Pilot 11: bigger feedback + video + socially anxious",12,"high",1
"SUPPRF23161",24,20,91,55,1,53,54,42,"Pilot 11","Pilot 11: bigger feedback + video + socially anxious",12,"high",13
"SUPPRF23161",25,14,93,46,17,85,29,9,"Pilot 11","Pilot 11: bigger feedback + video + socially anxious",12,"high",37
"SUPPRF23161",26,20,85,96,16,14,80,16,"Pilot 11","Pilot 11: bigger feedback + video + socially anxious",12,"high",80
"SUPPRF23161",27,12,90,88,25,10,63,43,"Pilot 11","Pilot 11: bigger feedback + video + socially anxious",12,"high",45
"SUPPRF23161",28,37,91,71,0,48,71,30,"Pilot 11","Pilot 11: bigger feedback + video + socially anxious",12,"high",41
"SUPPRF23161",29,18,84,66,12,34,54,56,"Pilot 11","Pilot 11: bigger feedback + video + socially anxious",12,"high",10
"SUPPRF23161",30,7,92,19,-1,11,20,55,"Pilot 11","Pilot 11: bigger feedback + video + socially anxious",12,"high",-36
"SUPPRF23161",31,6,95,58,29,12,29,19,"Pilot 11","Pilot 11: bigger feedback + video + socially anxious",12,"high",39
"SUPPRF23161",32,9,84,47,27,71,20,19,"Pilot 11","Pilot 11: bigger feedback + video + socially anxious",12,"high",28
"SUPPRF23161",33,26,89,80,0,24,80,22,"Pilot 11","Pilot 11: bigger feedback + video + socially anxious",12,"high",58
"SUPPRF23161",34,20,94,94,23,63,71,56,"Pilot 11","Pilot 11: bigger feedback + video + socially anxious",12,"high",38
"SUPPRF23161",35,16,90,61,24,29,37,50,"Pilot 11","Pilot 11: bigger feedback + video + socially anxious",12,"high",11
"SUPPRF23161",36,15,84,45,-1,64,46,54,"Pilot 11","Pilot 11: bigger feedback + video + socially anxious",12,"high",-9
"SUPPRF23161",37,19,88,100,20,22,80,45,"Pilot 11","Pilot 11: bigger feedback + video + socially anxious",12,"high",55
"SUPPRF23161",38,18,82,81,1,58,80,74,"Pilot 11","Pilot 11: bigger feedback + video + socially anxious",12,"high",7
"SUPPRF23161",39,11,90,68,-12,54,80,58,"Pilot 11","Pilot 11: bigger feedback + video + socially anxious",12,"high",10
"SUPPRF23161",40,14,89,49,12,50,37,27,"Pilot 11","Pilot 11: bigger feedback + video + socially anxious",12,"high",22
"SUPPRF23161",41,22,80,35,15,27,20,51,"Pilot 11","Pilot 11: bigger feedback + video + socially anxious",12,"high",-16
"SUPPRF23161",42,13,94,22,-15,71,37,36,"Pilot 11","Pilot 11: bigger feedback + video + socially anxious",12,"high",-14
"SUPPRF23161",43,9,90,50,-13,44,63,58,"Pilot 11","Pilot 11: bigger feedback + video + socially anxious",12,"high",-8
"SUPPRF23161",44,25,90,34,-12,19,46,44,"Pilot 11","Pilot 11: bigger feedback + video + socially anxious",12,"high",-10
"SUPPRF23161",45,10,96,41,-13,17,54,28,"Pilot 11","Pilot 11: bigger feedback + video + socially anxious",12,"high",13
"SUPPRF23161",46,6,91,29,0,71,29,20,"Pilot 11","Pilot 11: bigger feedback + video + socially anxious",12,"high",9
"SUPPRF23161",47,11,86,24,-13,24,37,59,"Pilot 11","Pilot 11: bigger feedback + video + socially anxious",12,"high",-35
"SUPPRF23161",48,14,91,46,0,25,46,40,"Pilot 11","Pilot 11: bigger feedback + video + socially anxious",12,"high",6
"SUPPRF24628",1,28,21,16,-13,69,29,27,"Pilot 9","Pilot 9: bigger feedback + text",6,"high",-11
"SUPPRF24628",2,56,21,47,27,72,20,24,"Pilot 9","Pilot 9: bigger feedback + text",6,"high",23
"SUPPRF24628",3,73,25,6,-14,64,20,21,"Pilot 9","Pilot 9: bigger feedback + text",6,"high",-15
"SUPPRF24628",4,73,3,67,-13,76,80,76,"Pilot 9","Pilot 9: bigger feedback + text",6,"high",-9
"SUPPRF24628",5,78,6,55,-16,74,71,77,"Pilot 9","Pilot 9: bigger feedback + text",6,"high",-22
"SUPPRF24628",6,25,76,58,12,59,46,41,"Pilot 9","Pilot 9: bigger feedback + text",6,"high",17
"SUPPRF24628",7,67,17,38,1,63,37,36,"Pilot 9","Pilot 9: bigger feedback + text",6,"high",2
"SUPPRF24628",8,64,62,19,-1,43,20,17,"Pilot 9","Pilot 9: bigger feedback + text",6,"high",2
"SUPPRF24628",9,91,52,78,24,60,54,54,"Pilot 9","Pilot 9: bigger feedback + text",6,"high",24
"SUPPRF24628",10,89,60,88,25,82,63,73,"Pilot 9","Pilot 9: bigger feedback + text",6,"high",15
"SUPPRF24628",11,35,63,54,0,75,54,70,"Pilot 9","Pilot 9: bigger feedback + text",6,"high",-16
"SUPPRF24628",12,39,33,50,-13,28,63,56,"Pilot 9","Pilot 9: bigger feedback + text",6,"high",-6
"SUPPRF24628",13,47,60,66,12,49,54,70,"Pilot 9","Pilot 9: bigger feedback + text",6,"high",-4
"SUPPRF24628",14,69,62,80,0,71,80,79,"Pilot 9","Pilot 9: bigger feedback + text",6,"high",1
"SUPPRF24628",15,100,43,100,20,49,80,68,"Pilot 9","Pilot 9: bigger feedback + text",6,"high",32
"SUPPRF24628",16,98,21,83,12,30,71,81,"Pilot 9","Pilot 9: bigger feedback + text",6,"high",2
"SUPPRF24628",17,30,48,20,0,41,20,20,"Pilot 9","Pilot 9: bigger feedback + text",6,"high",0
"SUPPRF24628",18,62,38,63,0,30,63,67,"Pilot 9","Pilot 9: bigger feedback + text",6,"high",-4
"SUPPRF24628",19,12,70,22,-15,22,37,47,"Pilot 9","Pilot 9: bigger feedback + text",6,"high",-25
"SUPPRF24628",20,17,50,33,-13,42,46,54,"Pilot 9","Pilot 9: bigger feedback + text",6,"high",-21
"SUPPRF24628",21,80,29,70,-1,32,71,70,"Pilot 9","Pilot 9: bigger feedback + text",6,"high",0
"SUPPRF24628",22,59,33,28,-1,68,29,15,"Pilot 9","Pilot 9: bigger feedback + text",6,"high",13
"SUPPRF24628",23,59,25,34,-12,38,46,51,"Pilot 9","Pilot 9: bigger feedback + text",6,"high",-17
"SUPPRF24628",24,65,37,81,1,61,80,76,"Pilot 9","Pilot 9: bigger feedback + text",6,"high",5
"SUPPRF24628",25,65,66,46,17,24,29,25,"Pilot 9","Pilot 9: bigger feedback + text",6,"high",21
"SUPPRF24628",26,28,26,15,-14,14,29,37,"Pilot 9","Pilot 9: bigger feedback + text",6,"high",-22
"SUPPRF24628",27,20,39,24,-13,27,37,43,"Pilot 9","Pilot 9: bigger feedback + text",6,"high",-19
"SUPPRF24628",28,59,39,47,-16,26,63,37,"Pilot 9","Pilot 9: bigger feedback + text",6,"high",10
"SUPPRF24628",29,50,33,56,-15,1,71,49,"Pilot 9","Pilot 9: bigger feedback + text",6,"high",7
"SUPPRF24628",30,51,39,75,29,25,46,52,"Pilot 9","Pilot 9: bigger feedback + text",6,"high",23
"SUPPRF24628",31,99,10,94,23,34,71,53,"Pilot 9","Pilot 9: bigger feedback + text",6,"high",41
"SUPPRF24628",32,98,21,96,16,14,80,72,"Pilot 9","Pilot 9: bigger feedback + text",6,"high",24
"SUPPRF24628",33,47,27,29,0,27,29,26,"Pilot 9","Pilot 9: bigger feedback + text",6,"high",3
"SUPPRF24628",34,49,27,71,0,56,71,70,"Pilot 9","Pilot 9: bigger feedback + text",6,"high",1
"SUPPRF24628",35,40,37,68,-12,65,80,80,"Pilot 9","Pilot 9: bigger feedback + text",6,"high",-12
"SUPPRF24628",36,25,34,49,12,69,37,47,"Pilot 9","Pilot 9: bigger feedback + text",6,"high",2
"SUPPRF24628",37,1,26,38,-16,30,54,45,"Pilot 9","Pilot 9: bigger feedback + text",6,"high",-7
"SUPPRF24628",38,4,15,62,-1,9,63,43,"Pilot 9","Pilot 9: bigger feedback + text",6,"high",19
"SUPPRF24628",39,1,30,46,0,66,46,34,"Pilot 9","Pilot 9: bigger feedback + text",6,"high",12
"SUPPRF24628",40,2,23,61,24,60,37,56,"Pilot 9","Pilot 9: bigger feedback + text",6,"high",5
"SUPPRF24628",41,8,18,41,-13,63,54,59,"Pilot 9","Pilot 9: bigger feedback + text",6,"high",-18
"SUPPRF24628",42,15,24,58,29,65,29,26,"Pilot 9","Pilot 9: bigger feedback + text",6,"high",32
"SUPPRF24628",43,9,16,37,0,29,37,55,"Pilot 9","Pilot 9: bigger feedback + text",6,"high",-18
"SUPPRF24628",44,2,22,8,-12,59,20,16,"Pilot 9","Pilot 9: bigger feedback + text",6,"high",-8
"SUPPRF24628",45,27,17,35,15,65,20,13,"Pilot 9","Pilot 9: bigger feedback + text",6,"high",22
"SUPPRF24628",46,23,17,45,-1,31,46,54,"Pilot 9","Pilot 9: bigger feedback + text",6,"high",-9
"SUPPRF24628",47,59,25,77,14,26,63,55,"Pilot 9","Pilot 9: bigger feedback + text",6,"high",22
"SUPPRF24628",48,1,21,55,1,23,54,51,"Pilot 9","Pilot 9: bigger feedback + text",6,"high",4
"SUPPRF25745",1,96,2,29,0,43,29,34,"Pilot 8","Pilot 8: max feedback + text",5,"low",-5
"SUPPRF25745",2,98,2,54,0,53,54,57,"Pilot 8","Pilot 8: max feedback + text",5,"low",-3
"SUPPRF25745",3,98,1,61,24,52,37,35,"Pilot 8","Pilot 8: max feedback + text",5,"low",26
"SUPPRF25745",4,98,1,34,-12,58,46,30,"Pilot 8","Pilot 8: max feedback + text",5,"low",4
"SUPPRF25745",5,99,1,22,-15,41,37,62,"Pilot 8","Pilot 8: max feedback + text",5,"low",-40
"SUPPRF25745",6,99,0,28,-1,75,29,30,"Pilot 8","Pilot 8: max feedback + text",5,"low",-2
"SUPPRF25745",7,98,0,81,1,78,80,71,"Pilot 8","Pilot 8: max feedback + text",5,"low",10
"SUPPRF25745",8,99,1,46,0,57,46,51,"Pilot 8","Pilot 8: max feedback + text",5,"low",-5
"SUPPRF25745",9,99,1,8,-12,78,20,24,"Pilot 8","Pilot 8: max feedback + text",5,"low",-16
"SUPPRF25745",10,100,0,45,-1,64,46,49,"Pilot 8","Pilot 8: max feedback + text",5,"low",-4
"SUPPRF25745",11,98,2,63,0,78,63,65,"Pilot 8","Pilot 8: max feedback + text",5,"low",-2
"SUPPRF25745",12,100,0,38,-16,63,54,59,"Pilot 8","Pilot 8: max feedback + text",5,"low",-21
"SUPPRF25745",13,99,1,80,0,19,80,49,"Pilot 8","Pilot 8: max feedback + text",5,"low",31
"SUPPRF25745",14,99,1,55,-16,31,71,59,"Pilot 8","Pilot 8: max feedback + text",5,"low",-4
"SUPPRF25745",15,99,1,70,-1,79,71,63,"Pilot 8","Pilot 8: max feedback + text",5,"low",7
"SUPPRF25745",16,100,0,20,0,35,20,60,"Pilot 8","Pilot 8: max feedback + text",5,"low",-40
"SUPPRF25745",17,100,0,6,-14,54,20,19,"Pilot 8","Pilot 8: max feedback + text",5,"low",-13
"SUPPRF25745",18,100,0,47,27,31,20,17,"Pilot 8","Pilot 8: max feedback + text",5,"low",30
"SUPPRF25745",19,100,0,35,15,1,20,17,"Pilot 8","Pilot 8: max feedback + text",5,"low",18
"SUPPRF25745",20,100,0,96,16,42,80,65,"Pilot 8","Pilot 8: max feedback + text",5,"low",31
"SUPPRF25745",21,100,0,62,-1,13,63,59,"Pilot 8","Pilot 8: max feedback + text",5,"low",3
"SUPPRF25745",22,100,0,83,12,70,71,72,"Pilot 8","Pilot 8: max feedback + text",5,"low",11
"SUPPRF25745",23,100,0,15,-14,61,29,70,"Pilot 8","Pilot 8: max feedback + text",5,"low",-55
"SUPPRF25745",24,100,0,50,-13,66,63,66,"Pilot 8","Pilot 8: max feedback + text",5,"low",-16
"SUPPRF25745",25,100,1,77,14,57,63,62,"Pilot 8","Pilot 8: max feedback + text",5,"low",15
"SUPPRF25745",26,100,0,24,-13,61,37,37,"Pilot 8","Pilot 8: max feedback + text",5,"low",-13
"SUPPRF25745",27,99,0,55,1,56,54,64,"Pilot 8","Pilot 8: max feedback + text",5,"low",-9
"SUPPRF25745",28,100,0,88,25,69,63,66,"Pilot 8","Pilot 8: max feedback + text",5,"low",22
"SUPPRF25745",29,100,0,16,-13,74,29,34,"Pilot 8","Pilot 8: max feedback + text",5,"low",-18
"SUPPRF25745",30,100,0,66,12,72,54,65,"Pilot 8","Pilot 8: max feedback + text",5,"low",1
"SUPPRF25745",31,100,0,33,-13,65,46,46,"Pilot 8","Pilot 8: max feedback + text",5,"low",-13
"SUPPRF25745",32,99,0,46,17,33,29,29,"Pilot 8","Pilot 8: max feedback + text",5,"low",17
"SUPPRF25745",33,100,1,78,24,80,54,66,"Pilot 8","Pilot 8: max feedback + text",5,"low",12
"SUPPRF25745",34,100,0,47,-16,77,63,63,"Pilot 8","Pilot 8: max feedback + text",5,"low",-16
"SUPPRF25745",35,100,0,38,1,53,37,34,"Pilot 8","Pilot 8: max feedback + text",5,"low",4
"SUPPRF25745",36,100,0,100,20,72,80,83,"Pilot 8","Pilot 8: max feedback + text",5,"low",17
"SUPPRF25745",37,99,0,71,0,29,71,60,"Pilot 8","Pilot 8: max feedback + text",5,"low",11
"SUPPRF25745",38,100,0,58,29,74,29,26,"Pilot 8","Pilot 8: max feedback + text",5,"low",32
"SUPPRF25745",39,99,0,37,0,67,37,41,"Pilot 8","Pilot 8: max feedback + text",5,"low",-4
"SUPPRF25745",40,100,0,41,-13,65,54,64,"Pilot 8","Pilot 8: max feedback + text",5,"low",-23
"SUPPRF25745",41,100,0,75,29,54,46,49,"Pilot 8","Pilot 8: max feedback + text",5,"low",26
"SUPPRF25745",42,100,1,19,-1,59,20,29,"Pilot 8","Pilot 8: max feedback + text",5,"low",-10
"SUPPRF25745",43,100,0,56,-15,40,71,57,"Pilot 8","Pilot 8: max feedback + text",5,"low",-1
"SUPPRF25745",44,100,0,94,23,72,71,69,"Pilot 8","Pilot 8: max feedback + text",5,"low",25
"SUPPRF25745",45,100,0,68,-12,74,80,73,"Pilot 8","Pilot 8: max feedback + text",5,"low",-5
"SUPPRF25745",46,100,0,49,12,63,37,37,"Pilot 8","Pilot 8: max feedback + text",5,"low",12
"SUPPRF25745",47,100,1,67,-13,49,80,31,"Pilot 8","Pilot 8: max feedback + text",5,"low",36
"SUPPRF25745",48,100,0,58,12,74,46,55,"Pilot 8","Pilot 8: max feedback + text",5,"low",3
"SUPPRF26467",1,93,9,28,-1,78,29,47,"Pilot 10","Pilot 10: bigger feedback + video",3,"low",-19
"SUPPRF26467",2,49,0,47,27,60,20,34,"Pilot 10","Pilot 10: bigger feedback + video",3,"low",13
"SUPPRF26467",3,100,9,35,15,40,20,61,"Pilot 10","Pilot 10: bigger feedback + video",3,"low",-26
"SUPPRF26467",4,93,0,94,23,88,71,88,"Pilot 10","Pilot 10: bigger feedback + video",3,"low",6
"SUPPRF26467",5,79,0,38,-16,4,54,46,"Pilot 10","Pilot 10: bigger feedback + video",3,"low",-8
"SUPPRF26467",6,50,0,29,0,37,29,57,"Pilot 10","Pilot 10: bigger feedback + video",3,"low",-28
"SUPPRF26467",7,75,7,49,12,51,37,69,"Pilot 10","Pilot 10: bigger feedback + video",3,"low",-20
"SUPPRF26467",8,75,0,75,29,52,46,73,"Pilot 10","Pilot 10: bigger feedback + video",3,"low",2
"SUPPRF26467",9,68,0,37,0,28,37,56,"Pilot 10","Pilot 10: bigger feedback + video",3,"low",-19
"SUPPRF26467",10,65,4,58,29,68,29,73,"Pilot 10","Pilot 10: bigger feedback + video",3,"low",-15
"SUPPRF26467",11,86,14,16,-13,46,29,69,"Pilot 10","Pilot 10: bigger feedback + video",3,"low",-53
"SUPPRF26467",12,90,6,19,-1,63,20,51,"Pilot 10","Pilot 10: bigger feedback + video",3,"low",-32
"SUPPRF26467",13,81,5,55,-16,48,71,64,"Pilot 10","Pilot 10: bigger feedback + video",3,"low",-9
"SUPPRF26467",14,89,0,88,25,15,63,74,"Pilot 10","Pilot 10: bigger feedback + video",3,"low",14
"SUPPRF26467",15,92,0,83,12,7,71,73,"Pilot 10","Pilot 10: bigger feedback + video",3,"low",10
"SUPPRF26467",16,95,3,15,-14,10,29,49,"Pilot 10","Pilot 10: bigger feedback + video",3,"low",-34
"SUPPRF26467",17,75,10,46,17,36,29,58,"Pilot 10","Pilot 10: bigger feedback + video",3,"low",-12
"SUPPRF26467",18,94,11,66,12,27,54,66,"Pilot 10","Pilot 10: bigger feedback + video",3,"low",0
"SUPPRF26467",19,67,26,45,-1,12,46,65,"Pilot 10","Pilot 10: bigger feedback + video",3,"low",-20
"SUPPRF26467",20,87,15,54,0,26,54,58,"Pilot 10","Pilot 10: bigger feedback + video",3,"low",-4
"SUPPRF26467",21,77,12,55,1,14,54,55,"Pilot 10","Pilot 10: bigger feedback + video",3,"low",0
"SUPPRF26467",22,29,47,62,-1,17,63,60,"Pilot 10","Pilot 10: bigger feedback + video",3,"low",2
"SUPPRF26467",23,71,15,80,0,44,80,62,"Pilot 10","Pilot 10: bigger feedback + video",3,"low",18
"SUPPRF26467",24,15,69,50,-13,21,63,67,"Pilot 10","Pilot 10: bigger feedback + video",3,"low",-17
"SUPPRF26467",25,21,78,78,24,35,54,67,"Pilot 10","Pilot 10: bigger feedback + video",3,"low",11
"SUPPRF26467",26,51,53,81,1,32,80,76,"Pilot 10","Pilot 10: bigger feedback + video",3,"low",5
"SUPPRF26467",27,86,1,6,-14,17,20,54,"Pilot 10","Pilot 10: bigger feedback + video",3,"low",-48
"SUPPRF26467",28,74,20,61,24,15,37,49,"Pilot 10","Pilot 10: bigger feedback + video",3,"low",12
"SUPPRF26467",29,76,13,33,-13,36,46,2,"Pilot 10","Pilot 10: bigger feedback + video",3,"low",31
"SUPPRF26467",30,64,20,38,1,24,37,53,"Pilot 10","Pilot 10: bigger feedback + video",3,"low",-15
"SUPPRF26467",31,41,36,47,-16,44,63,43,"Pilot 10","Pilot 10: bigger feedback + video",3,"low",4
"SUPPRF26467",32,48,44,46,0,24,46,56,"Pilot 10","Pilot 10: bigger feedback + video",3,"low",-10
"SUPPRF26467",33,5,70,8,-12,36,20,53,"Pilot 10","Pilot 10: bigger feedback + video",3,"low",-45
"SUPPRF26467",34,49,47,58,12,41,46,61,"Pilot 10","Pilot 10: bigger feedback + video",3,"low",-3
"SUPPRF26467",35,50,23,63,0,11,63,48,"Pilot 10","Pilot 10: bigger feedback + video",3,"low",15
"SUPPRF26467",36,51,23,22,-15,40,37,53,"Pilot 10","Pilot 10: bigger feedback + video",3,"low",-31
"SUPPRF26467",37,97,3,100,20,21,80,97,"Pilot 10","Pilot 10: bigger feedback + video",3,"low",3
"SUPPRF26467",38,87,15,20,0,8,20,47,"Pilot 10","Pilot 10: bigger feedback + video",3,"low",-27
"SUPPRF26467",39,72,19,24,-13,35,37,58,"Pilot 10","Pilot 10: bigger feedback + video",3,"low",-34
"SUPPRF26467",40,70,16,67,-13,23,80,75,"Pilot 10","Pilot 10: bigger feedback + video",3,"low",-8
"SUPPRF26467",41,85,10,96,16,4,80,93,"Pilot 10","Pilot 10: bigger feedback + video",3,"low",3
"SUPPRF26467",42,45,31,34,-12,28,46,69,"Pilot 10","Pilot 10: bigger feedback + video",3,"low",-35
"SUPPRF26467",43,70,5,70,-1,22,71,53,"Pilot 10","Pilot 10: bigger feedback + video",3,"low",17
"SUPPRF26467",44,46,51,56,-15,38,71,59,"Pilot 10","Pilot 10: bigger feedback + video",3,"low",-3
"SUPPRF26467",45,55,39,71,0,47,71,50,"Pilot 10","Pilot 10: bigger feedback + video",3,"low",21
"SUPPRF26467",46,43,51,68,-12,23,80,52,"Pilot 10","Pilot 10: bigger feedback + video",3,"low",16
"SUPPRF26467",47,67,33,41,-13,29,54,49,"Pilot 10","Pilot 10: bigger feedback + video",3,"low",-8
"SUPPRF26467",48,52,37,77,14,40,63,63,"Pilot 10","Pilot 10: bigger feedback + video",3,"low",14
"SUPPRF28694",1,68,49,62,-1,11,63,12,"Pilot 9","Pilot 9: bigger feedback + text",9,"high",50
"SUPPRF28694",2,63,20,63,0,29,63,20,"Pilot 9","Pilot 9: bigger feedback + text",9,"high",43
"SUPPRF28694",3,79,20,54,0,25,54,32,"Pilot 9","Pilot 9: bigger feedback + text",9,"high",22
"SUPPRF28694",4,49,29,22,-15,22,37,42,"Pilot 9","Pilot 9: bigger feedback + text",9,"high",-20
"SUPPRF28694",5,75,25,83,12,52,71,50,"Pilot 9","Pilot 9: bigger feedback + text",9,"high",33
"SUPPRF28694",6,61,15,41,-13,41,54,52,"Pilot 9","Pilot 9: bigger feedback + text",9,"high",-11
"SUPPRF28694",7,74,18,81,1,56,80,22,"Pilot 9","Pilot 9: bigger feedback + text",9,"high",59
"SUPPRF28694",8,68,15,75,29,14,46,50,"Pilot 9","Pilot 9: bigger feedback + text",9,"high",25
"SUPPRF28694",9,100,6,100,20,15,80,40,"Pilot 9","Pilot 9: bigger feedback + text",9,"high",60
"SUPPRF28694",10,67,20,20,0,65,20,73,"Pilot 9","Pilot 9: bigger feedback + text",9,"high",-53
"SUPPRF28694",11,60,15,55,-16,52,71,68,"Pilot 9","Pilot 9: bigger feedback + text",9,"high",-13
"SUPPRF28694",12,47,24,33,-13,16,46,32,"Pilot 9","Pilot 9: bigger feedback + text",9,"high",1
"SUPPRF28694",13,66,14,24,-13,24,37,25,"Pilot 9","Pilot 9: bigger feedback + text",9,"high",-1
"SUPPRF28694",14,56,18,55,1,25,54,23,"Pilot 9","Pilot 9: bigger feedback + text",9,"high",32
"SUPPRF28694",15,15,23,8,-12,14,20,15,"Pilot 9","Pilot 9: bigger feedback + text",9,"high",-7
"SUPPRF28694",16,54,18,56,-15,45,71,61,"Pilot 9","Pilot 9: bigger feedback + text",9,"high",-5
"SUPPRF28694",17,33,32,15,-14,33,29,38,"Pilot 9","Pilot 9: bigger feedback + text",9,"high",-23
"SUPPRF28694",18,21,26,58,29,28,29,31,"Pilot 9","Pilot 9: bigger feedback + text",9,"high",27
"SUPPRF28694",19,26,22,66,12,22,54,34,"Pilot 9","Pilot 9: bigger feedback + text",9,"high",32
"SUPPRF28694",20,39,20,50,-13,19,63,63,"Pilot 9","Pilot 9: bigger feedback + text",9,"high",-13
"SUPPRF28694",21,51,13,28,-1,54,29,19,"Pilot 9","Pilot 9: bigger feedback + text",9,"high",9
"SUPPRF28694",22,79,20,94,23,30,71,28,"Pilot 9","Pilot 9: bigger feedback + text",9,"high",66
"SUPPRF28694",23,28,30,46,0,35,46,33,"Pilot 9","Pilot 9: bigger feedback + text",9,"high",13
"SUPPRF28694",24,35,37,77,14,7,63,40,"Pilot 9","Pilot 9: bigger feedback + text",9,"high",37
"SUPPRF28694",25,56,34,68,-12,20,80,50,"Pilot 9","Pilot 9: bigger feedback + text",9,"high",18
"SUPPRF28694",26,50,22,38,1,24,37,42,"Pilot 9","Pilot 9: bigger feedback + text",9,"high",-4
"SUPPRF28694",27,42,27,80,0,42,80,27,"Pilot 9","Pilot 9: bigger feedback + text",9,"high",53
"SUPPRF28694",28,38,30,35,15,40,20,48,"Pilot 9","Pilot 9: bigger feedback + text",9,"high",-13
"SUPPRF28694",29,44,35,49,12,41,37,51,"Pilot 9","Pilot 9: bigger feedback + text",9,"high",-2
"SUPPRF28694",30,39,25,45,-1,46,46,45,"Pilot 9","Pilot 9: bigger feedback + text",9,"high",0
"SUPPRF28694",31,45,29,34,-12,30,46,41,"Pilot 9","Pilot 9: bigger feedback + text",9,"high",-7
"SUPPRF28694",32,40,24,78,24,8,54,20,"Pilot 9","Pilot 9: bigger feedback + text",9,"high",58
"SUPPRF28694",33,36,32,38,-16,38,54,30,"Pilot 9","Pilot 9: bigger feedback + text",9,"high",8
"SUPPRF28694",34,44,29,70,-1,4,71,44,"Pilot 9","Pilot 9: bigger feedback + text",9,"high",26
"SUPPRF28694",35,34,50,37,0,13,37,22,"Pilot 9","Pilot 9: bigger feedback + text",9,"high",15
"SUPPRF28694",36,40,42,47,-16,41,63,17,"Pilot 9","Pilot 9: bigger feedback + text",9,"high",30
"SUPPRF28694",37,46,29,19,-1,26,20,35,"Pilot 9","Pilot 9: bigger feedback + text",9,"high",-16
"SUPPRF28694",38,57,54,67,-13,42,80,36,"Pilot 9","Pilot 9: bigger feedback + text",9,"high",31
"SUPPRF28694",39,27,26,16,-13,24,29,36,"Pilot 9","Pilot 9: bigger feedback + text",9,"high",-20
"SUPPRF28694",40,38,34,47,27,23,20,17,"Pilot 9","Pilot 9: bigger feedback + text",9,"high",30
"SUPPRF28694",41,28,21,71,0,20,71,27,"Pilot 9","Pilot 9: bigger feedback + text",9,"high",44
"SUPPRF28694",42,56,8,46,17,22,29,41,"Pilot 9","Pilot 9: bigger feedback + text",9,"high",5
"SUPPRF28694",43,67,24,88,25,33,63,44,"Pilot 9","Pilot 9: bigger feedback + text",9,"high",44
"SUPPRF28694",44,20,15,61,24,21,37,37,"Pilot 9","Pilot 9: bigger feedback + text",9,"high",24
"SUPPRF28694",45,32,37,6,-14,25,20,27,"Pilot 9","Pilot 9: bigger feedback + text",9,"high",-21
"SUPPRF28694",46,43,40,58,12,39,46,32,"Pilot 9","Pilot 9: bigger feedback + text",9,"high",26
"SUPPRF28694",47,35,23,29,0,28,29,20,"Pilot 9","Pilot 9: bigger feedback + text",9,"high",9
"SUPPRF28694",48,26,23,96,16,6,80,13,"Pilot 9","Pilot 9: bigger feedback + text",9,"high",83
"SUPPRF28820",1,51,51,63,0,51,63,50,"Pilot 8","Pilot 8: max feedback + text",5,"low",13
"SUPPRF28820",2,50,51,88,25,52,63,50,"Pilot 8","Pilot 8: max feedback + text",5,"low",38
"SUPPRF28820",3,48,49,22,-15,72,37,40,"Pilot 8","Pilot 8: max feedback + text",5,"low",-18
"SUPPRF28820",4,50,49,81,1,62,80,73,"Pilot 8","Pilot 8: max feedback + text",5,"low",8
"SUPPRF28820",5,50,51,47,27,82,20,20,"Pilot 8","Pilot 8: max feedback + text",5,"low",27
"SUPPRF28820",6,53,55,45,-1,65,46,52,"Pilot 8","Pilot 8: max feedback + text",5,"low",-7
"SUPPRF28820",7,52,52,55,-16,62,71,55,"Pilot 8","Pilot 8: max feedback + text",5,"low",0
"SUPPRF28820",8,74,24,71,0,60,71,55,"Pilot 8","Pilot 8: max feedback + text",5,"low",16
"SUPPRF28820",9,67,30,66,12,58,54,54,"Pilot 8","Pilot 8: max feedback + text",5,"low",12
"SUPPRF28820",10,75,24,46,0,63,46,60,"Pilot 8","Pilot 8: max feedback + text",5,"low",-14
"SUPPRF28820",11,69,24,61,24,64,37,50,"Pilot 8","Pilot 8: max feedback + text",5,"low",11
"SUPPRF28820",12,74,30,38,1,62,37,50,"Pilot 8","Pilot 8: max feedback + text",5,"low",-12
"SUPPRF28820",13,82,12,94,23,76,71,75,"Pilot 8","Pilot 8: max feedback + text",5,"low",19
"SUPPRF28820",14,75,25,37,0,33,37,50,"Pilot 8","Pilot 8: max feedback + text",5,"low",-13
"SUPPRF28820",15,82,18,78,24,62,54,53,"Pilot 8","Pilot 8: max feedback + text",5,"low",25
"SUPPRF28820",16,75,15,8,-12,31,20,50,"Pilot 8","Pilot 8: max feedback + text",5,"low",-42
"SUPPRF28820",17,81,18,46,17,57,29,52,"Pilot 8","Pilot 8: max feedback + text",5,"low",-6
"SUPPRF28820",18,81,16,16,-13,63,29,65,"Pilot 8","Pilot 8: max feedback + text",5,"low",-49
"SUPPRF28820",19,73,20,24,-13,52,37,24,"Pilot 8","Pilot 8: max feedback + text",5,"low",0
"SUPPRF28820",20,82,18,28,-1,49,29,31,"Pilot 8","Pilot 8: max feedback + text",5,"low",-3
"SUPPRF28820",21,76,12,20,0,71,20,15,"Pilot 8","Pilot 8: max feedback + text",5,"low",5
"SUPPRF28820",22,76,17,54,0,70,54,47,"Pilot 8","Pilot 8: max feedback + text",5,"low",7
"SUPPRF28820",23,84,14,56,-15,64,71,58,"Pilot 8","Pilot 8: max feedback + text",5,"low",-2
"SUPPRF28820",24,84,13,67,-13,74,80,72,"Pilot 8","Pilot 8: max feedback + text",5,"low",-5
"SUPPRF28820",25,82,19,80,0,55,80,70,"Pilot 8","Pilot 8: max feedback + text",5,"low",10
"SUPPRF28820",26,79,17,83,12,63,71,76,"Pilot 8","Pilot 8: max feedback + text",5,"low",7
"SUPPRF28820",27,88,21,15,-14,48,29,27,"Pilot 8","Pilot 8: max feedback + text",5,"low",-12
"SUPPRF28820",28,88,16,29,0,56,29,35,"Pilot 8","Pilot 8: max feedback + text",5,"low",-6
"SUPPRF28820",29,83,23,34,-12,65,46,53,"Pilot 8","Pilot 8: max feedback + text",5,"low",-19
"SUPPRF28820",30,84,15,35,15,55,20,35,"Pilot 8","Pilot 8: max feedback + text",5,"low",0
"SUPPRF28820",31,86,11,70,-1,52,71,57,"Pilot 8","Pilot 8: max feedback + text",5,"low",13
"SUPPRF28820",32,83,8,55,1,66,54,48,"Pilot 8","Pilot 8: max feedback + text",5,"low",7
"SUPPRF28820",33,85,10,50,-13,47,63,61,"Pilot 8","Pilot 8: max feedback + text",5,"low",-11
"SUPPRF28820",34,89,13,38,-16,47,54,62,"Pilot 8","Pilot 8: max feedback + text",5,"low",-24
"SUPPRF28820",35,99,0,100,20,50,80,59,"Pilot 8","Pilot 8: max feedback + text",5,"low",41
"SUPPRF28820",36,88,8,77,14,52,63,68,"Pilot 8","Pilot 8: max feedback + text",5,"low",9
"SUPPRF28820",37,72,5,6,-14,71,20,33,"Pilot 8","Pilot 8: max feedback + text",5,"low",-27
"SUPPRF28820",38,89,7,58,29,19,29,76,"Pilot 8","Pilot 8: max feedback + text",5,"low",-18
"SUPPRF28820",39,89,12,19,-1,32,20,61,"Pilot 8","Pilot 8: max feedback + text",5,"low",-42
"SUPPRF28820",40,94,7,96,16,29,80,74,"Pilot 8","Pilot 8: max feedback + text",5,"low",22
"SUPPRF28820",41,87,8,58,12,49,46,49,"Pilot 8","Pilot 8: max feedback + text",5,"low",9
"SUPPRF28820",42,92,7,47,-16,19,63,86,"Pilot 8","Pilot 8: max feedback + text",5,"low",-39
"SUPPRF28820",43,87,7,75,29,17,46,50,"Pilot 8","Pilot 8: max feedback + text",5,"low",25
"SUPPRF28820",44,91,12,41,-13,15,54,79,"Pilot 8","Pilot 8: max feedback + text",5,"low",-38
"SUPPRF28820",45,88,5,68,-12,18,80,75,"Pilot 8","Pilot 8: max feedback + text",5,"low",-7
"SUPPRF28820",46,88,11,62,-1,14,63,46,"Pilot 8","Pilot 8: max feedback + text",5,"low",16
"SUPPRF28820",47,92,6,33,-13,50,46,79,"Pilot 8","Pilot 8: max feedback + text",5,"low",-46
"SUPPRF28820",48,89,10,49,12,48,37,50,"Pilot 8","Pilot 8: max feedback + text",5,"low",-1
"SUPPRF28831",1,62,15,34,-12,66,46,45,"Pilot 8","Pilot 8: max feedback + text",9,"high",-11
"SUPPRF28831",2,60,15,35,15,70,20,20,"Pilot 8","Pilot 8: max feedback + text",9,"high",15
"SUPPRF28831",3,58,17,47,27,76,20,34,"Pilot 8","Pilot 8: max feedback + text",9,"high",13
"SUPPRF28831",4,73,13,83,12,75,71,78,"Pilot 8","Pilot 8: max feedback + text",9,"high",5
"SUPPRF28831",5,69,0,94,23,72,71,74,"Pilot 8","Pilot 8: max feedback + text",9,"high",20
"SUPPRF28831",6,66,0,66,12,78,54,71,"Pilot 8","Pilot 8: max feedback + text",9,"high",-5
"SUPPRF28831",7,66,0,33,-13,32,46,46,"Pilot 8","Pilot 8: max feedback + text",9,"high",-13
"SUPPRF28831",8,70,0,88,25,49,63,70,"Pilot 8","Pilot 8: max feedback + text",9,"high",18
"SUPPRF28831",9,57,0,67,-13,77,80,79,"Pilot 8","Pilot 8: max feedback + text",9,"high",-12
"SUPPRF28831",10,67,0,20,0,0,20,20,"Pilot 8","Pilot 8: max feedback + text",9,"high",0
"SUPPRF28831",11,76,0,62,-1,23,63,67,"Pilot 8","Pilot 8: max feedback + text",9,"high",-5
"SUPPRF28831",12,66,0,61,24,100,37,25,"Pilot 8","Pilot 8: max feedback + text",9,"high",36
"SUPPRF28831",13,65,0,24,-13,75,37,41,"Pilot 8","Pilot 8: max feedback + text",9,"high",-17
"SUPPRF28831",14,64,3,47,-16,94,63,75,"Pilot 8","Pilot 8: max feedback + text",9,"high",-28
"SUPPRF28831",15,69,0,55,-16,50,71,68,"Pilot 8","Pilot 8: max feedback + text",9,"high",-13
"SUPPRF28831",16,64,0,50,-13,72,63,73,"Pilot 8","Pilot 8: max feedback + text",9,"high",-23
"SUPPRF28831",17,60,0,22,-15,0,37,68,"Pilot 8","Pilot 8: max feedback + text",9,"high",-46
"SUPPRF28831",18,68,0,68,-12,76,80,68,"Pilot 8","Pilot 8: max feedback + text",9,"high",0
"SUPPRF28831",19,72,3,58,29,75,29,71,"Pilot 8","Pilot 8: max feedback + text",9,"high",-13
"SUPPRF28831",20,66,0,55,1,72,54,76,"Pilot 8","Pilot 8: max feedback + text",9,"high",-21
"SUPPRF28831",21,72,0,75,29,10,46,43,"Pilot 8","Pilot 8: max feedback + text",9,"high",32
"SUPPRF28831",22,65,0,54,0,68,54,71,"Pilot 8","Pilot 8: max feedback + text",9,"high",-17
"SUPPRF28831",23,67,0,29,0,100,29,6,"Pilot 8","Pilot 8: max feedback + text",9,"high",23
"SUPPRF28831",24,70,0,6,-14,73,20,11,"Pilot 8","Pilot 8: max feedback + text",9,"high",-5
"SUPPRF28831",25,75,0,96,16,16,80,85,"Pilot 8","Pilot 8: max feedback + text",9,"high",11
"SUPPRF28831",26,71,0,56,-15,77,71,75,"Pilot 8","Pilot 8: max feedback + text",9,"high",-19
"SUPPRF28831",27,70,0,78,24,78,54,38,"Pilot 8","Pilot 8: max feedback + text",9,"high",40
"SUPPRF28831",28,74,0,15,-14,63,29,43,"Pilot 8","Pilot 8: max feedback + text",9,"high",-28
"SUPPRF28831",29,70,0,41,-13,74,54,67,"Pilot 8","Pilot 8: max feedback + text",9,"high",-26
"SUPPRF28831",30,66,0,63,0,66,63,66,"Pilot 8","Pilot 8: max feedback + text",9,"high",-3
"SUPPRF28831",31,63,0,58,12,12,46,38,"Pilot 8","Pilot 8: max feedback + text",9,"high",20
"SUPPRF28831",32,66,0,16,-13,78,29,42,"Pilot 8","Pilot 8: max feedback + text",9,"high",-26
"SUPPRF28831",33,68,0,71,0,95,71,79,"Pilot 8","Pilot 8: max feedback + text",9,"high",-8
"SUPPRF28831",34,81,2,46,17,81,29,25,"Pilot 8","Pilot 8: max feedback + text",9,"high",21
"SUPPRF28831",35,67,0,38,-16,74,54,72,"Pilot 8","Pilot 8: max feedback + text",9,"high",-34
"SUPPRF28831",36,72,0,19,-1,77,20,30,"Pilot 8","Pilot 8: max feedback + text",9,"high",-11
"SUPPRF28831",37,71,0,49,12,73,37,42,"Pilot 8","Pilot 8: max feedback + text",9,"high",7
"SUPPRF28831",38,68,0,8,-12,80,20,28,"Pilot 8","Pilot 8: max feedback + text",9,"high",-20
"SUPPRF28831",39,70,0,28,-1,76,29,26,"Pilot 8","Pilot 8: max feedback + text",9,"high",2
"SUPPRF28831",40,67,0,70,-1,87,71,80,"Pilot 8","Pilot 8: max feedback + text",9,"high",-10
"SUPPRF28831",41,74,0,45,-1,84,46,49,"Pilot 8","Pilot 8: max feedback + text",9,"high",-4
"SUPPRF28831",42,66,0,38,1,0,37,0,"Pilot 8","Pilot 8: max feedback + text",9,"high",38
"SUPPRF28831",43,76,0,77,14,75,63,59,"Pilot 8","Pilot 8: max feedback + text",9,"high",18
"SUPPRF28831",44,70,0,46,0,86,46,49,"Pilot 8","Pilot 8: max feedback + text",9,"high",-3
"SUPPRF28831",45,68,0,37,0,87,37,43,"Pilot 8","Pilot 8: max feedback + text",9,"high",-6
"SUPPRF28831",46,75,0,80,0,22,80,84,"Pilot 8","Pilot 8: max feedback + text",9,"high",-4
"SUPPRF28831",47,76,0,100,20,82,80,87,"Pilot 8","Pilot 8: max feedback + text",9,"high",13
"SUPPRF28831",48,74,0,81,1,72,80,78,"Pilot 8","Pilot 8: max feedback + text",9,"high",3
"SUPPRF30203",1,52,51,22,-15,66,37,33,"Pilot 6","Pilot 6: feedback + text",8,"high",-11
"SUPPRF30203",2,47,50,16,-13,40,29,44,"Pilot 6","Pilot 6: feedback + text",8,"high",-28
"SUPPRF30203",3,50,47,28,-1,53,29,22,"Pilot 6","Pilot 6: feedback + text",8,"high",6
"SUPPRF30203",4,35,38,6,-14,40,20,36,"Pilot 6","Pilot 6: feedback + text",8,"high",-30
"SUPPRF30203",5,45,49,46,17,28,29,16,"Pilot 6","Pilot 6: feedback + text",8,"high",30
"SUPPRF30203",6,43,49,71,0,59,71,69,"Pilot 6","Pilot 6: feedback + text",8,"high",2
"SUPPRF30203",7,49,51,83,12,70,71,62,"Pilot 6","Pilot 6: feedback + text",8,"high",21
"SUPPRF30203",8,47,47,55,1,41,54,41,"Pilot 6","Pilot 6: feedback + text",8,"high",14
"SUPPRF30203",9,48,48,45,-1,53,46,58,"Pilot 6","Pilot 6: feedback + text",8,"high",-13
"SUPPRF30203",10,60,52,81,1,64,80,53,"Pilot 6","Pilot 6: feedback + text",8,"high",28
"SUPPRF30203",11,48,33,29,0,49,29,65,"Pilot 6","Pilot 6: feedback + text",8,"high",-36
"SUPPRF30203",12,50,46,37,0,33,37,35,"Pilot 6","Pilot 6: feedback + text",8,"high",2
"SUPPRF30203",13,32,40,24,-13,47,37,43,"Pilot 6","Pilot 6: feedback + text",8,"high",-19
"SUPPRF30203",14,43,45,38,-16,47,54,49,"Pilot 6","Pilot 6: feedback + text",8,"high",-11
"SUPPRF30203",15,46,47,58,12,77,46,19,"Pilot 6","Pilot 6: feedback + text",8,"high",39
"SUPPRF30203",16,51,47,35,15,42,20,11,"Pilot 6","Pilot 6: feedback + text",8,"high",24
"SUPPRF30203",17,57,60,96,16,43,80,45,"Pilot 6","Pilot 6: feedback + text",8,"high",51
"SUPPRF30203",18,55,54,49,12,0,37,67,"Pilot 6","Pilot 6: feedback + text",8,"high",-18
"SUPPRF30203",19,44,45,38,1,55,37,44,"Pilot 6","Pilot 6: feedback + text",8,"high",-6
"SUPPRF30203",20,40,40,66,12,70,54,50,"Pilot 6","Pilot 6: feedback + text",8,"high",16
"SUPPRF30203",21,18,53,19,-1,59,20,62,"Pilot 6","Pilot 6: feedback + text",8,"high",-43
"SUPPRF30203",22,57,72,50,-13,53,63,56,"Pilot 6","Pilot 6: feedback + text",8,"high",-6
"SUPPRF30203",23,52,46,51,14,49,37,55,"Pilot 6","Pilot 6: feedback + text",8,"high",-4
"SUPPRF30203",24,44,45,20,0,22,20,12,"Pilot 6","Pilot 6: feedback + text",8,"high",8
"SUPPRF30203",25,44,31,8,-12,38,20,16,"Pilot 6","Pilot 6: feedback + text",8,"high",-8
"SUPPRF30203",26,64,53,62,-1,46,63,55,"Pilot 6","Pilot 6: feedback + text",8,"high",7
"SUPPRF30203",27,48,47,48,19,58,29,49,"Pilot 6","Pilot 6: feedback + text",8,"high",-1
"SUPPRF30203",28,48,53,55,-16,43,71,42,"Pilot 6","Pilot 6: feedback + text",8,"high",13
"SUPPRF30203",29,57,44,63,0,53,63,50,"Pilot 6","Pilot 6: feedback + text",8,"high",13
"SUPPRF30203",30,43,37,41,-13,48,54,60,"Pilot 6","Pilot 6: feedback + text",8,"high",-19
"SUPPRF30203",31,48,44,67,-13,39,80,47,"Pilot 6","Pilot 6: feedback + text",8,"high",20
"SUPPRF30203",32,56,67,70,-1,59,71,59,"Pilot 6","Pilot 6: feedback + text",8,"high",11
"SUPPRF30203",33,53,55,54,0,50,54,54,"Pilot 6","Pilot 6: feedback + text",8,"high",0
"SUPPRF30203",34,50,44,34,-12,55,46,52,"Pilot 6","Pilot 6: feedback + text",8,"high",-18
"SUPPRF30203",35,51,47,68,-12,59,80,56,"Pilot 6","Pilot 6: feedback + text",8,"high",12
"SUPPRF30203",36,51,56,68,14,47,54,42,"Pilot 6","Pilot 6: feedback + text",8,"high",26
"SUPPRF30203",37,48,42,33,-13,50,46,45,"Pilot 6","Pilot 6: feedback + text",8,"high",-12
"SUPPRF30203",38,39,38,15,-14,22,29,19,"Pilot 6","Pilot 6: feedback + text",8,"high",-4
"SUPPRF30203",39,43,47,47,-16,42,63,49,"Pilot 6","Pilot 6: feedback + text",8,"high",-2
"SUPPRF30203",40,55,41,56,-15,46,71,36,"Pilot 6","Pilot 6: feedback + text",8,"high",20
"SUPPRF30203",41,42,44,77,14,47,63,42,"Pilot 6","Pilot 6: feedback + text",8,"high",35
"SUPPRF30203",42,44,47,46,0,45,46,51,"Pilot 6","Pilot 6: feedback + text",8,"high",-5
"SUPPRF30203",43,45,51,78,15,47,63,41,"Pilot 6","Pilot 6: feedback + text",8,"high",37
"SUPPRF30203",44,75,52,37,17,23,20,13,"Pilot 6","Pilot 6: feedback + text",8,"high",24
"SUPPRF30203",45,54,47,65,19,52,46,47,"Pilot 6","Pilot 6: feedback + text",8,"high",18
"SUPPRF30203",46,38,21,97,17,43,80,28,"Pilot 6","Pilot 6: feedback + text",8,"high",69
"SUPPRF30203",47,46,54,84,13,58,71,62,"Pilot 6","Pilot 6: feedback + text",8,"high",22
"SUPPRF30203",48,53,47,80,0,63,80,82,"Pilot 6","Pilot 6: feedback + text",8,"high",-2
"SUPPRF30226",1,28,90,34,-12,63,46,46,"Pilot 8","Pilot 8: max feedback + text",12,"high",-12
"SUPPRF30226",2,37,84,71,0,64,71,41,"Pilot 8","Pilot 8: max feedback + text",12,"high",30
"SUPPRF30226",3,16,89,6,-14,35,20,52,"Pilot 8","Pilot 8: max feedback + text",12,"high",-46
"SUPPRF30226",4,24,94,38,-16,75,54,59,"Pilot 8","Pilot 8: max feedback + text",12,"high",-21
"SUPPRF30226",5,28,93,46,17,79,29,62,"Pilot 8","Pilot 8: max feedback + text",12,"high",-16
"SUPPRF30226",6,24,92,78,24,44,54,25,"Pilot 8","Pilot 8: max feedback + text",12,"high",53
"SUPPRF30226",7,9,92,38,1,32,37,55,"Pilot 8","Pilot 8: max feedback + text",12,"high",-17
"SUPPRF30226",8,22,87,96,16,33,80,15,"Pilot 8","Pilot 8: max feedback + text",12,"high",81
"SUPPRF30226",9,18,91,83,12,26,71,54,"Pilot 8","Pilot 8: max feedback + text",12,"high",29
"SUPPRF30226",10,12,88,77,14,20,63,33,"Pilot 8","Pilot 8: max feedback + text",12,"high",44
"SUPPRF30226",11,22,93,33,-13,25,46,55,"Pilot 8","Pilot 8: max feedback + text",12,"high",-22
"SUPPRF30226",12,16,91,22,-15,64,37,38,"Pilot 8","Pilot 8: max feedback + text",12,"high",-16
"SUPPRF30226",13,15,89,58,29,25,29,55,"Pilot 8","Pilot 8: max feedback + text",12,"high",3
"SUPPRF30226",14,20,97,61,24,40,37,35,"Pilot 8","Pilot 8: max feedback + text",12,"high",26
"SUPPRF30226",15,86,89,47,27,19,20,22,"Pilot 8","Pilot 8: max feedback + text",12,"high",25
"SUPPRF30226",16,24,100,15,-14,71,29,15,"Pilot 8","Pilot 8: max feedback + text",12,"high",0
"SUPPRF30226",17,26,100,46,0,78,46,15,"Pilot 8","Pilot 8: max feedback + text",12,"high",31
"SUPPRF30226",18,8,93,68,-12,30,80,48,"Pilot 8","Pilot 8: max feedback + text",12,"high",20
"SUPPRF30226",19,10,98,8,-12,77,20,27,"Pilot 8","Pilot 8: max feedback + text",12,"high",-19
"SUPPRF30226",20,16,94,94,23,75,71,47,"Pilot 8","Pilot 8: max feedback + text",12,"high",47
"SUPPRF30226",21,20,96,28,-1,84,29,30,"Pilot 8","Pilot 8: max feedback + text",12,"high",-2
"SUPPRF30226",22,19,99,35,15,59,20,30,"Pilot 8","Pilot 8: max feedback + text",12,"high",5
"SUPPRF30226",23,16,100,55,-16,74,71,31,"Pilot 8","Pilot 8: max feedback + text",12,"high",24
"SUPPRF30226",24,24,98,70,-1,24,71,7,"Pilot 8","Pilot 8: max feedback + text",12,"high",63
"SUPPRF30226",25,13,94,54,0,39,54,13,"Pilot 8","Pilot 8: max feedback + text",12,"high",41
"SUPPRF30226",26,20,100,80,0,71,80,13,"Pilot 8","Pilot 8: max feedback + text",12,"high",67
"SUPPRF30226",27,5,100,41,-13,44,54,26,"Pilot 8","Pilot 8: max feedback + text",12,"high",15
"SUPPRF30226",28,25,99,58,12,26,46,48,"Pilot 8","Pilot 8: max feedback + text",12,"high",10
"SUPPRF30226",29,0,100,29,0,89,29,30,"Pilot 8","Pilot 8: max feedback + text",12,"high",-1
"SUPPRF30226",30,1,100,50,-13,76,63,14,"Pilot 8","Pilot 8: max feedback + text",12,"high",36
"SUPPRF30226",31,2,100,20,0,26,20,13,"Pilot 8","Pilot 8: max feedback + text",12,"high",7
"SUPPRF30226",32,0,98,66,12,1,54,0,"Pilot 8","Pilot 8: max feedback + text",12,"high",66
"SUPPRF30226",33,0,97,62,-1,34,63,7,"Pilot 8","Pilot 8: max feedback + text",12,"high",55
"SUPPRF30226",34,0,99,19,-1,7,20,7,"Pilot 8","Pilot 8: max feedback + text",12,"high",12
"SUPPRF30226",35,0,98,16,-13,44,29,4,"Pilot 8","Pilot 8: max feedback + text",12,"high",12
"SUPPRF30226",36,0,98,56,-15,56,71,0,"Pilot 8","Pilot 8: max feedback + text",12,"high",56
"SUPPRF30226",37,1,99,63,0,29,63,9,"Pilot 8","Pilot 8: max feedback + text",12,"high",54
"SUPPRF30226",38,1,0,81,1,64,80,72,"Pilot 8","Pilot 8: max feedback + text",12,"high",9
"SUPPRF30226",39,3,97,49,12,55,37,0,"Pilot 8","Pilot 8: max feedback + text",12,"high",49
"SUPPRF30226",40,2,99,47,-16,43,63,33,"Pilot 8","Pilot 8: max feedback + text",12,"high",14
"SUPPRF30226",41,2,98,88,25,40,63,3,"Pilot 8","Pilot 8: max feedback + text",12,"high",85
"SUPPRF30226",42,1,100,75,29,70,46,19,"Pilot 8","Pilot 8: max feedback + text",12,"high",56
"SUPPRF30226",43,1,97,55,1,32,54,11,"Pilot 8","Pilot 8: max feedback + text",12,"high",44
"SUPPRF30226",44,1,100,67,-13,59,80,10,"Pilot 8","Pilot 8: max feedback + text",12,"high",57
"SUPPRF30226",45,0,98,37,0,33,37,42,"Pilot 8","Pilot 8: max feedback + text",12,"high",-5
"SUPPRF30226",46,2,100,24,-13,26,37,30,"Pilot 8","Pilot 8: max feedback + text",12,"high",-6
"SUPPRF30226",47,0,99,100,20,29,80,48,"Pilot 8","Pilot 8: max feedback + text",12,"high",52
"SUPPRF30226",48,0,98,45,-1,39,46,40,"Pilot 8","Pilot 8: max feedback + text",12,"high",5
"SUPPRF31306",1,94,1,24,-13,61,37,35,"Pilot 9","Pilot 9: bigger feedback + text",7,"high",-11
"SUPPRF31306",2,97,3,56,-15,63,71,81,"Pilot 9","Pilot 9: bigger feedback + text",7,"high",-25
"SUPPRF31306",3,98,1,67,-13,58,80,73,"Pilot 9","Pilot 9: bigger feedback + text",7,"high",-6
"SUPPRF31306",4,98,2,22,-15,39,37,23,"Pilot 9","Pilot 9: bigger feedback + text",7,"high",-1
"SUPPRF31306",5,97,1,38,-16,32,54,46,"Pilot 9","Pilot 9: bigger feedback + text",7,"high",-8
"SUPPRF31306",6,97,2,8,-12,9,20,39,"Pilot 9","Pilot 9: bigger feedback + text",7,"high",-31
"SUPPRF31306",7,97,2,6,-14,20,20,17,"Pilot 9","Pilot 9: bigger feedback + text",7,"high",-11
"SUPPRF31306",8,97,4,16,-13,35,29,20,"Pilot 9","Pilot 9: bigger feedback + text",7,"high",-4
"SUPPRF31306",9,96,4,54,0,78,54,20,"Pilot 9","Pilot 9: bigger feedback + text",7,"high",34
"SUPPRF31306",10,97,2,100,20,77,80,28,"Pilot 9","Pilot 9: bigger feedback + text",7,"high",72
"SUPPRF31306",11,99,1,94,23,90,71,88,"Pilot 9","Pilot 9: bigger feedback + text",7,"high",6
"SUPPRF31306",12,95,4,63,0,69,63,61,"Pilot 9","Pilot 9: bigger feedback + text",7,"high",2
"SUPPRF31306",13,95,4,61,24,49,37,48,"Pilot 9","Pilot 9: bigger feedback + text",7,"high",13
"SUPPRF31306",14,94,1,41,-13,66,54,65,"Pilot 9","Pilot 9: bigger feedback + text",7,"high",-24
"SUPPRF31306",15,96,3,58,12,42,46,59,"Pilot 9","Pilot 9: bigger feedback + text",7,"high",-1
"SUPPRF31306",16,96,4,83,12,58,71,46,"Pilot 9","Pilot 9: bigger feedback + text",7,"high",37
"SUPPRF31306",17,98,3,88,25,68,63,13,"Pilot 9","Pilot 9: bigger feedback + text",7,"high",75
"SUPPRF31306",18,96,5,49,12,74,37,36,"Pilot 9","Pilot 9: bigger feedback + text",7,"high",13
"SUPPRF31306",19,19,73,50,-13,65,63,58,"Pilot 9","Pilot 9: bigger feedback + text",7,"high",-8
"SUPPRF31306",20,12,26,37,0,69,37,40,"Pilot 9","Pilot 9: bigger feedback + text",7,"high",-3
"SUPPRF31306",21,31,24,80,0,53,80,73,"Pilot 9","Pilot 9: bigger feedback + text",7,"high",7
"SUPPRF31306",22,19,24,81,1,47,80,64,"Pilot 9","Pilot 9: bigger feedback + text",7,"high",17
"SUPPRF31306",23,19,20,47,27,63,20,24,"Pilot 9","Pilot 9: bigger feedback + text",7,"high",23
"SUPPRF31306",24,13,14,78,24,78,54,35,"Pilot 9","Pilot 9: bigger feedback + text",7,"high",43
"SUPPRF31306",25,3,26,15,-14,26,29,48,"Pilot 9","Pilot 9: bigger feedback + text",7,"high",-33
"SUPPRF31306",26,8,35,58,29,54,29,65,"Pilot 9","Pilot 9: bigger feedback + text",7,"high",-7
"SUPPRF31306",27,2,41,55,1,66,54,54,"Pilot 9","Pilot 9: bigger feedback + text",7,"high",1
"SUPPRF31306",28,63,10,46,17,73,29,20,"Pilot 9","Pilot 9: bigger feedback + text",7,"high",26
"SUPPRF31306",29,2,41,70,-1,61,71,59,"Pilot 9","Pilot 9: bigger feedback + text",7,"high",11
"SUPPRF31306",30,7,75,47,-16,26,63,48,"Pilot 9","Pilot 9: bigger feedback + text",7,"high",-1
"SUPPRF31306",31,7,68,71,0,57,71,60,"Pilot 9","Pilot 9: bigger feedback + text",7,"high",11
"SUPPRF31306",32,8,77,46,0,66,46,33,"Pilot 9","Pilot 9: bigger feedback + text",7,"high",13
"SUPPRF31306",33,4,90,33,-13,100,46,45,"Pilot 9","Pilot 9: bigger feedback + text",7,"high",-12
"SUPPRF31306",34,10,93,77,14,30,63,53,"Pilot 9","Pilot 9: bigger feedback + text",7,"high",24
"SUPPRF31306",35,5,96,45,-1,78,46,54,"Pilot 9","Pilot 9: bigger feedback + text",7,"high",-9
"SUPPRF31306",36,13,100,55,-16,30,71,64,"Pilot 9","Pilot 9: bigger feedback + text",7,"high",-9
"SUPPRF31306",37,0,100,29,0,42,29,64,"Pilot 9","Pilot 9: bigger feedback + text",7,"high",-35
"SUPPRF31306",38,2,98,20,0,79,20,16,"Pilot 9","Pilot 9: bigger feedback + text",7,"high",4
"SUPPRF31306",39,3,80,28,-1,69,29,30,"Pilot 9","Pilot 9: bigger feedback + text",7,"high",-2
"SUPPRF31306",40,37,53,34,-12,60,46,44,"Pilot 9","Pilot 9: bigger feedback + text",7,"high",-10
"SUPPRF31306",41,9,96,38,1,29,37,48,"Pilot 9","Pilot 9: bigger feedback + text",7,"high",-10
"SUPPRF31306",42,0,100,96,16,21,80,51,"Pilot 9","Pilot 9: bigger feedback + text",7,"high",45
"SUPPRF31306",43,0,99,35,15,100,20,20,"Pilot 9","Pilot 9: bigger feedback + text",7,"high",15
"SUPPRF31306",44,6,100,68,-12,22,80,71,"Pilot 9","Pilot 9: bigger feedback + text",7,"high",-3
"SUPPRF31306",45,0,100,19,-1,72,20,21,"Pilot 9","Pilot 9: bigger feedback + text",7,"high",-2
"SUPPRF31306",46,0,89,66,12,65,54,55,"Pilot 9","Pilot 9: bigger feedback + text",7,"high",11
"SUPPRF31306",47,0,100,75,29,74,46,48,"Pilot 9","Pilot 9: bigger feedback + text",7,"high",27
"SUPPRF31306",48,0,84,62,-1,74,63,75,"Pilot 9","Pilot 9: bigger feedback + text",7,"high",-13
"SUPPRF31333",1,80,6,37,0,76,37,40,"Pilot 8","Pilot 8: max feedback + text",5,"low",-3
"SUPPRF31333",2,79,4,80,0,76,80,71,"Pilot 8","Pilot 8: max feedback + text",5,"low",9
"SUPPRF31333",3,85,6,54,0,82,54,67,"Pilot 8","Pilot 8: max feedback + text",5,"low",-13
"SUPPRF31333",4,85,11,68,-12,76,80,69,"Pilot 8","Pilot 8: max feedback + text",5,"low",-1
"SUPPRF31333",5,87,18,33,-13,67,46,58,"Pilot 8","Pilot 8: max feedback + text",5,"low",-25
"SUPPRF31333",6,81,12,75,29,74,46,40,"Pilot 8","Pilot 8: max feedback + text",5,"low",35
"SUPPRF31333",7,92,16,50,-13,67,63,72,"Pilot 8","Pilot 8: max feedback + text",5,"low",-22
"SUPPRF31333",8,90,4,96,16,73,80,65,"Pilot 8","Pilot 8: max feedback + text",5,"low",31
"SUPPRF31333",9,74,20,22,-15,65,37,50,"Pilot 8","Pilot 8: max feedback + text",5,"low",-28
"SUPPRF31333",10,75,7,47,-16,27,63,72,"Pilot 8","Pilot 8: max feedback + text",5,"low",-25
"SUPPRF31333",11,83,7,41,-13,62,54,57,"Pilot 8","Pilot 8: max feedback + text",5,"low",-16
"SUPPRF31333",12,79,21,61,24,78,37,21,"Pilot 8","Pilot 8: max feedback + text",5,"low",40
"SUPPRF31333",13,79,11,94,23,48,71,59,"Pilot 8","Pilot 8: max feedback + text",5,"low",35
"SUPPRF31333",14,87,14,20,0,57,20,23,"Pilot 8","Pilot 8: max feedback + text",5,"low",-3
"SUPPRF31333",15,79,15,70,-1,24,71,56,"Pilot 8","Pilot 8: max feedback + text",5,"low",14
"SUPPRF31333",16,85,20,78,24,63,54,45,"Pilot 8","Pilot 8: max feedback + text",5,"low",33
"SUPPRF31333",17,88,17,46,17,68,29,33,"Pilot 8","Pilot 8: max feedback + text",5,"low",13
"SUPPRF31333",18,80,14,63,0,66,63,62,"Pilot 8","Pilot 8: max feedback + text",5,"low",1
"SUPPRF31333",19,76,15,6,-14,78,20,42,"Pilot 8","Pilot 8: max feedback + text",5,"low",-36
"SUPPRF31333",20,78,18,83,12,66,71,65,"Pilot 8","Pilot 8: max feedback + text",5,"low",18
"SUPPRF31333",21,91,20,29,0,54,29,56,"Pilot 8","Pilot 8: max feedback + text",5,"low",-27
"SUPPRF31333",22,79,15,58,29,68,29,35,"Pilot 8","Pilot 8: max feedback + text",5,"low",23
"SUPPRF31333",23,79,21,28,-1,75,29,26,"Pilot 8","Pilot 8: max feedback + text",5,"low",2
"SUPPRF31333",24,85,13,67,-13,65,80,37,"Pilot 8","Pilot 8: max feedback + text",5,"low",30
"SUPPRF31333",25,71,22,88,25,59,63,61,"Pilot 8","Pilot 8: max feedback + text",5,"low",27
"SUPPRF31333",26,90,15,55,-16,72,71,57,"Pilot 8","Pilot 8: max feedback + text",5,"low",-2
"SUPPRF31333",27,75,14,38,-16,72,54,70,"Pilot 8","Pilot 8: max feedback + text",5,"low",-32
"SUPPRF31333",28,79,16,16,-13,66,29,48,"Pilot 8","Pilot 8: max feedback + text",5,"low",-32
"SUPPRF31333",29,82,20,56,-15,68,71,69,"Pilot 8","Pilot 8: max feedback + text",5,"low",-13
"SUPPRF31333",30,83,27,35,15,20,20,33,"Pilot 8","Pilot 8: max feedback + text",5,"low",2
"SUPPRF31333",31,82,14,71,0,29,71,29,"Pilot 8","Pilot 8: max feedback + text",5,"low",42
"SUPPRF31333",32,91,20,47,27,53,20,30,"Pilot 8","Pilot 8: max feedback + text",5,"low",17
"SUPPRF31333",33,92,6,45,-1,41,46,73,"Pilot 8","Pilot 8: max feedback + text",5,"low",-28
"SUPPRF31333",34,91,5,100,20,72,80,25,"Pilot 8","Pilot 8: max feedback + text",5,"low",75
"SUPPRF31333",35,93,5,55,1,69,54,59,"Pilot 8","Pilot 8: max feedback + text",5,"low",-4
"SUPPRF31333",36,75,29,15,-14,61,29,50,"Pilot 8","Pilot 8: max feedback + text",5,"low",-35
"SUPPRF31333",37,76,15,66,12,69,54,62,"Pilot 8","Pilot 8: max feedback + text",5,"low",4
"SUPPRF31333",38,87,13,81,1,74,80,75,"Pilot 8","Pilot 8: max feedback + text",5,"low",6
"SUPPRF31333",39,75,17,8,-12,73,20,29,"Pilot 8","Pilot 8: max feedback + text",5,"low",-21
"SUPPRF31333",40,86,19,58,12,59,46,49,"Pilot 8","Pilot 8: max feedback + text",5,"low",9
"SUPPRF31333",41,86,12,38,1,41,37,63,"Pilot 8","Pilot 8: max feedback + text",5,"low",-25
"SUPPRF31333",42,82,9,77,14,14,63,60,"Pilot 8","Pilot 8: max feedback + text",5,"low",17
"SUPPRF31333",43,78,13,46,0,24,46,43,"Pilot 8","Pilot 8: max feedback + text",5,"low",3
"SUPPRF31333",44,76,18,24,-13,19,37,69,"Pilot 8","Pilot 8: max feedback + text",5,"low",-45
"SUPPRF31333",45,82,12,62,-1,17,63,63,"Pilot 8","Pilot 8: max feedback + text",5,"low",-1
"SUPPRF31333",46,72,25,49,12,25,37,60,"Pilot 8","Pilot 8: max feedback + text",5,"low",-11
"SUPPRF31333",47,85,9,19,-1,75,20,15,"Pilot 8","Pilot 8: max feedback + text",5,"low",4
"SUPPRF31333",48,81,16,34,-12,20,46,54,"Pilot 8","Pilot 8: max feedback + text",5,"low",-20
"SUPPRF32902",1,86,9,94,23,96,71,73,"Pilot 8","Pilot 8: max feedback + text",4,"low",21
"SUPPRF32902",2,91,4,68,-12,87,80,84,"Pilot 8","Pilot 8: max feedback + text",4,"low",-16
"SUPPRF32902",3,88,8,49,12,89,37,74,"Pilot 8","Pilot 8: max feedback + text",4,"low",-25
"SUPPRF32902",4,86,5,63,0,7,63,65,"Pilot 8","Pilot 8: max feedback + text",4,"low",-2
"SUPPRF32902",5,91,7,38,1,15,37,42,"Pilot 8","Pilot 8: max feedback + text",4,"low",-4
"SUPPRF32902",6,96,1,54,0,19,54,46,"Pilot 8","Pilot 8: max feedback + text",4,"low",8
"SUPPRF32902",7,98,3,20,0,48,20,20,"Pilot 8","Pilot 8: max feedback + text",4,"low",0
"SUPPRF32902",8,98,2,46,17,14,29,30,"Pilot 8","Pilot 8: max feedback + text",4,"low",16
"SUPPRF32902",9,94,2,83,12,74,71,59,"Pilot 8","Pilot 8: max feedback + text",4,"low",24
"SUPPRF32902",10,94,6,33,-13,80,46,79,"Pilot 8","Pilot 8: max feedback + text",4,"low",-46
"SUPPRF32902",11,88,9,55,-16,81,71,60,"Pilot 8","Pilot 8: max feedback + text",4,"low",-5
"SUPPRF32902",12,98,4,80,0,80,80,70,"Pilot 8","Pilot 8: max feedback + text",4,"low",10
"SUPPRF32902",13,86,14,100,20,36,80,85,"Pilot 8","Pilot 8: max feedback + text",4,"low",15
"SUPPRF32902",14,96,3,47,-16,55,63,86,"Pilot 8","Pilot 8: max feedback + text",4,"low",-39
"SUPPRF32902",15,89,4,71,0,61,71,89,"Pilot 8","Pilot 8: max feedback + text",4,"low",-18
"SUPPRF32902",16,94,2,81,1,24,80,82,"Pilot 8","Pilot 8: max feedback + text",4,"low",-1
"SUPPRF32902",17,96,7,50,-13,26,63,85,"Pilot 8","Pilot 8: max feedback + text",4,"low",-35
"SUPPRF32902",18,91,3,45,-1,14,46,61,"Pilot 8","Pilot 8: max feedback + text",4,"low",-16
"SUPPRF32902",19,88,6,38,-16,22,54,34,"Pilot 8","Pilot 8: max feedback + text",4,"low",4
"SUPPRF32902",20,82,14,19,-1,28,20,82,"Pilot 8","Pilot 8: max feedback + text",4,"low",-63
"SUPPRF32902",21,90,79,24,-13,16,37,32,"Pilot 8","Pilot 8: max feedback + text",4,"low",-8
"SUPPRF32902",22,89,13,75,29,14,46,89,"Pilot 8","Pilot 8: max feedback + text",4,"low",-14
"SUPPRF32902",23,90,5,62,-1,14,63,88,"Pilot 8","Pilot 8: max feedback + text",4,"low",-26
"SUPPRF32902",24,93,8,15,-14,10,29,44,"Pilot 8","Pilot 8: max feedback + text",4,"low",-29
"SUPPRF32902",25,96,9,35,15,19,20,36,"Pilot 8","Pilot 8: max feedback + text",4,"low",-1
"SUPPRF32902",26,91,17,47,27,14,20,59,"Pilot 8","Pilot 8: max feedback + text",4,"low",-12
"SUPPRF32902",27,87,12,41,-13,17,54,34,"Pilot 8","Pilot 8: max feedback + text",4,"low",7
"SUPPRF32902",28,96,12,78,24,18,54,11,"Pilot 8","Pilot 8: max feedback + text",4,"low",67
"SUPPRF32902",29,89,12,61,24,16,37,43,"Pilot 8","Pilot 8: max feedback + text",4,"low",18
"SUPPRF32902",30,97,11,8,-12,21,20,23,"Pilot 8","Pilot 8: max feedback + text",4,"low",-15
"SUPPRF32902",31,92,0,6,-14,23,20,24,"Pilot 8","Pilot 8: max feedback + text",4,"low",-18
"SUPPRF32902",32,91,16,29,0,27,29,17,"Pilot 8","Pilot 8: max feedback + text",4,"low",12
"SUPPRF32902",33,92,12,58,12,12,46,25,"Pilot 8","Pilot 8: max feedback + text",4,"low",33
"SUPPRF32902",34,98,15,34,-12,16,46,26,"Pilot 8","Pilot 8: max feedback + text",4,"low",8
"SUPPRF32902",35,91,10,28,-1,18,29,52,"Pilot 8","Pilot 8: max feedback + text",4,"low",-24
"SUPPRF32902",36,87,22,88,25,18,63,66,"Pilot 8","Pilot 8: max feedback + text",4,"low",22
"SUPPRF32902",37,72,13,67,-13,12,80,22,"Pilot 8","Pilot 8: max feedback + text",4,"low",45
"SUPPRF32902",38,97,2,96,16,7,80,60,"Pilot 8","Pilot 8: max feedback + text",4,"low",36
"SUPPRF32902",39,95,9,16,-13,29,29,54,"Pilot 8","Pilot 8: max feedback + text",4,"low",-38
"SUPPRF32902",40,78,18,22,-15,16,37,35,"Pilot 8","Pilot 8: max feedback + text",4,"low",-13
"SUPPRF32902",41,92,14,58,29,24,29,27,"Pilot 8","Pilot 8: max feedback + text",4,"low",31
"SUPPRF32902",42,100,0,46,0,20,46,56,"Pilot 8","Pilot 8: max feedback + text",4,"low",-10
"SUPPRF32902",43,95,0,37,0,17,37,55,"Pilot 8","Pilot 8: max feedback + text",4,"low",-18
"SUPPRF32902",44,94,11,66,12,5,54,75,"Pilot 8","Pilot 8: max feedback + text",4,"low",-9
"SUPPRF32902",45,87,14,55,1,13,54,25,"Pilot 8","Pilot 8: max feedback + text",4,"low",30
"SUPPRF32902",46,97,3,70,-1,9,71,22,"Pilot 8","Pilot 8: max feedback + text",4,"low",48
"SUPPRF32902",47,89,12,77,14,6,63,82,"Pilot 8","Pilot 8: max feedback + text",4,"low",-5
"SUPPRF32902",48,97,1,56,-15,99,71,39,"Pilot 8","Pilot 8: max feedback + text",4,"low",17
"SUPPRF33361",1,53,32,15,-14,43,29,25,"Pilot 10","Pilot 10: bigger feedback + video",4,"low",-10
"SUPPRF33361",2,50,27,20,0,16,20,18,"Pilot 10","Pilot 10: bigger feedback + video",4,"low",2
"SUPPRF33361",3,57,9,28,-1,17,29,22,"Pilot 10","Pilot 10: bigger feedback + video",4,"low",6
"SUPPRF33361",4,57,27,8,-12,18,20,42,"Pilot 10","Pilot 10: bigger feedback + video",4,"low",-34
"SUPPRF33361",5,61,28,50,-13,24,63,36,"Pilot 10","Pilot 10: bigger feedback + video",4,"low",14
"SUPPRF33361",6,57,31,49,12,17,37,33,"Pilot 10","Pilot 10: bigger feedback + video",4,"low",16
"SUPPRF33361",7,64,30,46,0,20,46,68,"Pilot 10","Pilot 10: bigger feedback + video",4,"low",-22
"SUPPRF33361",8,64,23,24,-13,28,37,33,"Pilot 10","Pilot 10: bigger feedback + video",4,"low",-9
"SUPPRF33361",9,60,29,35,15,67,20,9,"Pilot 10","Pilot 10: bigger feedback + video",4,"low",26
"SUPPRF33361",10,74,28,94,23,15,71,31,"Pilot 10","Pilot 10: bigger feedback + video",4,"low",63
"SUPPRF33361",11,65,33,70,-1,15,71,56,"Pilot 10","Pilot 10: bigger feedback + video",4,"low",14
"SUPPRF33361",12,58,36,47,27,25,20,25,"Pilot 10","Pilot 10: bigger feedback + video",4,"low",22
"SUPPRF33361",13,54,38,47,-16,53,63,57,"Pilot 10","Pilot 10: bigger feedback + video",4,"low",-10
"SUPPRF33361",14,47,57,81,1,53,80,61,"Pilot 10","Pilot 10: bigger feedback + video",4,"low",20
"SUPPRF33361",15,39,56,55,-16,5,71,58,"Pilot 10","Pilot 10: bigger feedback + video",4,"low",-3
"SUPPRF33361",16,67,79,38,1,84,37,36,"Pilot 10","Pilot 10: bigger feedback + video",4,"low",2
"SUPPRF33361",17,34,66,56,-15,67,71,75,"Pilot 10","Pilot 10: bigger feedback + video",4,"low",-19
"SUPPRF33361",18,42,60,78,24,69,54,67,"Pilot 10","Pilot 10: bigger feedback + video",4,"low",11
"SUPPRF33361",19,39,63,46,17,51,29,43,"Pilot 10","Pilot 10: bigger feedback + video",4,"low",3
"SUPPRF33361",20,33,63,45,-1,49,46,55,"Pilot 10","Pilot 10: bigger feedback + video",4,"low",-10
"SUPPRF33361",21,27,71,33,-13,17,46,54,"Pilot 10","Pilot 10: bigger feedback + video",4,"low",-21
"SUPPRF33361",22,32,63,77,14,52,63,70,"Pilot 10","Pilot 10: bigger feedback + video",4,"low",7
"SUPPRF33361",23,37,59,67,-13,18,80,78,"Pilot 10","Pilot 10: bigger feedback + video",4,"low",-11
"SUPPRF33361",24,34,64,34,-12,28,46,42,"Pilot 10","Pilot 10: bigger feedback + video",4,"low",-8
"SUPPRF33361",25,51,47,63,0,29,63,63,"Pilot 10","Pilot 10: bigger feedback + video",4,"low",0
"SUPPRF33361",26,47,48,83,12,71,71,68,"Pilot 10","Pilot 10: bigger feedback + video",4,"low",15
"SUPPRF33361",27,37,62,55,1,51,54,69,"Pilot 10","Pilot 10: bigger feedback + video",4,"low",-14
"SUPPRF33361",28,43,66,41,-13,3,54,50,"Pilot 10","Pilot 10: bigger feedback + video",4,"low",-9
"SUPPRF33361",29,52,50,16,-13,52,29,30,"Pilot 10","Pilot 10: bigger feedback + video",4,"low",-14
"SUPPRF33361",30,32,59,75,29,55,46,51,"Pilot 10","Pilot 10: bigger feedback + video",4,"low",24
"SUPPRF33361",31,38,55,66,12,24,54,49,"Pilot 10","Pilot 10: bigger feedback + video",4,"low",17
"SUPPRF33361",32,5,68,37,0,53,37,63,"Pilot 10","Pilot 10: bigger feedback + video",4,"low",-26
"SUPPRF33361",33,22,71,96,16,14,80,72,"Pilot 10","Pilot 10: bigger feedback + video",4,"low",24
"SUPPRF33361",34,0,64,38,-16,45,54,69,"Pilot 10","Pilot 10: bigger feedback + video",4,"low",-31
"SUPPRF33361",35,2,61,58,29,34,29,61,"Pilot 10","Pilot 10: bigger feedback + video",4,"low",-3
"SUPPRF33361",36,1,62,29,0,35,29,33,"Pilot 10","Pilot 10: bigger feedback + video",4,"low",-4
"SUPPRF33361",37,7,79,88,25,16,63,48,"Pilot 10","Pilot 10: bigger feedback + video",4,"low",40
"SUPPRF33361",38,1,98,71,0,71,71,65,"Pilot 10","Pilot 10: bigger feedback + video",4,"low",6
"SUPPRF33361",39,6,95,19,-1,32,20,57,"Pilot 10","Pilot 10: bigger feedback + video",4,"low",-38
"SUPPRF33361",40,41,78,54,0,26,54,58,"Pilot 10","Pilot 10: bigger feedback + video",4,"low",-4
"SUPPRF33361",41,5,86,100,20,77,80,87,"Pilot 10","Pilot 10: bigger feedback + video",4,"low",13
"SUPPRF33361",42,0,98,58,12,13,46,41,"Pilot 10","Pilot 10: bigger feedback + video",4,"low",17
"SUPPRF33361",43,2,80,62,-1,19,63,59,"Pilot 10","Pilot 10: bigger feedback + video",4,"low",3
"SUPPRF33361",44,1,84,80,0,12,80,46,"Pilot 10","Pilot 10: bigger feedback + video",4,"low",34
"SUPPRF33361",45,3,88,22,-15,33,37,61,"Pilot 10","Pilot 10: bigger feedback + video",4,"low",-39
"SUPPRF33361",46,1,98,68,-12,16,80,86,"Pilot 10","Pilot 10: bigger feedback + video",4,"low",-18
"SUPPRF33361",47,6,65,61,24,34,37,69,"Pilot 10","Pilot 10: bigger feedback + video",4,"low",-8
"SUPPRF33361",48,15,75,6,-14,38,20,74,"Pilot 10","Pilot 10: bigger feedback + video",4,"low",-68
"SUPPRF34408",1,1,100,66,12,14,54,10,"Pilot 10","Pilot 10: bigger feedback + video",12,"high",56
"SUPPRF34408",2,1,99,75,29,61,46,17,"Pilot 10","Pilot 10: bigger feedback + video",12,"high",58
"SUPPRF34408",3,2,98,41,-13,60,54,32,"Pilot 10","Pilot 10: bigger feedback + video",12,"high",9
"SUPPRF34408",4,1,98,100,20,19,80,19,"Pilot 10","Pilot 10: bigger feedback + video",12,"high",81
"SUPPRF34408",5,3,97,70,-1,21,71,14,"Pilot 10","Pilot 10: bigger feedback + video",12,"high",56
"SUPPRF34408",6,2,97,33,-13,18,46,15,"Pilot 10","Pilot 10: bigger feedback + video",12,"high",18
"SUPPRF34408",7,0,99,38,-16,22,54,15,"Pilot 10","Pilot 10: bigger feedback + video",12,"high",23
"SUPPRF34408",8,0,100,35,15,15,20,16,"Pilot 10","Pilot 10: bigger feedback + video",12,"high",19
"SUPPRF34408",9,2,98,71,0,18,71,10,"Pilot 10","Pilot 10: bigger feedback + video",12,"high",61
"SUPPRF34408",10,1,99,61,24,22,37,21,"Pilot 10","Pilot 10: bigger feedback + video",12,"high",40
"SUPPRF34408",11,2,99,47,27,22,20,15,"Pilot 10","Pilot 10: bigger feedback + video",12,"high",32
"SUPPRF34408",12,1,99,55,1,9,54,20,"Pilot 10","Pilot 10: bigger feedback + video",12,"high",35
"SUPPRF34408",13,1,99,34,-12,19,46,14,"Pilot 10","Pilot 10: bigger feedback + video",12,"high",20
"SUPPRF34408",14,2,99,49,12,15,37,15,"Pilot 10","Pilot 10: bigger feedback + video",12,"high",34
"SUPPRF34408",15,0,99,45,-1,16,46,21,"Pilot 10","Pilot 10: bigger feedback + video",12,"high",24
"SUPPRF34408",16,2,98,19,-1,26,20,11,"Pilot 10","Pilot 10: bigger feedback + video",12,"high",8
"SUPPRF34408",17,1,99,29,0,25,29,21,"Pilot 10","Pilot 10: bigger feedback + video",12,"high",8
"SUPPRF34408",18,0,99,24,-13,17,37,13,"Pilot 10","Pilot 10: bigger feedback + video",12,"high",11
"SUPPRF34408",19,1,100,6,-14,17,20,26,"Pilot 10","Pilot 10: bigger feedback + video",12,"high",-20
"SUPPRF34408",20,1,100,20,0,18,20,13,"Pilot 10","Pilot 10: bigger feedback + video",12,"high",7
"SUPPRF34408",21,2,99,22,-15,14,37,13,"Pilot 10","Pilot 10: bigger feedback + video",12,"high",9
"SUPPRF34408",22,3,97,81,1,19,80,14,"Pilot 10","Pilot 10: bigger feedback + video",12,"high",67
"SUPPRF34408",23,2,99,83,12,16,71,10,"Pilot 10","Pilot 10: bigger feedback + video",12,"high",73
"SUPPRF34408",24,1,99,68,-12,11,80,12,"Pilot 10","Pilot 10: bigger feedback + video",12,"high",56
"SUPPRF34408",25,1,98,88,25,23,63,10,"Pilot 10","Pilot 10: bigger feedback + video",12,"high",78
"SUPPRF34408",26,2,99,67,-13,14,80,11,"Pilot 10","Pilot 10: bigger feedback + video",12,"high",56
"SUPPRF34408",27,4,89,94,23,16,71,12,"Pilot 10","Pilot 10: bigger feedback + video",12,"high",82
"SUPPRF34408",28,0,99,28,-1,29,29,3,"Pilot 10","Pilot 10: bigger feedback + video",12,"high",25
"SUPPRF34408",29,2,99,15,-14,9,29,11,"Pilot 10","Pilot 10: bigger feedback + video",12,"high",4
"SUPPRF34408",30,1,99,58,29,18,29,13,"Pilot 10","Pilot 10: bigger feedback + video",12,"high",45
"SUPPRF34408",31,19,99,37,0,20,37,16,"Pilot 10","Pilot 10: bigger feedback + video",12,"high",21
"SUPPRF34408",32,1,99,55,-16,19,71,10,"Pilot 10","Pilot 10: bigger feedback + video",12,"high",45
"SUPPRF34408",33,1,99,54,0,23,54,11,"Pilot 10","Pilot 10: bigger feedback + video",12,"high",43
"SUPPRF34408",34,0,99,38,1,20,37,14,"Pilot 10","Pilot 10: bigger feedback + video",12,"high",24
"SUPPRF34408",35,3,100,16,-13,19,29,18,"Pilot 10","Pilot 10: bigger feedback + video",12,"high",-2
"SUPPRF34408",36,2,99,46,0,12,46,14,"Pilot 10","Pilot 10: bigger feedback + video",12,"high",32
"SUPPRF34408",37,1,99,80,0,28,80,11,"Pilot 10","Pilot 10: bigger feedback + video",12,"high",69
"SUPPRF34408",38,2,97,77,14,25,63,23,"Pilot 10","Pilot 10: bigger feedback + video",12,"high",54
"SUPPRF34408",39,2,99,8,-12,29,20,20,"Pilot 10","Pilot 10: bigger feedback + video",12,"high",-12
"SUPPRF34408",40,2,99,78,24,26,54,25,"Pilot 10","Pilot 10: bigger feedback + video",12,"high",53
"SUPPRF34408",41,1,98,63,0,10,63,22,"Pilot 10","Pilot 10: bigger feedback + video",12,"high",41
"SUPPRF34408",42,2,98,50,-13,36,63,26,"Pilot 10","Pilot 10: bigger feedback + video",12,"high",24
"SUPPRF34408",43,2,100,56,-15,21,71,18,"Pilot 10","Pilot 10: bigger feedback + video",12,"high",38
"SUPPRF34408",44,1,99,96,16,31,80,28,"Pilot 10","Pilot 10: bigger feedback + video",12,"high",68
"SUPPRF34408",45,3,98,46,17,20,29,23,"Pilot 10","Pilot 10: bigger feedback + video",12,"high",23
"SUPPRF34408",46,1,100,47,-16,17,63,22,"Pilot 10","Pilot 10: bigger feedback + video",12,"high",25
"SUPPRF34408",47,1,98,58,12,38,46,17,"Pilot 10","Pilot 10: bigger feedback + video",12,"high",41
"SUPPRF34408",48,2,99,62,-1,32,63,23,"Pilot 10","Pilot 10: bigger feedback + video",12,"high",39
"SUPPRF34485",1,69,8,38,1,70,37,36,"Pilot 8","Pilot 8: max feedback + text",7,"high",2
"SUPPRF34485",2,95,0,80,0,99,80,82,"Pilot 8","Pilot 8: max feedback + text",7,"high",-2
"SUPPRF34485",3,59,9,8,-12,83,20,21,"Pilot 8","Pilot 8: max feedback + text",7,"high",-13
"SUPPRF34485",4,78,26,46,17,53,29,42,"Pilot 8","Pilot 8: max feedback + text",7,"high",4
"SUPPRF34485",5,83,16,66,12,62,54,49,"Pilot 8","Pilot 8: max feedback + text",7,"high",17
"SUPPRF34485",6,57,9,67,-13,59,80,80,"Pilot 8","Pilot 8: max feedback + text",7,"high",-13
"SUPPRF34485",7,53,7,20,0,40,20,67,"Pilot 8","Pilot 8: max feedback + text",7,"high",-47
"SUPPRF34485",8,65,2,81,1,45,80,78,"Pilot 8","Pilot 8: max feedback + text",7,"high",3
"SUPPRF34485",9,66,6,19,-1,60,20,21,"Pilot 8","Pilot 8: max feedback + text",7,"high",-2
"SUPPRF34485",10,82,4,94,23,77,71,76,"Pilot 8","Pilot 8: max feedback + text",7,"high",18
"SUPPRF34485",11,56,4,63,0,78,63,75,"Pilot 8","Pilot 8: max feedback + text",7,"high",-12
"SUPPRF34485",12,63,13,88,25,57,63,57,"Pilot 8","Pilot 8: max feedback + text",7,"high",31
"SUPPRF34485",13,75,16,47,27,61,20,25,"Pilot 8","Pilot 8: max feedback + text",7,"high",22
"SUPPRF34485",14,47,3,29,0,58,29,45,"Pilot 8","Pilot 8: max feedback + text",7,"high",-16
"SUPPRF34485",15,33,7,33,-13,53,46,52,"Pilot 8","Pilot 8: max feedback + text",7,"high",-19
"SUPPRF34485",16,54,14,38,-16,33,54,36,"Pilot 8","Pilot 8: max feedback + text",7,"high",2
"SUPPRF34485",17,52,16,46,0,63,46,47,"Pilot 8","Pilot 8: max feedback + text",7,"high",-1
"SUPPRF34485",18,61,2,71,0,49,71,58,"Pilot 8","Pilot 8: max feedback + text",7,"high",13
"SUPPRF34485",19,77,9,83,12,55,71,63,"Pilot 8","Pilot 8: max feedback + text",7,"high",20
"SUPPRF34485",20,65,13,75,29,55,46,57,"Pilot 8","Pilot 8: max feedback + text",7,"high",18
"SUPPRF34485",21,44,3,28,-1,58,29,64,"Pilot 8","Pilot 8: max feedback + text",7,"high",-36
"SUPPRF34485",22,65,27,58,12,58,46,64,"Pilot 8","Pilot 8: max feedback + text",7,"high",-6
"SUPPRF34485",23,64,20,34,-12,72,46,54,"Pilot 8","Pilot 8: max feedback + text",7,"high",-20
"SUPPRF34485",24,30,21,22,-15,49,37,62,"Pilot 8","Pilot 8: max feedback + text",7,"high",-40
"SUPPRF34485",25,70,14,58,29,46,29,28,"Pilot 8","Pilot 8: max feedback + text",7,"high",30
"SUPPRF34485",26,60,49,61,24,55,37,34,"Pilot 8","Pilot 8: max feedback + text",7,"high",27
"SUPPRF34485",27,65,23,68,-12,66,80,95,"Pilot 8","Pilot 8: max feedback + text",7,"high",-27
"SUPPRF34485",28,64,19,35,15,37,20,22,"Pilot 8","Pilot 8: max feedback + text",7,"high",13
"SUPPRF34485",29,68,27,49,12,56,37,39,"Pilot 8","Pilot 8: max feedback + text",7,"high",10
"SUPPRF34485",30,32,56,50,-13,55,63,62,"Pilot 8","Pilot 8: max feedback + text",7,"high",-12
"SUPPRF34485",31,67,25,100,20,33,80,59,"Pilot 8","Pilot 8: max feedback + text",7,"high",41
"SUPPRF34485",32,66,27,6,-14,52,20,39,"Pilot 8","Pilot 8: max feedback + text",7,"high",-33
"SUPPRF34485",33,67,22,56,-15,57,71,24,"Pilot 8","Pilot 8: max feedback + text",7,"high",32
"SUPPRF34485",34,69,27,55,1,59,54,44,"Pilot 8","Pilot 8: max feedback + text",7,"high",11
"SUPPRF34485",35,67,33,78,24,38,54,57,"Pilot 8","Pilot 8: max feedback + text",7,"high",21
"SUPPRF34485",36,49,15,47,-16,55,63,69,"Pilot 8","Pilot 8: max feedback + text",7,"high",-22
"SUPPRF34485",37,75,31,96,16,69,80,85,"Pilot 8","Pilot 8: max feedback + text",7,"high",11
"SUPPRF34485",38,61,18,54,0,58,54,67,"Pilot 8","Pilot 8: max feedback + text",7,"high",-13
"SUPPRF34485",39,69,33,45,-1,65,46,52,"Pilot 8","Pilot 8: max feedback + text",7,"high",-7
"SUPPRF34485",40,44,6,55,-16,66,71,75,"Pilot 8","Pilot 8: max feedback + text",7,"high",-20
"SUPPRF34485",41,51,72,16,-13,47,29,57,"Pilot 8","Pilot 8: max feedback + text",7,"high",-41
"SUPPRF34485",42,48,17,77,14,43,63,51,"Pilot 8","Pilot 8: max feedback + text",7,"high",26
"SUPPRF34485",43,23,42,62,-1,65,63,71,"Pilot 8","Pilot 8: max feedback + text",7,"high",-9
"SUPPRF34485",44,52,28,37,0,25,37,42,"Pilot 8","Pilot 8: max feedback + text",7,"high",-5
"SUPPRF34485",45,59,14,70,-1,60,71,65,"Pilot 8","Pilot 8: max feedback + text",7,"high",5
"SUPPRF34485",46,31,29,41,-13,62,54,49,"Pilot 8","Pilot 8: max feedback + text",7,"high",-8
"SUPPRF34485",47,31,28,15,-14,49,29,35,"Pilot 8","Pilot 8: max feedback + text",7,"high",-20
"SUPPRF34485",48,40,25,24,-13,61,37,32,"Pilot 8","Pilot 8: max feedback + text",7,"high",-8
"SUPPRF35697",1,48,33,35,15,65,20,28,"Pilot 9","Pilot 9: bigger feedback + text",1,"low",7
"SUPPRF35697",2,60,27,55,1,55,54,54,"Pilot 9","Pilot 9: bigger feedback + text",1,"low",1
"SUPPRF35697",3,58,41,38,1,44,37,55,"Pilot 9","Pilot 9: bigger feedback + text",1,"low",-17
"SUPPRF35697",4,52,28,47,27,61,20,29,"Pilot 9","Pilot 9: bigger feedback + text",1,"low",18
"SUPPRF35697",5,48,41,28,-1,50,29,54,"Pilot 9","Pilot 9: bigger feedback + text",1,"low",-26
"SUPPRF35697",6,42,32,100,20,25,80,32,"Pilot 9","Pilot 9: bigger feedback + text",1,"low",68
"SUPPRF35697",7,57,37,46,17,44,29,51,"Pilot 9","Pilot 9: bigger feedback + text",1,"low",-5
"SUPPRF35697",8,56,39,70,-1,41,71,59,"Pilot 9","Pilot 9: bigger feedback + text",1,"low",11
"SUPPRF35697",9,40,30,6,-14,40,20,61,"Pilot 9","Pilot 9: bigger feedback + text",1,"low",-55
"SUPPRF35697",10,52,47,22,-15,38,37,56,"Pilot 9","Pilot 9: bigger feedback + text",1,"low",-34
"SUPPRF35697",11,52,38,24,-13,42,37,57,"Pilot 9","Pilot 9: bigger feedback + text",1,"low",-33
"SUPPRF35697",12,36,46,15,-14,43,29,45,"Pilot 9","Pilot 9: bigger feedback + text",1,"low",-30
"SUPPRF35697",13,46,38,45,-1,34,46,48,"Pilot 9","Pilot 9: bigger feedback + text",1,"low",-3
"SUPPRF35697",14,39,44,33,-13,55,46,48,"Pilot 9","Pilot 9: bigger feedback + text",1,"low",-15
"SUPPRF35697",15,43,38,81,1,56,80,70,"Pilot 9","Pilot 9: bigger feedback + text",1,"low",11
"SUPPRF35697",16,37,50,29,0,48,29,49,"Pilot 9","Pilot 9: bigger feedback + text",1,"low",-20
"SUPPRF35697",17,49,47,34,-12,1,46,1,"Pilot 9","Pilot 9: bigger feedback + text",1,"low",33
"SUPPRF35697",18,39,50,38,-16,50,54,51,"Pilot 9","Pilot 9: bigger feedback + text",1,"low",-13
"SUPPRF35697",19,48,50,88,25,50,63,52,"Pilot 9","Pilot 9: bigger feedback + text",1,"low",36
"SUPPRF35697",20,57,48,63,0,57,63,45,"Pilot 9","Pilot 9: bigger feedback + text",1,"low",18
"SUPPRF35697",21,51,58,56,-15,59,71,59,"Pilot 9","Pilot 9: bigger feedback + text",1,"low",-3
"SUPPRF35697",22,54,45,8,-12,55,20,25,"Pilot 9","Pilot 9: bigger feedback + text",1,"low",-17
"SUPPRF35697",23,57,42,50,-13,60,63,45,"Pilot 9","Pilot 9: bigger feedback + text",1,"low",5
"SUPPRF35697",24,55,46,83,12,55,71,61,"Pilot 9","Pilot 9: bigger feedback + text",1,"low",22
"SUPPRF35697",25,40,48,16,-13,55,29,36,"Pilot 9","Pilot 9: bigger feedback + text",1,"low",-20
"SUPPRF35697",26,57,64,67,-13,73,80,82,"Pilot 9","Pilot 9: bigger feedback + text",1,"low",-15
"SUPPRF35697",27,52,48,75,29,45,46,61,"Pilot 9","Pilot 9: bigger feedback + text",1,"low",14
"SUPPRF35697",28,64,31,94,23,70,71,78,"Pilot 9","Pilot 9: bigger feedback + text",1,"low",16
"SUPPRF35697",29,52,46,66,12,52,54,58,"Pilot 9","Pilot 9: bigger feedback + text",1,"low",8
"SUPPRF35697",30,36,40,54,0,53,54,54,"Pilot 9","Pilot 9: bigger feedback + text",1,"low",0
"SUPPRF35697",31,41,55,55,-16,49,71,65,"Pilot 9","Pilot 9: bigger feedback + text",1,"low",-10
"SUPPRF35697",32,30,57,20,0,62,20,22,"Pilot 9","Pilot 9: bigger feedback + text",1,"low",-2
"SUPPRF35697",33,44,39,37,0,33,37,47,"Pilot 9","Pilot 9: bigger feedback + text",1,"low",-10
"SUPPRF35697",34,51,43,61,24,43,37,63,"Pilot 9","Pilot 9: bigger feedback + text",1,"low",-2
"SUPPRF35697",35,54,45,49,12,51,37,46,"Pilot 9","Pilot 9: bigger feedback + text",1,"low",3
"SUPPRF35697",36,49,51,77,14,57,63,43,"Pilot 9","Pilot 9: bigger feedback + text",1,"low",34
"SUPPRF35697",37,71,37,80,0,56,80,75,"Pilot 9","Pilot 9: bigger feedback + text",1,"low",5
"SUPPRF35697",38,50,64,68,-12,55,80,56,"Pilot 9","Pilot 9: bigger feedback + text",1,"low",12
"SUPPRF35697",39,59,47,47,-16,74,63,75,"Pilot 9","Pilot 9: bigger feedback + text",1,"low",-28
"SUPPRF35697",40,53,43,41,-13,44,54,56,"Pilot 9","Pilot 9: bigger feedback + text",1,"low",-15
"SUPPRF35697",41,49,41,46,0,39,46,60,"Pilot 9","Pilot 9: bigger feedback + text",1,"low",-14
"SUPPRF35697",42,43,52,58,29,41,29,46,"Pilot 9","Pilot 9: bigger feedback + text",1,"low",12
"SUPPRF35697",43,41,51,58,12,38,46,49,"Pilot 9","Pilot 9: bigger feedback + text",1,"low",9
"SUPPRF35697",44,42,50,71,0,36,71,47,"Pilot 9","Pilot 9: bigger feedback + text",1,"low",24
"SUPPRF35697",45,45,56,62,-1,41,63,54,"Pilot 9","Pilot 9: bigger feedback + text",1,"low",8
"SUPPRF35697",46,27,51,19,-1,24,20,24,"Pilot 9","Pilot 9: bigger feedback + text",1,"low",-5
"SUPPRF35697",47,53,44,78,24,40,54,49,"Pilot 9","Pilot 9: bigger feedback + text",1,"low",29
"SUPPRF35697",48,71,34,96,16,71,80,73,"Pilot 9","Pilot 9: bigger feedback + text",1,"low",23
"SUPPRF37035",1,48,46,45,-1,31,46,37,"Pilot 9","Pilot 9: bigger feedback + text",6,"high",8
"SUPPRF37035",2,45,45,19,-1,97,20,20,"Pilot 9","Pilot 9: bigger feedback + text",6,"high",-1
"SUPPRF37035",3,49,49,20,0,41,20,16,"Pilot 9","Pilot 9: bigger feedback + text",6,"high",4
"SUPPRF37035",4,47,51,49,12,49,37,42,"Pilot 9","Pilot 9: bigger feedback + text",6,"high",7
"SUPPRF37035",5,51,50,81,1,48,80,56,"Pilot 9","Pilot 9: bigger feedback + text",6,"high",25
"SUPPRF37035",6,23,26,96,16,96,80,76,"Pilot 9","Pilot 9: bigger feedback + text",6,"high",20
"SUPPRF37035",7,44,45,77,14,39,63,41,"Pilot 9","Pilot 9: bigger feedback + text",6,"high",36
"SUPPRF37035",8,49,48,71,0,71,71,52,"Pilot 9","Pilot 9: bigger feedback + text",6,"high",19
"SUPPRF37035",9,57,52,88,25,96,63,66,"Pilot 9","Pilot 9: bigger feedback + text",6,"high",22
"SUPPRF37035",10,49,56,61,24,80,37,51,"Pilot 9","Pilot 9: bigger feedback + text",6,"high",10
"SUPPRF37035",11,49,50,8,-12,85,20,16,"Pilot 9","Pilot 9: bigger feedback + text",6,"high",-8
"SUPPRF37035",12,51,53,38,-16,49,54,37,"Pilot 9","Pilot 9: bigger feedback + text",6,"high",1
"SUPPRF37035",13,51,54,78,24,55,54,52,"Pilot 9","Pilot 9: bigger feedback + text",6,"high",26
"SUPPRF37035",14,51,53,41,-13,84,54,62,"Pilot 9","Pilot 9: bigger feedback + text",6,"high",-21
"SUPPRF37035",15,55,57,58,12,41,46,43,"Pilot 9","Pilot 9: bigger feedback + text",6,"high",15
"SUPPRF37035",16,59,53,50,-13,71,63,49,"Pilot 9","Pilot 9: bigger feedback + text",6,"high",1
"SUPPRF37035",17,54,52,83,12,85,71,54,"Pilot 9","Pilot 9: bigger feedback + text",6,"high",29
"SUPPRF37035",18,49,49,24,-13,86,37,33,"Pilot 9","Pilot 9: bigger feedback + text",6,"high",-9
"SUPPRF37035",19,48,51,22,-15,95,37,24,"Pilot 9","Pilot 9: bigger feedback + text",6,"high",-2
"SUPPRF37035",20,55,57,54,0,89,54,47,"Pilot 9","Pilot 9: bigger feedback + text",6,"high",7
"SUPPRF37035",21,52,55,56,-15,81,71,54,"Pilot 9","Pilot 9: bigger feedback + text",6,"high",2
"SUPPRF37035",22,45,49,35,15,92,20,16,"Pilot 9","Pilot 9: bigger feedback + text",6,"high",19
"SUPPRF37035",23,59,59,75,29,81,46,38,"Pilot 9","Pilot 9: bigger feedback + text",6,"high",37
"SUPPRF37035",24,48,54,55,1,86,54,45,"Pilot 9","Pilot 9: bigger feedback + text",6,"high",10
"SUPPRF37035",25,53,63,58,29,84,29,31,"Pilot 9","Pilot 9: bigger feedback + text",6,"high",27
"SUPPRF37035",26,21,79,67,-13,86,80,79,"Pilot 9","Pilot 9: bigger feedback + text",6,"high",-12
"SUPPRF37035",27,52,44,33,-13,60,46,63,"Pilot 9","Pilot 9: bigger feedback + text",6,"high",-30
"SUPPRF37035",28,53,51,100,20,31,80,28,"Pilot 9","Pilot 9: bigger feedback + text",6,"high",72
"SUPPRF37035",29,51,55,70,-1,44,71,42,"Pilot 9","Pilot 9: bigger feedback + text",6,"high",28
"SUPPRF37035",30,50,50,15,-14,71,29,35,"Pilot 9","Pilot 9: bigger feedback + text",6,"high",-20
"SUPPRF37035",31,55,55,66,12,55,54,51,"Pilot 9","Pilot 9: bigger feedback + text",6,"high",15
"SUPPRF37035",32,55,53,37,0,82,37,47,"Pilot 9","Pilot 9: bigger feedback + text",6,"high",-10
"SUPPRF37035",33,50,49,47,27,33,20,35,"Pilot 9","Pilot 9: bigger feedback + text",6,"high",12
"SUPPRF37035",34,52,53,47,-16,69,63,46,"Pilot 9","Pilot 9: bigger feedback + text",6,"high",1
"SUPPRF37035",35,51,50,28,-1,84,29,36,"Pilot 9","Pilot 9: bigger feedback + text",6,"high",-8
"SUPPRF37035",36,47,50,68,-12,81,80,26,"Pilot 9","Pilot 9: bigger feedback + text",6,"high",42
"SUPPRF37035",37,51,49,55,-16,57,71,57,"Pilot 9","Pilot 9: bigger feedback + text",6,"high",-2
"SUPPRF37035",38,55,54,34,-12,82,46,48,"Pilot 9","Pilot 9: bigger feedback + text",6,"high",-14
"SUPPRF37035",39,50,51,38,1,83,37,53,"Pilot 9","Pilot 9: bigger feedback + text",6,"high",-15
"SUPPRF37035",40,50,48,80,0,79,80,81,"Pilot 9","Pilot 9: bigger feedback + text",6,"high",-1
"SUPPRF37035",41,52,56,46,17,53,29,56,"Pilot 9","Pilot 9: bigger feedback + text",6,"high",-10
"SUPPRF37035",42,52,50,46,0,52,46,48,"Pilot 9","Pilot 9: bigger feedback + text",6,"high",-2
"SUPPRF37035",43,52,56,16,-13,59,29,55,"Pilot 9","Pilot 9: bigger feedback + text",6,"high",-39
"SUPPRF37035",44,54,54,29,0,86,29,24,"Pilot 9","Pilot 9: bigger feedback + text",6,"high",5
"SUPPRF37035",45,49,53,6,-14,84,20,18,"Pilot 9","Pilot 9: bigger feedback + text",6,"high",-12
"SUPPRF37035",46,62,58,94,23,67,71,62,"Pilot 9","Pilot 9: bigger feedback + text",6,"high",32
"SUPPRF37035",47,52,61,63,0,77,63,51,"Pilot 9","Pilot 9: bigger feedback + text",6,"high",12
"SUPPRF37035",48,55,54,62,-1,51,63,49,"Pilot 9","Pilot 9: bigger feedback + text",6,"high",13
"SUPPRF37610",1,0,14,48,19,77,29,38,"Pilot 7","Pilot 7: bigger feedback + text",0,"low",10
"SUPPRF37610",2,0,11,38,-16,64,54,38,"Pilot 7","Pilot 7: bigger feedback + text",0,"low",0
"SUPPRF37610",3,0,12,70,-1,66,71,75,"Pilot 7","Pilot 7: bigger feedback + text",0,"low",-5
"SUPPRF37610",4,0,9,15,-14,68,29,40,"Pilot 7","Pilot 7: bigger feedback + text",0,"low",-25
"SUPPRF37610",5,0,10,62,-1,74,63,44,"Pilot 7","Pilot 7: bigger feedback + text",0,"low",18
"SUPPRF37610",6,0,8,54,0,73,54,55,"Pilot 7","Pilot 7: bigger feedback + text",0,"low",-1
"SUPPRF37610",7,0,8,34,-12,79,46,45,"Pilot 7","Pilot 7: bigger feedback + text",0,"low",-11
"SUPPRF37610",8,1,7,68,-12,62,80,78,"Pilot 7","Pilot 7: bigger feedback + text",0,"low",-10
"SUPPRF37610",9,0,10,33,-13,63,46,45,"Pilot 7","Pilot 7: bigger feedback + text",0,"low",-12
"SUPPRF37610",10,0,7,68,14,35,54,42,"Pilot 7","Pilot 7: bigger feedback + text",0,"low",26
"SUPPRF37610",11,0,11,50,-13,47,63,54,"Pilot 7","Pilot 7: bigger feedback + text",0,"low",-4
"SUPPRF37610",12,0,8,46,17,68,29,30,"Pilot 7","Pilot 7: bigger feedback + text",0,"low",16
"SUPPRF37610",13,0,6,22,-15,16,37,35,"Pilot 7","Pilot 7: bigger feedback + text",0,"low",-13
"SUPPRF37610",14,0,12,55,-16,72,71,39,"Pilot 7","Pilot 7: bigger feedback + text",0,"low",16
"SUPPRF37610",15,0,11,38,1,72,37,34,"Pilot 7","Pilot 7: bigger feedback + text",0,"low",4
"SUPPRF37610",16,0,9,16,-13,47,29,51,"Pilot 7","Pilot 7: bigger feedback + text",0,"low",-35
"SUPPRF37610",17,2,7,63,0,60,63,26,"Pilot 7","Pilot 7: bigger feedback + text",0,"low",37
"SUPPRF37610",18,7,9,29,0,59,29,36,"Pilot 7","Pilot 7: bigger feedback + text",0,"low",-7
"SUPPRF37610",19,0,6,41,-13,86,54,48,"Pilot 7","Pilot 7: bigger feedback + text",0,"low",-7
"SUPPRF37610",20,0,6,28,-1,15,29,54,"Pilot 7","Pilot 7: bigger feedback + text",0,"low",-26
"SUPPRF37610",21,0,8,58,12,71,46,35,"Pilot 7","Pilot 7: bigger feedback + text",0,"low",23
"SUPPRF37610",22,0,7,97,17,74,80,60,"Pilot 7","Pilot 7: bigger feedback + text",0,"low",37
"SUPPRF37610",23,0,11,37,0,77,37,38,"Pilot 7","Pilot 7: bigger feedback + text",0,"low",-1
"SUPPRF37610",24,0,8,84,13,67,71,73,"Pilot 7","Pilot 7: bigger feedback + text",0,"low",11
"SUPPRF37610",25,0,7,35,15,64,20,20,"Pilot 7","Pilot 7: bigger feedback + text",0,"low",15
"SUPPRF37610",26,0,0,6,-14,32,20,35,"Pilot 7","Pilot 7: bigger feedback + text",0,"low",-29
"SUPPRF37610",27,0,0,80,0,68,80,81,"Pilot 7","Pilot 7: bigger feedback + text",0,"low",-1
"SUPPRF37610",28,0,0,55,1,51,54,51,"Pilot 7","Pilot 7: bigger feedback + text",0,"low",4
"SUPPRF37610",29,0,0,45,-1,49,46,54,"Pilot 7","Pilot 7: bigger feedback + text",0,"low",-9
"SUPPRF37610",30,0,0,47,-16,52,63,65,"Pilot 7","Pilot 7: bigger feedback + text",0,"low",-18
"SUPPRF37610",31,1,1,56,-15,16,71,61,"Pilot 7","Pilot 7: bigger feedback + text",0,"low",-5
"SUPPRF37610",32,0,7,24,-13,17,37,9,"Pilot 7","Pilot 7: bigger feedback + text",0,"low",15
"SUPPRF37610",33,0,0,71,0,28,71,52,"Pilot 7","Pilot 7: bigger feedback + text",0,"low",19
"SUPPRF37610",34,4,0,8,-12,64,20,20,"Pilot 7","Pilot 7: bigger feedback + text",0,"low",-12
"SUPPRF37610",35,0,18,51,14,65,37,49,"Pilot 7","Pilot 7: bigger feedback + text",0,"low",2
"SUPPRF37610",36,0,0,67,-13,67,80,69,"Pilot 7","Pilot 7: bigger feedback + text",0,"low",-2
"SUPPRF37610",37,2,0,20,0,67,20,13,"Pilot 7","Pilot 7: bigger feedback + text",0,"low",7
"SUPPRF37610",38,0,2,66,12,49,54,47,"Pilot 7","Pilot 7: bigger feedback + text",0,"low",19
"SUPPRF37610",39,0,2,46,0,64,46,55,"Pilot 7","Pilot 7: bigger feedback + text",0,"low",-9
"SUPPRF37610",40,0,0,65,19,4,46,61,"Pilot 7","Pilot 7: bigger feedback + text",0,"low",4
"SUPPRF37610",41,0,3,96,16,61,80,75,"Pilot 7","Pilot 7: bigger feedback + text",0,"low",21
"SUPPRF37610",42,0,0,83,12,33,71,57,"Pilot 7","Pilot 7: bigger feedback + text",0,"low",26
"SUPPRF37610",43,0,0,78,15,69,63,75,"Pilot 7","Pilot 7: bigger feedback + text",0,"low",3
"SUPPRF37610",44,0,0,77,14,81,63,70,"Pilot 7","Pilot 7: bigger feedback + text",0,"low",7
"SUPPRF37610",45,0,23,49,12,0,37,7,"Pilot 7","Pilot 7: bigger feedback + text",0,"low",42
"SUPPRF37610",46,0,41,37,17,38,20,6,"Pilot 7","Pilot 7: bigger feedback + text",0,"low",31
"SUPPRF37610",47,0,58,81,1,40,80,69,"Pilot 7","Pilot 7: bigger feedback + text",0,"low",12
"SUPPRF37610",48,0,71,19,-1,5,20,55,"Pilot 7","Pilot 7: bigger feedback + text",0,"low",-36
"SUPPRF37681",1,71,80,48,19,41,29,44,"Pilot 7","Pilot 7: bigger feedback + text",6,"high",4
"SUPPRF37681",2,46,48,58,12,19,46,70,"Pilot 7","Pilot 7: bigger feedback + text",6,"high",-12
"SUPPRF37681",3,75,78,46,0,45,46,53,"Pilot 7","Pilot 7: bigger feedback + text",6,"high",-7
"SUPPRF37681",4,78,31,55,1,42,54,60,"Pilot 7","Pilot 7: bigger feedback + text",6,"high",-5
"SUPPRF37681",5,78,33,54,0,49,54,59,"Pilot 7","Pilot 7: bigger feedback + text",6,"high",-5
"SUPPRF37681",6,71,46,66,12,34,54,26,"Pilot 7","Pilot 7: bigger feedback + text",6,"high",40
"SUPPRF37681",7,67,33,15,-14,55,29,49,"Pilot 7","Pilot 7: bigger feedback + text",6,"high",-34
"SUPPRF37681",8,82,22,33,-13,0,46,39,"Pilot 7","Pilot 7: bigger feedback + text",6,"high",-6
"SUPPRF37681",9,81,18,77,14,13,63,39,"Pilot 7","Pilot 7: bigger feedback + text",6,"high",38
"SUPPRF37681",10,62,23,19,-1,21,20,72,"Pilot 7","Pilot 7: bigger feedback + text",6,"high",-53
"SUPPRF37681",11,68,75,56,-15,46,71,33,"Pilot 7","Pilot 7: bigger feedback + text",6,"high",23
"SUPPRF37681",12,73,50,38,-16,53,54,71,"Pilot 7","Pilot 7: bigger feedback + text",6,"high",-33
"SUPPRF37681",13,56,39,62,-1,53,63,68,"Pilot 7","Pilot 7: bigger feedback + text",6,"high",-6
"SUPPRF37681",14,52,29,34,-12,48,46,58,"Pilot 7","Pilot 7: bigger feedback + text",6,"high",-24
"SUPPRF37681",15,70,36,37,0,58,37,60,"Pilot 7","Pilot 7: bigger feedback + text",6,"high",-23
"SUPPRF37681",16,63,17,63,0,20,63,43,"Pilot 7","Pilot 7: bigger feedback + text",6,"high",20
"SUPPRF37681",17,75,43,49,12,76,37,57,"Pilot 7","Pilot 7: bigger feedback + text",6,"high",-8
"SUPPRF37681",18,57,27,29,0,47,29,63,"Pilot 7","Pilot 7: bigger feedback + text",6,"high",-34
"SUPPRF37681",19,67,13,51,14,0,37,43,"Pilot 7","Pilot 7: bigger feedback + text",6,"high",8
"SUPPRF37681",20,7,19,8,-12,31,20,35,"Pilot 7","Pilot 7: bigger feedback + text",6,"high",-27
"SUPPRF37681",21,72,17,70,-1,65,71,2,"Pilot 7","Pilot 7: bigger feedback + text",6,"high",68
"SUPPRF37681",22,90,13,83,12,25,71,38,"Pilot 7","Pilot 7: bigger feedback + text",6,"high",45
"SUPPRF37681",23,80,13,80,0,2,80,41,"Pilot 7","Pilot 7: bigger feedback + text",6,"high",39
"SUPPRF37681",24,69,37,24,-13,75,37,26,"Pilot 7","Pilot 7: bigger feedback + text",6,"high",-2
"SUPPRF37681",25,76,17,96,16,13,80,35,"Pilot 7","Pilot 7: bigger feedback + text",6,"high",61
"SUPPRF37681",26,79,12,46,17,90,29,12,"Pilot 7","Pilot 7: bigger feedback + text",6,"high",34
"SUPPRF37681",27,61,23,67,-13,19,80,26,"Pilot 7","Pilot 7: bigger feedback + text",6,"high",41
"SUPPRF37681",28,79,23,37,17,15,20,32,"Pilot 7","Pilot 7: bigger feedback + text",6,"high",5
"SUPPRF37681",29,83,12,97,17,54,80,24,"Pilot 7","Pilot 7: bigger feedback + text",6,"high",73
"SUPPRF37681",30,85,9,41,-13,16,54,19,"Pilot 7","Pilot 7: bigger feedback + text",6,"high",22
"SUPPRF37681",31,85,9,68,14,64,54,84,"Pilot 7","Pilot 7: bigger feedback + text",6,"high",-16
"SUPPRF37681",32,76,9,55,-16,50,71,60,"Pilot 7","Pilot 7: bigger feedback + text",6,"high",-5
"SUPPRF37681",33,84,18,47,-16,73,63,13,"Pilot 7","Pilot 7: bigger feedback + text",6,"high",34
"SUPPRF37681",34,13,31,22,-15,21,37,28,"Pilot 7","Pilot 7: bigger feedback + text",6,"high",-6
"SUPPRF37681",35,72,79,68,-12,4,80,15,"Pilot 7","Pilot 7: bigger feedback + text",6,"high",53
"SUPPRF37681",36,20,36,28,-1,7,29,22,"Pilot 7","Pilot 7: bigger feedback + text",6,"high",6
"SUPPRF37681",37,77,8,20,0,98,20,17,"Pilot 7","Pilot 7: bigger feedback + text",6,"high",3
"SUPPRF37681",38,10,45,78,15,15,63,22,"Pilot 7","Pilot 7: bigger feedback + text",6,"high",56
"SUPPRF37681",39,79,22,71,0,0,71,20,"Pilot 7","Pilot 7: bigger feedback + text",6,"high",51
"SUPPRF37681",40,83,30,35,15,9,20,23,"Pilot 7","Pilot 7: bigger feedback + text",6,"high",12
"SUPPRF37681",41,94,13,65,19,1,46,22,"Pilot 7","Pilot 7: bigger feedback + text",6,"high",43
"SUPPRF37681",42,87,27,50,-13,25,63,52,"Pilot 7","Pilot 7: bigger feedback + text",6,"high",-2
"SUPPRF37681",43,50,7,81,1,8,80,8,"Pilot 7","Pilot 7: bigger feedback + text",6,"high",73
"SUPPRF37681",44,27,3,16,-13,78,29,4,"Pilot 7","Pilot 7: bigger feedback + text",6,"high",12
"SUPPRF37681",45,74,8,45,-1,8,46,37,"Pilot 7","Pilot 7: bigger feedback + text",6,"high",8
"SUPPRF37681",46,92,8,6,-14,5,20,16,"Pilot 7","Pilot 7: bigger feedback + text",6,"high",-10
"SUPPRF37681",47,89,13,84,13,11,71,20,"Pilot 7","Pilot 7: bigger feedback + text",6,"high",64
"SUPPRF37681",48,71,10,38,1,5,37,10,"Pilot 7","Pilot 7: bigger feedback + text",6,"high",28
"SUPPRF37840",1,51,9,37,0,80,37,40,"Pilot 10","Pilot 10: bigger feedback + video",2,"low",-3
"SUPPRF37840",2,50,8,46,0,40,46,25,"Pilot 10","Pilot 10: bigger feedback + video",2,"low",21
"SUPPRF37840",3,51,8,54,0,80,54,60,"Pilot 10","Pilot 10: bigger feedback + video",2,"low",-6
"SUPPRF37840",4,61,5,100,20,80,80,80,"Pilot 10","Pilot 10: bigger feedback + video",2,"low",20
"SUPPRF37840",5,51,7,28,-1,80,29,30,"Pilot 10","Pilot 10: bigger feedback + video",2,"low",-2
"SUPPRF37840",6,50,7,33,-13,60,46,45,"Pilot 10","Pilot 10: bigger feedback + video",2,"low",-12
"SUPPRF37840",7,50,5,62,-1,60,63,50,"Pilot 10","Pilot 10: bigger feedback + video",2,"low",12
"SUPPRF37840",8,49,7,38,1,20,37,50,"Pilot 10","Pilot 10: bigger feedback + video",2,"low",-12
"SUPPRF37840",9,49,5,46,17,75,29,25,"Pilot 10","Pilot 10: bigger feedback + video",2,"low",21
"SUPPRF37840",10,51,6,58,29,50,29,30,"Pilot 10","Pilot 10: bigger feedback + video",2,"low",28
"SUPPRF37840",11,51,5,55,-16,80,71,78,"Pilot 10","Pilot 10: bigger feedback + video",2,"low",-23
"SUPPRF37840",12,50,6,66,12,30,54,50,"Pilot 10","Pilot 10: bigger feedback + video",2,"low",16
"SUPPRF37840",13,51,5,81,1,85,80,80,"Pilot 10","Pilot 10: bigger feedback + video",2,"low",1
"SUPPRF37840",14,50,5,67,-13,90,80,80,"Pilot 10","Pilot 10: bigger feedback + video",2,"low",-13
"SUPPRF37840",15,49,6,29,0,25,29,30,"Pilot 10","Pilot 10: bigger feedback + video",2,"low",-1
"SUPPRF37840",16,51,5,77,14,45,63,60,"Pilot 10","Pilot 10: bigger feedback + video",2,"low",17
"SUPPRF37840",17,51,6,55,1,65,54,55,"Pilot 10","Pilot 10: bigger feedback + video",2,"low",0
"SUPPRF37840",18,49,5,47,-16,40,63,60,"Pilot 10","Pilot 10: bigger feedback + video",2,"low",-13
"SUPPRF37840",19,52,6,41,-13,85,54,66,"Pilot 10","Pilot 10: bigger feedback + video",2,"low",-25
"SUPPRF37840",20,51,8,19,-1,75,20,20,"Pilot 10","Pilot 10: bigger feedback + video",2,"low",-1
"SUPPRF37840",21,52,5,94,23,65,71,70,"Pilot 10","Pilot 10: bigger feedback + video",2,"low",24
"SUPPRF37840",22,51,8,70,-1,75,71,70,"Pilot 10","Pilot 10: bigger feedback + video",2,"low",0
"SUPPRF37840",23,49,8,63,0,45,63,65,"Pilot 10","Pilot 10: bigger feedback + video",2,"low",-2
"SUPPRF37840",24,49,9,47,27,30,20,15,"Pilot 10","Pilot 10: bigger feedback + video",2,"low",32
"SUPPRF37840",25,49,10,50,-13,50,63,65,"Pilot 10","Pilot 10: bigger feedback + video",2,"low",-15
"SUPPRF37840",26,50,9,8,-12,25,20,20,"Pilot 10","Pilot 10: bigger feedback + video",2,"low",-12
"SUPPRF37840",27,49,11,80,0,75,80,80,"Pilot 10","Pilot 10: bigger feedback + video",2,"low",0
"SUPPRF37840",28,51,12,68,-12,90,80,80,"Pilot 10","Pilot 10: bigger feedback + video",2,"low",-12
"SUPPRF37840",29,49,11,20,0,10,20,20,"Pilot 10","Pilot 10: bigger feedback + video",2,"low",0
"SUPPRF37840",30,49,12,16,-13,10,29,40,"Pilot 10","Pilot 10: bigger feedback + video",2,"low",-24
"SUPPRF37840",31,49,9,22,-15,0,37,50,"Pilot 10","Pilot 10: bigger feedback + video",2,"low",-28
"SUPPRF37840",32,46,10,15,-14,10,29,25,"Pilot 10","Pilot 10: bigger feedback + video",2,"low",-10
"SUPPRF37840",33,49,13,58,12,10,46,50,"Pilot 10","Pilot 10: bigger feedback + video",2,"low",8
"SUPPRF37840",34,43,16,38,-16,80,54,70,"Pilot 10","Pilot 10: bigger feedback + video",2,"low",-32
"SUPPRF37840",35,39,17,35,15,75,20,20,"Pilot 10","Pilot 10: bigger feedback + video",2,"low",15
"SUPPRF37840",36,38,29,75,29,40,46,40,"Pilot 10","Pilot 10: bigger feedback + video",2,"low",35
"SUPPRF37840",37,38,23,96,16,80,80,75,"Pilot 10","Pilot 10: bigger feedback + video",2,"low",21
"SUPPRF37840",38,42,28,61,24,70,37,30,"Pilot 10","Pilot 10: bigger feedback + video",2,"low",31
"SUPPRF37840",39,38,32,71,0,80,71,80,"Pilot 10","Pilot 10: bigger feedback + video",2,"low",-9
"SUPPRF37840",40,37,37,24,-13,30,37,40,"Pilot 10","Pilot 10: bigger feedback + video",2,"low",-16
"SUPPRF37840",41,39,36,34,-12,80,46,50,"Pilot 10","Pilot 10: bigger feedback + video",2,"low",-16
"SUPPRF37840",42,38,40,49,12,85,37,30,"Pilot 10","Pilot 10: bigger feedback + video",2,"low",19
"SUPPRF37840",43,38,46,78,24,75,54,60,"Pilot 10","Pilot 10: bigger feedback + video",2,"low",18
"SUPPRF37840",44,40,45,88,25,10,63,50,"Pilot 10","Pilot 10: bigger feedback + video",2,"low",38
"SUPPRF37840",45,39,45,45,-1,40,46,30,"Pilot 10","Pilot 10: bigger feedback + video",2,"low",15
"SUPPRF37840",46,40,53,83,12,80,71,72,"Pilot 10","Pilot 10: bigger feedback + video",2,"low",11
"SUPPRF37840",47,33,49,6,-14,85,20,20,"Pilot 10","Pilot 10: bigger feedback + video",2,"low",-14
"SUPPRF37840",48,41,54,56,-15,90,71,80,"Pilot 10","Pilot 10: bigger feedback + video",2,"low",-24
"SUPPRF38095",1,54,20,47,-16,18,63,52,"Pilot 7","Pilot 7: bigger feedback + text",6,"high",-5
"SUPPRF38095",2,64,19,70,-1,13,71,27,"Pilot 7","Pilot 7: bigger feedback + text",6,"high",43
"SUPPRF38095",3,64,52,83,12,61,71,65,"Pilot 7","Pilot 7: bigger feedback + text",6,"high",18
"SUPPRF38095",4,58,41,20,0,28,20,55,"Pilot 7","Pilot 7: bigger feedback + text",6,"high",-35
"SUPPRF38095",5,54,26,38,1,37,37,72,"Pilot 7","Pilot 7: bigger feedback + text",6,"high",-34
"SUPPRF38095",6,64,29,46,17,19,29,65,"Pilot 7","Pilot 7: bigger feedback + text",6,"high",-19
"SUPPRF38095",7,56,20,24,-13,65,37,50,"Pilot 7","Pilot 7: bigger feedback + text",6,"high",-26
"SUPPRF38095",8,65,23,50,-13,78,63,78,"Pilot 7","Pilot 7: bigger feedback + text",6,"high",-28
"SUPPRF38095",9,51,23,55,1,71,54,36,"Pilot 7","Pilot 7: bigger feedback + text",6,"high",19
"SUPPRF38095",10,54,28,37,17,61,20,60,"Pilot 7","Pilot 7: bigger feedback + text",6,"high",-23
"SUPPRF38095",11,60,30,84,13,77,71,51,"Pilot 7","Pilot 7: bigger feedback + text",6,"high",33
"SUPPRF38095",12,65,32,51,14,37,37,74,"Pilot 7","Pilot 7: bigger feedback + text",6,"high",-23
"SUPPRF38095",13,42,29,16,-13,19,29,55,"Pilot 7","Pilot 7: bigger feedback + text",6,"high",-39
"SUPPRF38095",14,66,31,97,17,26,80,63,"Pilot 7","Pilot 7: bigger feedback + text",6,"high",34
"SUPPRF38095",15,54,31,19,-1,70,20,35,"Pilot 7","Pilot 7: bigger feedback + text",6,"high",-16
"SUPPRF38095",16,41,32,38,-16,16,54,65,"Pilot 7","Pilot 7: bigger feedback + text",6,"high",-27
"SUPPRF38095",17,56,41,68,14,0,54,58,"Pilot 7","Pilot 7: bigger feedback + text",6,"high",10
"SUPPRF38095",18,61,25,80,0,6,80,26,"Pilot 7","Pilot 7: bigger feedback + text",6,"high",54
"SUPPRF38095",19,56,25,22,-15,20,37,60,"Pilot 7","Pilot 7: bigger feedback + text",6,"high",-38
"SUPPRF38095",20,66,36,29,0,41,29,66,"Pilot 7","Pilot 7: bigger feedback + text",6,"high",-37
"SUPPRF38095",21,73,26,41,-13,24,54,36,"Pilot 7","Pilot 7: bigger feedback + text",6,"high",5
"SUPPRF38095",22,27,58,71,0,59,71,67,"Pilot 7","Pilot 7: bigger feedback + text",6,"high",4
"SUPPRF38095",23,65,43,65,19,82,46,30,"Pilot 7","Pilot 7: bigger feedback + text",6,"high",35
"SUPPRF38095",24,65,32,54,0,53,54,47,"Pilot 7","Pilot 7: bigger feedback + text",6,"high",7
"SUPPRF38095",25,52,39,8,-12,29,20,36,"Pilot 7","Pilot 7: bigger feedback + text",6,"high",-28
"SUPPRF38095",26,63,36,34,-12,56,46,48,"Pilot 7","Pilot 7: bigger feedback + text",6,"high",-14
"SUPPRF38095",27,53,38,63,0,37,63,41,"Pilot 7","Pilot 7: bigger feedback + text",6,"high",22
"SUPPRF38095",28,35,27,68,-12,8,80,70,"Pilot 7","Pilot 7: bigger feedback + text",6,"high",-2
"SUPPRF38095",29,55,35,37,0,11,37,39,"Pilot 7","Pilot 7: bigger feedback + text",6,"high",-2
"SUPPRF38095",30,59,26,96,16,31,80,37,"Pilot 7","Pilot 7: bigger feedback + text",6,"high",59
"SUPPRF38095",31,60,41,55,-16,65,71,90,"Pilot 7","Pilot 7: bigger feedback + text",6,"high",-35
"SUPPRF38095",32,44,20,46,0,6,46,66,"Pilot 7","Pilot 7: bigger feedback + text",6,"high",-20
"SUPPRF38095",33,67,28,58,12,25,46,48,"Pilot 7","Pilot 7: bigger feedback + text",6,"high",10
"SUPPRF38095",34,54,27,81,1,27,80,64,"Pilot 7","Pilot 7: bigger feedback + text",6,"high",17
"SUPPRF38095",35,71,34,62,-1,16,63,45,"Pilot 7","Pilot 7: bigger feedback + text",6,"high",17
"SUPPRF38095",36,53,32,15,-14,4,29,50,"Pilot 7","Pilot 7: bigger feedback + text",6,"high",-35
"SUPPRF38095",37,57,32,45,-1,64,46,21,"Pilot 7","Pilot 7: bigger feedback + text",6,"high",24
"SUPPRF38095",38,37,39,66,12,13,54,15,"Pilot 7","Pilot 7: bigger feedback + text",6,"high",51
"SUPPRF38095",39,53,29,35,15,60,20,74,"Pilot 7","Pilot 7: bigger feedback + text",6,"high",-39
"SUPPRF38095",40,31,28,67,-13,65,80,50,"Pilot 7","Pilot 7: bigger feedback + text",6,"high",17
"SUPPRF38095",41,69,35,56,-15,24,71,45,"Pilot 7","Pilot 7: bigger feedback + text",6,"high",11
"SUPPRF38095",42,51,36,28,-1,26,29,50,"Pilot 7","Pilot 7: bigger feedback + text",6,"high",-22
"SUPPRF38095",43,40,17,48,19,19,29,44,"Pilot 7","Pilot 7: bigger feedback + text",6,"high",4
"SUPPRF38095",44,51,63,6,-14,28,20,23,"Pilot 7","Pilot 7: bigger feedback + text",6,"high",-17
"SUPPRF38095",45,40,36,33,-13,55,46,55,"Pilot 7","Pilot 7: bigger feedback + text",6,"high",-22
"SUPPRF38095",46,58,31,77,14,61,63,57,"Pilot 7","Pilot 7: bigger feedback + text",6,"high",20
"SUPPRF38095",47,57,37,78,15,65,63,51,"Pilot 7","Pilot 7: bigger feedback + text",6,"high",27
"SUPPRF38095",48,48,41,49,12,38,37,44,"Pilot 7","Pilot 7: bigger feedback + text",6,"high",5
"SUPPRF40116",1,55,54,6,-14,62,20,19,"Pilot 10","Pilot 10: bigger feedback + video",8,"high",-13
"SUPPRF40116",2,56,52,96,16,45,80,73,"Pilot 10","Pilot 10: bigger feedback + video",8,"high",23
"SUPPRF40116",3,51,54,67,-13,52,80,80,"Pilot 10","Pilot 10: bigger feedback + video",8,"high",-13
"SUPPRF40116",4,53,54,37,0,60,37,31,"Pilot 10","Pilot 10: bigger feedback + video",8,"high",6
"SUPPRF40116",5,58,55,46,0,35,46,47,"Pilot 10","Pilot 10: bigger feedback + video",8,"high",-1
"SUPPRF40116",6,61,55,100,20,65,80,89,"Pilot 10","Pilot 10: bigger feedback + video",8,"high",11
"SUPPRF40116",7,57,60,45,-1,37,46,33,"Pilot 10","Pilot 10: bigger feedback + video",8,"high",12
"SUPPRF40116",8,60,53,94,23,43,71,64,"Pilot 10","Pilot 10: bigger feedback + video",8,"high",30
"SUPPRF40116",9,59,54,75,29,28,46,57,"Pilot 10","Pilot 10: bigger feedback + video",8,"high",18
"SUPPRF40116",10,53,53,33,-13,57,46,40,"Pilot 10","Pilot 10: bigger feedback + video",8,"high",-7
"SUPPRF40116",11,52,53,66,12,56,54,58,"Pilot 10","Pilot 10: bigger feedback + video",8,"high",8
"SUPPRF40116",12,52,53,55,-16,60,71,81,"Pilot 10","Pilot 10: bigger feedback + video",8,"high",-26
"SUPPRF40116",13,51,52,41,-13,32,54,56,"Pilot 10","Pilot 10: bigger feedback + video",8,"high",-15
"SUPPRF40116",14,54,52,71,0,39,71,67,"Pilot 10","Pilot 10: bigger feedback + video",8,"high",4
"SUPPRF40116",15,52,54,24,-13,50,37,41,"Pilot 10","Pilot 10: bigger feedback + video",8,"high",-17
"SUPPRF40116",16,57,49,77,14,61,63,57,"Pilot 10","Pilot 10: bigger feedback + video",8,"high",20
"SUPPRF40116",17,62,52,8,-12,64,20,12,"Pilot 10","Pilot 10: bigger feedback + video",8,"high",-4
"SUPPRF40116",18,50,56,54,0,34,54,46,"Pilot 10","Pilot 10: bigger feedback + video",8,"high",8
"SUPPRF40116",19,51,50,15,-14,53,29,33,"Pilot 10","Pilot 10: bigger feedback + video",8,"high",-18
"SUPPRF40116",20,56,48,68,-12,30,80,56,"Pilot 10","Pilot 10: bigger feedback + video",8,"high",12
"SUPPRF40116",21,64,54,50,-13,73,63,54,"Pilot 10","Pilot 10: bigger feedback + video",8,"high",-4
"SUPPRF40116",22,65,55,58,29,59,29,17,"Pilot 10","Pilot 10: bigger feedback + video",8,"high",41
"SUPPRF40116",23,58,48,78,24,50,54,59,"Pilot 10","Pilot 10: bigger feedback + video",8,"high",19
"SUPPRF40116",24,54,47,28,-1,53,29,18,"Pilot 10","Pilot 10: bigger feedback + video",8,"high",10
"SUPPRF40116",25,50,43,70,-1,60,71,60,"Pilot 10","Pilot 10: bigger feedback + video",8,"high",10
"SUPPRF40116",26,54,49,38,-16,44,54,57,"Pilot 10","Pilot 10: bigger feedback + video",8,"high",-19
"SUPPRF40116",27,43,56,38,1,75,37,21,"Pilot 10","Pilot 10: bigger feedback + video",8,"high",17
"SUPPRF40116",28,60,38,62,-1,46,63,56,"Pilot 10","Pilot 10: bigger feedback + video",8,"high",6
"SUPPRF40116",29,57,40,80,0,62,80,83,"Pilot 10","Pilot 10: bigger feedback + video",8,"high",-3
"SUPPRF40116",30,51,41,56,-15,60,71,71,"Pilot 10","Pilot 10: bigger feedback + video",8,"high",-15
"SUPPRF40116",31,52,55,81,1,78,80,68,"Pilot 10","Pilot 10: bigger feedback + video",8,"high",13
"SUPPRF40116",32,51,57,19,-1,71,20,3,"Pilot 10","Pilot 10: bigger feedback + video",8,"high",16
"SUPPRF40116",33,62,43,88,25,62,63,58,"Pilot 10","Pilot 10: bigger feedback + video",8,"high",30
"SUPPRF40116",34,51,43,35,15,72,20,16,"Pilot 10","Pilot 10: bigger feedback + video",8,"high",19
"SUPPRF40116",35,56,46,83,12,81,71,58,"Pilot 10","Pilot 10: bigger feedback + video",8,"high",25
"SUPPRF40116",36,49,48,47,-16,47,63,55,"Pilot 10","Pilot 10: bigger feedback + video",8,"high",-8
"SUPPRF40116",37,55,44,46,17,76,29,26,"Pilot 10","Pilot 10: bigger feedback + video",8,"high",20
"SUPPRF40116",38,53,46,58,12,32,46,35,"Pilot 10","Pilot 10: bigger feedback + video",8,"high",23
"SUPPRF40116",39,54,45,55,1,59,54,66,"Pilot 10","Pilot 10: bigger feedback + video",8,"high",-11
"SUPPRF40116",40,54,44,61,24,34,37,37,"Pilot 10","Pilot 10: bigger feedback + video",8,"high",24
"SUPPRF40116",41,63,46,47,27,76,20,21,"Pilot 10","Pilot 10: bigger feedback + video",8,"high",26
"SUPPRF40116",42,56,58,29,0,56,29,29,"Pilot 10","Pilot 10: bigger feedback + video",8,"high",0
"SUPPRF40116",43,51,44,22,-15,56,37,24,"Pilot 10","Pilot 10: bigger feedback + video",8,"high",-2
"SUPPRF40116",44,53,45,16,-13,50,29,34,"Pilot 10","Pilot 10: bigger feedback + video",8,"high",-18
"SUPPRF40116",45,59,44,49,12,60,37,40,"Pilot 10","Pilot 10: bigger feedback + video",8,"high",9
"SUPPRF40116",46,48,41,34,-12,45,46,49,"Pilot 10","Pilot 10: bigger feedback + video",8,"high",-15
"SUPPRF40116",47,55,41,63,0,32,63,57,"Pilot 10","Pilot 10: bigger feedback + video",8,"high",6
"SUPPRF40116",48,72,40,20,0,58,20,20,"Pilot 10","Pilot 10: bigger feedback + video",8,"high",0
"SUPPRF41746",1,40,47,55,1,33,54,33,"Pilot 6","Pilot 6: feedback + text",7,"high",22
"SUPPRF41746",2,47,48,46,17,49,29,30,"Pilot 6","Pilot 6: feedback + text",7,"high",16
"SUPPRF41746",3,40,48,24,-13,52,37,47,"Pilot 6","Pilot 6: feedback + text",7,"high",-23
"SUPPRF41746",4,47,48,84,13,58,71,74,"Pilot 6","Pilot 6: feedback + text",7,"high",10
"SUPPRF41746",5,45,50,67,-13,62,80,80,"Pilot 6","Pilot 6: feedback + text",7,"high",-13
"SUPPRF41746",6,42,46,8,-12,58,20,20,"Pilot 6","Pilot 6: feedback + text",7,"high",-12
"SUPPRF41746",7,45,45,48,19,51,29,30,"Pilot 6","Pilot 6: feedback + text",7,"high",18
"SUPPRF41746",8,46,48,50,-13,70,63,66,"Pilot 6","Pilot 6: feedback + text",7,"high",-16
"SUPPRF41746",9,46,45,77,14,77,63,50,"Pilot 6","Pilot 6: feedback + text",7,"high",27
"SUPPRF41746",10,49,41,58,12,66,46,44,"Pilot 6","Pilot 6: feedback + text",7,"high",14
"SUPPRF41746",11,49,44,54,0,68,54,56,"Pilot 6","Pilot 6: feedback + text",7,"high",-2
"SUPPRF41746",12,47,43,63,0,63,63,49,"Pilot 6","Pilot 6: feedback + text",7,"high",14
"SUPPRF41746",13,49,41,28,-1,73,29,30,"Pilot 6","Pilot 6: feedback + text",7,"high",-2
"SUPPRF41746",14,48,40,34,-12,40,46,39,"Pilot 6","Pilot 6: feedback + text",7,"high",-5
"SUPPRF41746",15,49,42,19,-1,65,20,22,"Pilot 6","Pilot 6: feedback + text",7,"high",-3
"SUPPRF41746",16,48,38,51,14,48,37,31,"Pilot 6","Pilot 6: feedback + text",7,"high",20
"SUPPRF41746",17,48,39,37,17,67,20,19,"Pilot 6","Pilot 6: feedback + text",7,"high",18
"SUPPRF41746",18,48,39,41,-13,57,54,50,"Pilot 6","Pilot 6: feedback + text",7,"high",-9
"SUPPRF41746",19,49,38,33,-13,63,46,57,"Pilot 6","Pilot 6: feedback + text",7,"high",-24
"SUPPRF41746",20,50,44,80,0,54,80,80,"Pilot 6","Pilot 6: feedback + text",7,"high",0
"SUPPRF41746",21,47,40,49,12,48,37,44,"Pilot 6","Pilot 6: feedback + text",7,"high",5
"SUPPRF41746",22,44,38,46,0,67,46,24,"Pilot 6","Pilot 6: feedback + text",7,"high",22
"SUPPRF41746",23,42,42,35,15,49,20,21,"Pilot 6","Pilot 6: feedback + text",7,"high",14
"SUPPRF41746",24,39,40,29,0,51,29,29,"Pilot 6","Pilot 6: feedback + text",7,"high",0
"SUPPRF41746",25,44,37,62,-1,58,63,58,"Pilot 6","Pilot 6: feedback + text",7,"high",4
"SUPPRF41746",26,45,38,38,1,49,37,32,"Pilot 6","Pilot 6: feedback + text",7,"high",6
"SUPPRF41746",27,48,38,37,0,66,37,36,"Pilot 6","Pilot 6: feedback + text",7,"high",1
"SUPPRF41746",28,46,38,20,0,59,20,18,"Pilot 6","Pilot 6: feedback + text",7,"high",2
"SUPPRF41746",29,50,35,70,-1,70,71,71,"Pilot 6","Pilot 6: feedback + text",7,"high",-1
"SUPPRF41746",30,48,40,45,-1,65,46,49,"Pilot 6","Pilot 6: feedback + text",7,"high",-4
"SUPPRF41746",31,50,37,71,0,68,71,71,"Pilot 6","Pilot 6: feedback + text",7,"high",0
"SUPPRF41746",32,43,36,56,-15,75,71,74,"Pilot 6","Pilot 6: feedback + text",7,"high",-18
"SUPPRF41746",33,46,37,68,14,70,54,56,"Pilot 6","Pilot 6: feedback + text",7,"high",12
"SUPPRF41746",34,49,40,68,-12,47,80,57,"Pilot 6","Pilot 6: feedback + text",7,"high",11
"SUPPRF41746",35,49,50,55,-16,0,71,0,"Pilot 6","Pilot 6: feedback + text",7,"high",55
"SUPPRF41746",36,48,41,96,16,50,80,68,"Pilot 6","Pilot 6: feedback + text",7,"high",28
"SUPPRF41746",37,45,37,15,-14,49,29,28,"Pilot 6","Pilot 6: feedback + text",7,"high",-13
"SUPPRF41746",38,40,37,38,-16,56,54,64,"Pilot 6","Pilot 6: feedback + text",7,"high",-26
"SUPPRF41746",39,44,34,83,12,54,71,72,"Pilot 6","Pilot 6: feedback + text",7,"high",11
"SUPPRF41746",40,45,40,97,17,67,80,79,"Pilot 6","Pilot 6: feedback + text",7,"high",18
"SUPPRF41746",41,41,37,66,12,64,54,67,"Pilot 6","Pilot 6: feedback + text",7,"high",-1
"SUPPRF41746",42,40,35,16,-13,65,29,28,"Pilot 6","Pilot 6: feedback + text",7,"high",-12
"SUPPRF41746",43,39,37,65,19,66,46,44,"Pilot 6","Pilot 6: feedback + text",7,"high",21
"SUPPRF41746",44,44,35,78,15,49,63,35,"Pilot 6","Pilot 6: feedback + text",7,"high",43
"SUPPRF41746",45,41,35,47,-16,58,63,61,"Pilot 6","Pilot 6: feedback + text",7,"high",-14
"SUPPRF41746",46,40,36,22,-15,48,37,34,"Pilot 6","Pilot 6: feedback + text",7,"high",-12
"SUPPRF41746",47,42,39,81,1,63,80,76,"Pilot 6","Pilot 6: feedback + text",7,"high",5
"SUPPRF41746",48,43,34,6,-14,60,20,17,"Pilot 6","Pilot 6: feedback + text",7,"high",-11
"SUPPRF43222",1,48,24,29,0,66,29,80,"Pilot 9","Pilot 9: bigger feedback + text",6,"high",-51
"SUPPRF43222",2,47,17,56,-15,69,71,90,"Pilot 9","Pilot 9: bigger feedback + text",6,"high",-34
"SUPPRF43222",3,50,30,63,0,57,63,67,"Pilot 9","Pilot 9: bigger feedback + text",6,"high",-4
"SUPPRF43222",4,49,26,68,-12,41,80,62,"Pilot 9","Pilot 9: bigger feedback + text",6,"high",6
"SUPPRF43222",5,50,20,8,-12,60,20,67,"Pilot 9","Pilot 9: bigger feedback + text",6,"high",-59
"SUPPRF43222",6,50,13,46,0,71,46,76,"Pilot 9","Pilot 9: bigger feedback + text",6,"high",-30
"SUPPRF43222",7,50,18,47,-16,74,63,73,"Pilot 9","Pilot 9: bigger feedback + text",6,"high",-26
"SUPPRF43222",8,48,24,6,-14,67,20,74,"Pilot 9","Pilot 9: bigger feedback + text",6,"high",-68
"SUPPRF43222",9,51,14,80,0,67,80,56,"Pilot 9","Pilot 9: bigger feedback + text",6,"high",24
"SUPPRF43222",10,50,16,41,-13,82,54,71,"Pilot 9","Pilot 9: bigger feedback + text",6,"high",-30
"SUPPRF43222",11,49,22,71,0,46,71,45,"Pilot 9","Pilot 9: bigger feedback + text",6,"high",26
"SUPPRF43222",12,51,24,35,15,67,20,33,"Pilot 9","Pilot 9: bigger feedback + text",6,"high",2
"SUPPRF43222",13,55,26,81,1,65,80,74,"Pilot 9","Pilot 9: bigger feedback + text",6,"high",7
"SUPPRF43222",14,51,22,100,20,62,80,90,"Pilot 9","Pilot 9: bigger feedback + text",6,"high",10
"SUPPRF43222",15,47,15,50,-13,41,63,63,"Pilot 9","Pilot 9: bigger feedback + text",6,"high",-13
"SUPPRF43222",16,49,18,24,-13,70,37,78,"Pilot 9","Pilot 9: bigger feedback + text",6,"high",-54
"SUPPRF43222",17,50,25,77,14,69,63,70,"Pilot 9","Pilot 9: bigger feedback + text",6,"high",7
"SUPPRF43222",18,48,30,58,29,63,29,66,"Pilot 9","Pilot 9: bigger feedback + text",6,"high",-8
"SUPPRF43222",19,50,13,55,1,64,54,73,"Pilot 9","Pilot 9: bigger feedback + text",6,"high",-18
"SUPPRF43222",20,49,13,61,24,73,37,40,"Pilot 9","Pilot 9: bigger feedback + text",6,"high",21
"SUPPRF43222",21,50,22,33,-13,72,46,42,"Pilot 9","Pilot 9: bigger feedback + text",6,"high",-9
"SUPPRF43222",22,48,21,94,23,77,71,87,"Pilot 9","Pilot 9: bigger feedback + text",6,"high",7
"SUPPRF43222",23,49,24,49,12,40,37,64,"Pilot 9","Pilot 9: bigger feedback + text",6,"high",-15
"SUPPRF43222",24,47,14,45,-1,71,46,81,"Pilot 9","Pilot 9: bigger feedback + text",6,"high",-36
"SUPPRF43222",25,50,25,83,12,58,71,84,"Pilot 9","Pilot 9: bigger feedback + text",6,"high",-1
"SUPPRF43222",26,57,31,19,-1,42,20,69,"Pilot 9","Pilot 9: bigger feedback + text",6,"high",-50
"SUPPRF43222",27,51,26,78,24,46,54,67,"Pilot 9","Pilot 9: bigger feedback + text",6,"high",11
"SUPPRF43222",28,49,21,34,-12,62,46,83,"Pilot 9","Pilot 9: bigger feedback + text",6,"high",-49
"SUPPRF43222",29,54,24,46,17,37,29,69,"Pilot 9","Pilot 9: bigger feedback + text",6,"high",-23
"SUPPRF43222",30,50,21,67,-13,78,80,77,"Pilot 9","Pilot 9: bigger feedback + text",6,"high",-10
"SUPPRF43222",31,49,17,22,-15,43,37,62,"Pilot 9","Pilot 9: bigger feedback + text",6,"high",-40
"SUPPRF43222",32,50,26,58,12,40,46,65,"Pilot 9","Pilot 9: bigger feedback + text",6,"high",-7
"SUPPRF43222",33,53,19,75,29,39,46,66,"Pilot 9","Pilot 9: bigger feedback + text",6,"high",9
"SUPPRF43222",34,53,15,16,-13,67,29,45,"Pilot 9","Pilot 9: bigger feedback + text",6,"high",-29
"SUPPRF43222",35,49,22,28,-1,41,29,60,"Pilot 9","Pilot 9: bigger feedback + text",6,"high",-32
"SUPPRF43222",36,52,27,66,12,75,54,77,"Pilot 9","Pilot 9: bigger feedback + text",6,"high",-11
"SUPPRF43222",37,48,12,37,0,81,37,30,"Pilot 9","Pilot 9: bigger feedback + text",6,"high",7
"SUPPRF43222",38,48,21,62,-1,40,63,66,"Pilot 9","Pilot 9: bigger feedback + text",6,"high",-4
"SUPPRF43222",39,50,36,38,-16,65,54,47,"Pilot 9","Pilot 9: bigger feedback + text",6,"high",-9
"SUPPRF43222",40,48,23,47,27,61,20,46,"Pilot 9","Pilot 9: bigger feedback + text",6,"high",1
"SUPPRF43222",41,49,15,15,-14,33,29,69,"Pilot 9","Pilot 9: bigger feedback + text",6,"high",-54
"SUPPRF43222",42,50,20,88,25,38,63,62,"Pilot 9","Pilot 9: bigger feedback + text",6,"high",26
"SUPPRF43222",43,49,18,38,1,37,37,80,"Pilot 9","Pilot 9: bigger feedback + text",6,"high",-42
"SUPPRF43222",44,48,16,20,0,39,20,67,"Pilot 9","Pilot 9: bigger feedback + text",6,"high",-47
"SUPPRF43222",45,51,18,96,16,62,80,86,"Pilot 9","Pilot 9: bigger feedback + text",6,"high",10
"SUPPRF43222",46,50,14,70,-1,40,71,66,"Pilot 9","Pilot 9: bigger feedback + text",6,"high",4
"SUPPRF43222",47,44,20,54,0,41,54,63,"Pilot 9","Pilot 9: bigger feedback + text",6,"high",-9
"SUPPRF43222",48,51,16,55,-16,57,71,79,"Pilot 9","Pilot 9: bigger feedback + text",6,"high",-24
"SUPPRF43235",1,74,13,65,19,64,46,43,"Pilot 7","Pilot 7: bigger feedback + text",0,"low",22
"SUPPRF43235",2,66,5,37,17,67,20,30,"Pilot 7","Pilot 7: bigger feedback + text",0,"low",7
"SUPPRF43235",3,81,1,34,-12,53,46,44,"Pilot 7","Pilot 7: bigger feedback + text",0,"low",-10
"SUPPRF43235",4,80,3,38,1,54,37,19,"Pilot 7","Pilot 7: bigger feedback + text",0,"low",19
"SUPPRF43235",5,78,1,20,0,56,20,25,"Pilot 7","Pilot 7: bigger feedback + text",0,"low",-5
"SUPPRF43235",6,84,4,48,19,59,29,35,"Pilot 7","Pilot 7: bigger feedback + text",0,"low",13
"SUPPRF43235",7,85,5,55,1,62,54,39,"Pilot 7","Pilot 7: bigger feedback + text",0,"low",16
"SUPPRF43235",8,75,1,70,-1,58,71,54,"Pilot 7","Pilot 7: bigger feedback + text",0,"low",16
"SUPPRF43235",9,76,2,56,-15,54,71,49,"Pilot 7","Pilot 7: bigger feedback + text",0,"low",7
"SUPPRF43235",10,75,1,49,12,51,37,52,"Pilot 7","Pilot 7: bigger feedback + text",0,"low",-3
"SUPPRF43235",11,66,6,41,-13,56,54,46,"Pilot 7","Pilot 7: bigger feedback + text",0,"low",-5
"SUPPRF43235",12,91,7,71,0,50,71,38,"Pilot 7","Pilot 7: bigger feedback + text",0,"low",33
"SUPPRF43235",13,82,4,29,0,56,29,23,"Pilot 7","Pilot 7: bigger feedback + text",0,"low",6
"SUPPRF43235",14,89,3,80,0,55,80,39,"Pilot 7","Pilot 7: bigger feedback + text",0,"low",41
"SUPPRF43235",15,96,0,51,14,49,37,23,"Pilot 7","Pilot 7: bigger feedback + text",0,"low",28
"SUPPRF43235",16,94,6,66,12,59,54,38,"Pilot 7","Pilot 7: bigger feedback + text",0,"low",28
"SUPPRF43235",17,90,4,28,-1,55,29,30,"Pilot 7","Pilot 7: bigger feedback + text",0,"low",-2
"SUPPRF43235",18,97,3,84,13,62,71,6,"Pilot 7","Pilot 7: bigger feedback + text",0,"low",78
"SUPPRF43235",19,82,6,83,12,65,71,42,"Pilot 7","Pilot 7: bigger feedback + text",0,"low",41
"SUPPRF43235",20,93,5,54,0,66,54,12,"Pilot 7","Pilot 7: bigger feedback + text",0,"low",42
"SUPPRF43235",21,88,6,15,-14,74,29,1,"Pilot 7","Pilot 7: bigger feedback + text",0,"low",14
"SUPPRF43235",22,95,4,97,17,64,80,1,"Pilot 7","Pilot 7: bigger feedback + text",0,"low",96
"SUPPRF43235",23,95,2,81,1,66,80,37,"Pilot 7","Pilot 7: bigger feedback + text",0,"low",44
"SUPPRF43235",24,91,9,67,-13,66,80,40,"Pilot 7","Pilot 7: bigger feedback + text",0,"low",27
"SUPPRF43235",25,93,7,38,-16,50,54,45,"Pilot 7","Pilot 7: bigger feedback + text",0,"low",-7
"SUPPRF43235",26,82,9,6,-14,54,20,14,"Pilot 7","Pilot 7: bigger feedback + text",0,"low",-8
"SUPPRF43235",27,93,10,55,-16,48,71,46,"Pilot 7","Pilot 7: bigger feedback + text",0,"low",9
"SUPPRF43235",28,88,11,96,16,28,80,31,"Pilot 7","Pilot 7: bigger feedback + text",0,"low",65
"SUPPRF43235",29,75,5,77,14,39,63,25,"Pilot 7","Pilot 7: bigger feedback + text",0,"low",52
"SUPPRF43235",30,91,8,37,0,40,37,25,"Pilot 7","Pilot 7: bigger feedback + text",0,"low",12
"SUPPRF43235",31,95,7,62,-1,23,63,28,"Pilot 7","Pilot 7: bigger feedback + text",0,"low",34
"SUPPRF43235",32,96,6,47,-16,20,63,26,"Pilot 7","Pilot 7: bigger feedback + text",0,"low",21
"SUPPRF43235",33,94,10,46,17,16,29,22,"Pilot 7","Pilot 7: bigger feedback + text",0,"low",24
"SUPPRF43235",34,91,9,58,12,20,46,23,"Pilot 7","Pilot 7: bigger feedback + text",0,"low",35
"SUPPRF43235",35,76,10,63,0,26,63,34,"Pilot 7","Pilot 7: bigger feedback + text",0,"low",29
"SUPPRF43235",36,95,5,8,-12,25,20,24,"Pilot 7","Pilot 7: bigger feedback + text",0,"low",-16
"SUPPRF43420",1,64,37,65,19,74,46,31,"Pilot 6","Pilot 6: feedback + text",10,"high",34
"SUPPRF43420",2,64,40,48,19,60,29,33,"Pilot 6","Pilot 6: feedback + text",10,"high",15
"SUPPRF43420",3,62,43,66,12,48,54,55,"Pilot 6","Pilot 6: feedback + text",10,"high",11
"SUPPRF43420",4,56,45,15,-14,68,29,40,"Pilot 6","Pilot 6: feedback + text",10,"high",-25
"SUPPRF43420",5,63,41,78,15,39,63,51,"Pilot 6","Pilot 6: feedback + text",10,"high",27
"SUPPRF43420",6,57,43,16,-13,58,29,32,"Pilot 6","Pilot 6: feedback + text",10,"high",-16
"SUPPRF43420",7,55,44,41,-13,59,54,56,"Pilot 6","Pilot 6: feedback + text",10,"high",-15
"SUPPRF43420",8,60,35,68,14,40,54,55,"Pilot 6","Pilot 6: feedback + text",10,"high",13
"SUPPRF43420",9,57,41,55,-16,52,71,66,"Pilot 6","Pilot 6: feedback + text",10,"high",-11
"SUPPRF43420",10,76,34,97,17,49,80,71,"Pilot 6","Pilot 6: feedback + text",10,"high",26
"SUPPRF43420",11,62,32,28,-1,44,29,32,"Pilot 6","Pilot 6: feedback + text",10,"high",-4
"SUPPRF43420",12,57,42,24,-13,46,37,37,"Pilot 6","Pilot 6: feedback + text",10,"high",-13
"SUPPRF43420",13,66,34,71,0,37,71,49,"Pilot 6","Pilot 6: feedback + text",10,"high",22
"SUPPRF43420",14,64,36,55,1,65,54,58,"Pilot 6","Pilot 6: feedback + text",10,"high",-3
"SUPPRF43420",15,63,37,96,16,67,80,80,"Pilot 6","Pilot 6: feedback + text",10,"high",16
"SUPPRF43420",16,64,33,77,14,61,63,30,"Pilot 6","Pilot 6: feedback + text",10,"high",47
"SUPPRF43420",17,58,40,50,-13,43,63,63,"Pilot 6","Pilot 6: feedback + text",10,"high",-13
"SUPPRF43420",18,55,41,54,0,43,54,52,"Pilot 6","Pilot 6: feedback + text",10,"high",2
"SUPPRF43420",19,60,37,51,14,28,37,49,"Pilot 6","Pilot 6: feedback + text",10,"high",2
"SUPPRF43420",20,59,36,49,12,54,37,34,"Pilot 6","Pilot 6: feedback + text",10,"high",15
"SUPPRF43420",21,63,38,35,15,60,20,21,"Pilot 6","Pilot 6: feedback + text",10,"high",14
"SUPPRF43420",22,63,37,22,-15,64,37,24,"Pilot 6","Pilot 6: feedback + text",10,"high",-2
"SUPPRF43420",23,58,39,56,-15,55,71,68,"Pilot 6","Pilot 6: feedback + text",10,"high",-12
"SUPPRF43420",24,60,41,19,-1,59,20,15,"Pilot 6","Pilot 6: feedback + text",10,"high",4
"SUPPRF43420",25,61,39,83,12,59,71,70,"Pilot 6","Pilot 6: feedback + text",10,"high",13
"SUPPRF43420",26,61,39,34,-12,36,46,43,"Pilot 6","Pilot 6: feedback + text",10,"high",-9
"SUPPRF43420",27,61,36,80,0,62,80,82,"Pilot 6","Pilot 6: feedback + text",10,"high",-2
"SUPPRF43420",28,58,42,47,-16,53,63,61,"Pilot 6","Pilot 6: feedback + text",10,"high",-14
"SUPPRF43420",29,57,41,8,-12,64,20,14,"Pilot 6","Pilot 6: feedback + text",10,"high",-6
"SUPPRF43420",30,58,40,46,17,56,29,33,"Pilot 6","Pilot 6: feedback + text",10,"high",13
"SUPPRF43420",31,60,33,81,1,63,80,84,"Pilot 6","Pilot 6: feedback + text",10,"high",-3
"SUPPRF43420",32,62,35,62,-1,37,63,57,"Pilot 6","Pilot 6: feedback + text",10,"high",5
"SUPPRF43420",33,55,40,67,-13,67,80,79,"Pilot 6","Pilot 6: feedback + text",10,"high",-12
"SUPPRF43420",34,62,35,46,0,31,46,42,"Pilot 6","Pilot 6: feedback + text",10,"high",4
"SUPPRF43420",35,60,32,37,17,68,20,14,"Pilot 6","Pilot 6: feedback + text",10,"high",23
"SUPPRF43420",36,63,32,33,-13,25,46,43,"Pilot 6","Pilot 6: feedback + text",10,"high",-10
"SUPPRF43420",37,65,33,63,0,53,63,58,"Pilot 6","Pilot 6: feedback + text",10,"high",5
"SUPPRF43420",38,63,35,68,-12,66,80,76,"Pilot 6","Pilot 6: feedback + text",10,"high",-8
"SUPPRF43420",39,63,36,37,0,59,37,37,"Pilot 6","Pilot 6: feedback + text",10,"high",0
"SUPPRF43420",40,64,36,84,13,56,71,67,"Pilot 6","Pilot 6: feedback + text",10,"high",17
"SUPPRF43420",41,65,30,38,1,67,37,40,"Pilot 6","Pilot 6: feedback + text",10,"high",-2
"SUPPRF43420",42,65,35,45,-1,67,46,38,"Pilot 6","Pilot 6: feedback + text",10,"high",7
"SUPPRF43420",43,65,33,58,12,65,46,43,"Pilot 6","Pilot 6: feedback + text",10,"high",15
"SUPPRF43420",44,62,33,6,-14,73,20,13,"Pilot 6","Pilot 6: feedback + text",10,"high",-7
"SUPPRF43420",45,56,38,38,-16,59,54,55,"Pilot 6","Pilot 6: feedback + text",10,"high",-17
"SUPPRF43420",46,61,39,20,0,66,20,14,"Pilot 6","Pilot 6: feedback + text",10,"high",6
"SUPPRF43420",47,64,34,29,0,63,29,23,"Pilot 6","Pilot 6: feedback + text",10,"high",6
"SUPPRF43420",48,65,32,70,-1,61,71,70,"Pilot 6","Pilot 6: feedback + text",10,"high",0
"SUPPRF43536",1,57,44,22,-15,42,37,46,"Pilot 6","Pilot 6: feedback + text",10,"high",-24
"SUPPRF43536",2,70,46,83,12,49,71,34,"Pilot 6","Pilot 6: feedback + text",10,"high",49
"SUPPRF43536",3,57,34,71,0,46,71,38,"Pilot 6","Pilot 6: feedback + text",10,"high",33
"SUPPRF43536",4,15,49,51,14,63,37,41,"Pilot 6","Pilot 6: feedback + text",10,"high",10
"SUPPRF43536",5,50,32,33,-13,59,46,41,"Pilot 6","Pilot 6: feedback + text",10,"high",-8
"SUPPRF43536",6,54,42,48,19,53,29,36,"Pilot 6","Pilot 6: feedback + text",10,"high",12
"SUPPRF43536",7,67,53,46,17,75,29,45,"Pilot 6","Pilot 6: feedback + text",10,"high",1
"SUPPRF43536",8,48,52,28,-1,51,29,47,"Pilot 6","Pilot 6: feedback + text",10,"high",-19
"SUPPRF43536",9,90,4,77,14,41,63,30,"Pilot 6","Pilot 6: feedback + text",10,"high",47
"SUPPRF43536",10,94,8,68,14,50,54,41,"Pilot 6","Pilot 6: feedback + text",10,"high",27
"SUPPRF43536",11,89,53,78,15,49,63,54,"Pilot 6","Pilot 6: feedback + text",10,"high",24
"SUPPRF43536",12,50,52,84,13,58,71,48,"Pilot 6","Pilot 6: feedback + text",10,"high",36
"SUPPRF43536",13,31,66,38,-16,55,54,42,"Pilot 6","Pilot 6: feedback + text",10,"high",-4
"SUPPRF43536",14,46,92,6,-14,62,20,47,"Pilot 6","Pilot 6: feedback + text",10,"high",-41
"SUPPRF43536",15,80,17,70,-1,52,71,47,"Pilot 6","Pilot 6: feedback + text",10,"high",23
"SUPPRF43536",16,68,29,20,0,83,20,13,"Pilot 6","Pilot 6: feedback + text",10,"high",7
"SUPPRF43536",17,63,47,38,1,36,37,50,"Pilot 6","Pilot 6: feedback + text",10,"high",-12
"SUPPRF43536",18,62,46,58,12,61,46,66,"Pilot 6","Pilot 6: feedback + text",10,"high",-8
"SUPPRF43536",19,20,82,15,-14,55,29,36,"Pilot 6","Pilot 6: feedback + text",10,"high",-21
"SUPPRF43536",20,49,51,16,-13,46,29,50,"Pilot 6","Pilot 6: feedback + text",10,"high",-34
"SUPPRF43536",21,83,51,65,19,43,46,41,"Pilot 6","Pilot 6: feedback + text",10,"high",24
"SUPPRF43536",22,88,25,56,-15,43,71,50,"Pilot 6","Pilot 6: feedback + text",10,"high",6
"SUPPRF43536",23,15,78,19,-1,33,20,49,"Pilot 6","Pilot 6: feedback + text",10,"high",-30
"SUPPRF43536",24,48,47,24,-13,50,37,47,"Pilot 6","Pilot 6: feedback + text",10,"high",-23
"SUPPRF43536",25,53,49,55,-16,40,71,46,"Pilot 6","Pilot 6: feedback + text",10,"high",9
"SUPPRF43536",26,54,50,54,0,41,54,48,"Pilot 6","Pilot 6: feedback + text",10,"high",6
"SUPPRF43536",27,89,18,67,-13,44,80,40,"Pilot 6","Pilot 6: feedback + text",10,"high",27
"SUPPRF43536",28,53,28,45,-1,42,46,45,"Pilot 6","Pilot 6: feedback + text",10,"high",0
"SUPPRF43536",29,58,52,41,-13,49,54,44,"Pilot 6","Pilot 6: feedback + text",10,"high",-3
"SUPPRF43536",30,91,56,96,16,47,80,54,"Pilot 6","Pilot 6: feedback + text",10,"high",42
"SUPPRF43536",31,74,35,68,-12,46,80,38,"Pilot 6","Pilot 6: feedback + text",10,"high",30
"SUPPRF43536",32,74,60,47,-16,51,63,39,"Pilot 6","Pilot 6: feedback + text",10,"high",8
"SUPPRF43536",33,56,45,35,15,65,20,50,"Pilot 6","Pilot 6: feedback + text",10,"high",-15
"SUPPRF43536",34,52,44,49,12,53,37,46,"Pilot 6","Pilot 6: feedback + text",10,"high",3
"SUPPRF43536",35,20,86,8,-12,51,20,54,"Pilot 6","Pilot 6: feedback + text",10,"high",-46
"SUPPRF43536",36,46,17,34,-12,55,46,12,"Pilot 6","Pilot 6: feedback + text",10,"high",22
"SUPPRF43536",37,52,14,97,17,51,80,41,"Pilot 6","Pilot 6: feedback + text",10,"high",56
"SUPPRF43536",38,96,3,55,1,55,54,53,"Pilot 6","Pilot 6: feedback + text",10,"high",2
"SUPPRF43536",39,87,14,80,0,48,80,52,"Pilot 6","Pilot 6: feedback + text",10,"high",28
"SUPPRF43536",40,73,13,62,-1,54,63,14,"Pilot 6","Pilot 6: feedback + text",10,"high",48
"SUPPRF43536",41,76,55,63,0,53,63,56,"Pilot 6","Pilot 6: feedback + text",10,"high",7
"SUPPRF43536",42,76,14,50,-13,47,63,54,"Pilot 6","Pilot 6: feedback + text",10,"high",-4
"SUPPRF43536",43,62,11,66,12,37,54,51,"Pilot 6","Pilot 6: feedback + text",10,"high",15
"SUPPRF43536",44,85,22,46,0,38,46,49,"Pilot 6","Pilot 6: feedback + text",10,"high",-3
"SUPPRF43536",45,86,55,29,0,29,29,53,"Pilot 6","Pilot 6: feedback + text",10,"high",-24
"SUPPRF43536",46,63,34,81,1,42,80,51,"Pilot 6","Pilot 6: feedback + text",10,"high",30
"SUPPRF43536",47,44,68,37,0,47,37,43,"Pilot 6","Pilot 6: feedback + text",10,"high",-6
"SUPPRF43536",48,65,45,37,17,45,20,29,"Pilot 6","Pilot 6: feedback + text",10,"high",8
"SUPPRF43675",1,75,37,88,25,53,63,23,"Pilot 9","Pilot 9: bigger feedback + text",3,"low",65
"SUPPRF43675",2,58,55,6,-14,48,20,15,"Pilot 9","Pilot 9: bigger feedback + text",3,"low",-9
"SUPPRF43675",3,59,66,46,17,57,29,49,"Pilot 9","Pilot 9: bigger feedback + text",3,"low",-3
"SUPPRF43675",4,48,60,24,-13,72,37,52,"Pilot 9","Pilot 9: bigger feedback + text",3,"low",-28
"SUPPRF43675",5,55,57,34,-12,55,46,11,"Pilot 9","Pilot 9: bigger feedback + text",3,"low",23
"SUPPRF43675",6,54,67,62,-1,26,63,43,"Pilot 9","Pilot 9: bigger feedback + text",3,"low",19
"SUPPRF43675",7,65,59,81,1,66,80,65,"Pilot 9","Pilot 9: bigger feedback + text",3,"low",16
"SUPPRF43675",8,67,69,37,0,51,37,49,"Pilot 9","Pilot 9: bigger feedback + text",3,"low",-12
"SUPPRF43675",9,65,63,68,-12,63,80,72,"Pilot 9","Pilot 9: bigger feedback + text",3,"low",-4
"SUPPRF43675",10,66,69,100,20,71,80,43,"Pilot 9","Pilot 9: bigger feedback + text",3,"low",57
"SUPPRF43675",11,60,63,63,0,59,63,51,"Pilot 9","Pilot 9: bigger feedback + text",3,"low",12
"SUPPRF43675",12,47,59,15,-14,61,29,41,"Pilot 9","Pilot 9: bigger feedback + text",3,"low",-26
"SUPPRF43675",13,55,63,83,12,40,71,7,"Pilot 9","Pilot 9: bigger feedback + text",3,"low",76
"SUPPRF43675",14,69,71,78,24,53,54,66,"Pilot 9","Pilot 9: bigger feedback + text",3,"low",12
"SUPPRF43675",15,51,58,71,0,61,71,41,"Pilot 9","Pilot 9: bigger feedback + text",3,"low",30
"SUPPRF43675",16,70,61,47,27,73,20,10,"Pilot 9","Pilot 9: bigger feedback + text",3,"low",37
"SUPPRF43675",17,70,75,38,1,62,37,44,"Pilot 9","Pilot 9: bigger feedback + text",3,"low",-6
"SUPPRF43675",18,71,65,38,-16,59,54,35,"Pilot 9","Pilot 9: bigger feedback + text",3,"low",3
"SUPPRF43675",19,70,74,54,0,68,54,38,"Pilot 9","Pilot 9: bigger feedback + text",3,"low",16
"SUPPRF43675",20,72,70,58,29,73,29,51,"Pilot 9","Pilot 9: bigger feedback + text",3,"low",7
"SUPPRF43675",21,70,70,22,-15,67,37,52,"Pilot 9","Pilot 9: bigger feedback + text",3,"low",-30
"SUPPRF43675",22,73,63,28,-1,76,29,11,"Pilot 9","Pilot 9: bigger feedback + text",3,"low",17
"SUPPRF43675",23,57,69,20,0,55,20,39,"Pilot 9","Pilot 9: bigger feedback + text",3,"low",-19
"SUPPRF43675",24,65,69,66,12,67,54,57,"Pilot 9","Pilot 9: bigger feedback + text",3,"low",9
"SUPPRF43675",25,64,63,70,-1,50,71,18,"Pilot 9","Pilot 9: bigger feedback + text",3,"low",52
"SUPPRF43675",26,68,73,56,-15,34,71,62,"Pilot 9","Pilot 9: bigger feedback + text",3,"low",-6
"SUPPRF43675",27,74,67,58,12,48,46,28,"Pilot 9","Pilot 9: bigger feedback + text",3,"low",30
"SUPPRF43675",28,69,68,61,24,58,37,39,"Pilot 9","Pilot 9: bigger feedback + text",3,"low",22
"SUPPRF43675",29,48,55,8,-12,55,20,23,"Pilot 9","Pilot 9: bigger feedback + text",3,"low",-15
"SUPPRF43675",30,74,72,75,29,57,46,11,"Pilot 9","Pilot 9: bigger feedback + text",3,"low",64
"SUPPRF43675",31,54,65,94,23,58,71,58,"Pilot 9","Pilot 9: bigger feedback + text",3,"low",36
"SUPPRF43675",32,59,72,47,-16,61,63,45,"Pilot 9","Pilot 9: bigger feedback + text",3,"low",2
"SUPPRF43675",33,78,74,96,16,21,80,72,"Pilot 9","Pilot 9: bigger feedback + text",3,"low",24
"SUPPRF43675",34,69,71,35,15,37,20,6,"Pilot 9","Pilot 9: bigger feedback + text",3,"low",29
"SUPPRF43675",35,65,77,77,14,53,63,44,"Pilot 9","Pilot 9: bigger feedback + text",3,"low",33
"SUPPRF43675",36,72,64,49,12,34,37,45,"Pilot 9","Pilot 9: bigger feedback + text",3,"low",4
"SUPPRF43675",37,75,71,80,0,29,80,64,"Pilot 9","Pilot 9: bigger feedback + text",3,"low",16
"SUPPRF43675",38,70,66,55,1,69,54,24,"Pilot 9","Pilot 9: bigger feedback + text",3,"low",31
"SUPPRF43675",39,66,77,46,0,57,46,51,"Pilot 9","Pilot 9: bigger feedback + text",3,"low",-5
"SUPPRF43675",40,73,52,33,-13,64,46,40,"Pilot 9","Pilot 9: bigger feedback + text",3,"low",-7
"SUPPRF43675",41,65,56,19,-1,54,20,4,"Pilot 9","Pilot 9: bigger feedback + text",3,"low",15
"SUPPRF43675",42,60,74,16,-13,53,29,36,"Pilot 9","Pilot 9: bigger feedback + text",3,"low",-20
"SUPPRF43675",43,53,72,41,-13,50,54,24,"Pilot 9","Pilot 9: bigger feedback + text",3,"low",17
"SUPPRF43675",44,74,67,29,0,66,29,50,"Pilot 9","Pilot 9: bigger feedback + text",3,"low",-21
"SUPPRF43675",45,78,79,45,-1,60,46,42,"Pilot 9","Pilot 9: bigger feedback + text",3,"low",3
"SUPPRF43675",46,72,64,55,-16,56,71,30,"Pilot 9","Pilot 9: bigger feedback + text",3,"low",25
"SUPPRF43675",47,74,58,50,-13,71,63,50,"Pilot 9","Pilot 9: bigger feedback + text",3,"low",0
"SUPPRF43675",48,78,46,67,-13,59,80,36,"Pilot 9","Pilot 9: bigger feedback + text",3,"low",31
"SUPPRF43781",1,59,41,19,-1,31,20,25,"Pilot 8","Pilot 8: max feedback + text",5,"low",-6
"SUPPRF43781",2,47,41,47,-16,37,63,68,"Pilot 8","Pilot 8: max feedback + text",5,"low",-21
"SUPPRF43781",3,44,45,50,-13,28,63,60,"Pilot 8","Pilot 8: max feedback + text",5,"low",-10
"SUPPRF43781",4,37,33,8,-12,34,20,26,"Pilot 8","Pilot 8: max feedback + text",5,"low",-18
"SUPPRF43781",5,40,30,45,-1,25,46,41,"Pilot 8","Pilot 8: max feedback + text",5,"low",4
"SUPPRF43781",6,44,36,58,12,30,46,39,"Pilot 8","Pilot 8: max feedback + text",5,"low",19
"SUPPRF43781",7,61,30,61,24,28,37,43,"Pilot 8","Pilot 8: max feedback + text",5,"low",18
"SUPPRF43781",8,77,18,78,24,32,54,59,"Pilot 8","Pilot 8: max feedback + text",5,"low",19
"SUPPRF43781",9,51,38,20,0,27,20,18,"Pilot 8","Pilot 8: max feedback + text",5,"low",2
"SUPPRF43781",10,53,29,35,15,23,20,25,"Pilot 8","Pilot 8: max feedback + text",5,"low",10
"SUPPRF43781",11,89,13,96,16,27,80,65,"Pilot 8","Pilot 8: max feedback + text",5,"low",31
"SUPPRF43781",12,26,67,41,-13,7,54,99,"Pilot 8","Pilot 8: max feedback + text",5,"low",-58
"SUPPRF43781",13,99,14,100,20,22,80,85,"Pilot 8","Pilot 8: max feedback + text",5,"low",15
"SUPPRF43781",14,36,23,16,-13,26,29,24,"Pilot 8","Pilot 8: max feedback + text",5,"low",-8
"SUPPRF43781",15,67,24,88,25,27,63,64,"Pilot 8","Pilot 8: max feedback + text",5,"low",24
"SUPPRF43781",16,31,33,34,-12,18,46,58,"Pilot 8","Pilot 8: max feedback + text",5,"low",-24
"SUPPRF43781",17,62,39,71,0,32,71,61,"Pilot 8","Pilot 8: max feedback + text",5,"low",10
"SUPPRF43781",18,51,33,46,17,29,29,29,"Pilot 8","Pilot 8: max feedback + text",5,"low",17
"SUPPRF43781",19,58,20,77,14,28,63,64,"Pilot 8","Pilot 8: max feedback + text",5,"low",13
"SUPPRF43781",20,42,11,38,1,13,37,43,"Pilot 8","Pilot 8: max feedback + text",5,"low",-5
"SUPPRF43781",21,89,6,70,-1,19,71,69,"Pilot 8","Pilot 8: max feedback + text",5,"low",1
"SUPPRF43781",22,68,9,63,0,21,63,59,"Pilot 8","Pilot 8: max feedback + text",5,"low",4
"SUPPRF43781",23,25,8,38,-16,17,54,53,"Pilot 8","Pilot 8: max feedback + text",5,"low",-15
"SUPPRF43781",24,69,13,94,23,21,71,66,"Pilot 8","Pilot 8: max feedback + text",5,"low",28
"SUPPRF43781",25,65,8,62,-1,9,63,52,"Pilot 8","Pilot 8: max feedback + text",5,"low",10
"SUPPRF43781",26,21,5,22,-15,25,37,39,"Pilot 8","Pilot 8: max feedback + text",5,"low",-17
"SUPPRF43781",27,66,3,83,12,12,71,64,"Pilot 8","Pilot 8: max feedback + text",5,"low",19
"SUPPRF43781",28,29,8,68,-12,23,80,86,"Pilot 8","Pilot 8: max feedback + text",5,"low",-18
"SUPPRF43781",29,68,14,55,1,20,54,49,"Pilot 8","Pilot 8: max feedback + text",5,"low",6
"SUPPRF43781",30,69,2,80,0,17,80,80,"Pilot 8","Pilot 8: max feedback + text",5,"low",0
"SUPPRF43781",31,66,14,46,0,33,46,47,"Pilot 8","Pilot 8: max feedback + text",5,"low",-1
"SUPPRF43781",32,31,6,15,-14,28,29,26,"Pilot 8","Pilot 8: max feedback + text",5,"low",-11
"SUPPRF43781",33,50,12,49,12,26,37,28,"Pilot 8","Pilot 8: max feedback + text",5,"low",21
"SUPPRF43781",34,43,9,28,-1,11,29,32,"Pilot 8","Pilot 8: max feedback + text",5,"low",-4
"SUPPRF43781",35,48,68,47,27,3,20,9,"Pilot 8","Pilot 8: max feedback + text",5,"low",38
"SUPPRF43781",36,50,17,55,-16,25,71,61,"Pilot 8","Pilot 8: max feedback + text",5,"low",-6
"SUPPRF43781",37,59,18,58,29,25,29,31,"Pilot 8","Pilot 8: max feedback + text",5,"low",27
"SUPPRF43781",38,70,7,54,0,22,54,56,"Pilot 8","Pilot 8: max feedback + text",5,"low",-2
"SUPPRF43781",39,50,23,33,-13,17,46,46,"Pilot 8","Pilot 8: max feedback + text",5,"low",-13
"SUPPRF43781",40,50,13,37,0,11,37,30,"Pilot 8","Pilot 8: max feedback + text",5,"low",7
"SUPPRF43781",41,19,24,56,-15,13,71,88,"Pilot 8","Pilot 8: max feedback + text",5,"low",-32
"SUPPRF43781",42,28,13,67,-13,20,80,85,"Pilot 8","Pilot 8: max feedback + text",5,"low",-18
"SUPPRF43781",43,11,8,6,-14,16,20,32,"Pilot 8","Pilot 8: max feedback + text",5,"low",-26
"SUPPRF43781",44,38,15,24,-13,24,37,34,"Pilot 8","Pilot 8: max feedback + text",5,"low",-10
"SUPPRF43781",45,35,21,81,1,18,80,74,"Pilot 8","Pilot 8: max feedback + text",5,"low",7
"SUPPRF43781",46,46,23,75,29,18,46,32,"Pilot 8","Pilot 8: max feedback + text",5,"low",43
"SUPPRF43781",47,67,1,29,0,19,29,31,"Pilot 8","Pilot 8: max feedback + text",5,"low",-2
"SUPPRF43781",48,65,26,66,12,18,54,65,"Pilot 8","Pilot 8: max feedback + text",5,"low",1
"SUPPRF44058",1,69,65,81,1,71,80,19,"Pilot 8","Pilot 8: max feedback + text",11,"high",62
"SUPPRF44058",2,48,50,50,-13,84,63,40,"Pilot 8","Pilot 8: max feedback + text",11,"high",10
"SUPPRF44058",3,48,48,19,-1,39,20,40,"Pilot 8","Pilot 8: max feedback + text",11,"high",-21
"SUPPRF44058",4,68,51,16,-13,65,29,63,"Pilot 8","Pilot 8: max feedback + text",11,"high",-47
"SUPPRF44058",5,49,48,29,0,62,29,60,"Pilot 8","Pilot 8: max feedback + text",11,"high",-31
"SUPPRF44058",6,50,51,78,24,52,54,33,"Pilot 8","Pilot 8: max feedback + text",11,"high",45
"SUPPRF44058",7,50,50,47,-16,83,63,10,"Pilot 8","Pilot 8: max feedback + text",11,"high",37
"SUPPRF44058",8,51,51,66,12,86,54,12,"Pilot 8","Pilot 8: max feedback + text",11,"high",54
"SUPPRF44058",9,50,51,96,16,51,80,50,"Pilot 8","Pilot 8: max feedback + text",11,"high",46
"SUPPRF44058",10,53,54,83,12,20,71,12,"Pilot 8","Pilot 8: max feedback + text",11,"high",71
"SUPPRF44058",11,63,32,94,23,20,71,16,"Pilot 8","Pilot 8: max feedback + text",11,"high",78
"SUPPRF44058",12,52,52,54,0,34,54,17,"Pilot 8","Pilot 8: max feedback + text",11,"high",37
"SUPPRF44058",13,50,54,46,0,36,46,19,"Pilot 8","Pilot 8: max feedback + text",11,"high",27
"SUPPRF44058",14,50,50,33,-13,51,46,51,"Pilot 8","Pilot 8: max feedback + text",11,"high",-18
"SUPPRF44058",15,52,51,55,1,50,54,52,"Pilot 8","Pilot 8: max feedback + text",11,"high",3
"SUPPRF44058",16,51,53,67,-13,49,80,32,"Pilot 8","Pilot 8: max feedback + text",11,"high",35
"SUPPRF44058",17,51,54,45,-1,52,46,53,"Pilot 8","Pilot 8: max feedback + text",11,"high",-8
"SUPPRF44058",18,49,52,38,1,50,37,51,"Pilot 8","Pilot 8: max feedback + text",11,"high",-13
"SUPPRF44058",19,50,52,88,25,51,63,50,"Pilot 8","Pilot 8: max feedback + text",11,"high",38
"SUPPRF44058",20,51,50,46,17,51,29,52,"Pilot 8","Pilot 8: max feedback + text",11,"high",-6
"SUPPRF44058",21,51,52,71,0,29,71,23,"Pilot 8","Pilot 8: max feedback + text",11,"high",48
"SUPPRF44058",22,52,51,77,14,91,63,90,"Pilot 8","Pilot 8: max feedback + text",11,"high",-13
"SUPPRF44058",23,48,51,80,0,52,80,51,"Pilot 8","Pilot 8: max feedback + text",11,"high",29
"SUPPRF44058",24,49,52,62,-1,50,63,34,"Pilot 8","Pilot 8: max feedback + text",11,"high",28
"SUPPRF44058",25,75,43,28,-1,36,29,31,"Pilot 8","Pilot 8: max feedback + text",11,"high",-3
"SUPPRF44058",26,52,49,34,-12,34,46,37,"Pilot 8","Pilot 8: max feedback + text",11,"high",-3
"SUPPRF44058",27,47,49,37,0,51,37,49,"Pilot 8","Pilot 8: max feedback + text",11,"high",-12
"SUPPRF44058",28,46,50,35,15,66,20,65,"Pilot 8","Pilot 8: max feedback + text",11,"high",-30
"SUPPRF44058",29,52,51,63,0,39,63,41,"Pilot 8","Pilot 8: max feedback + text",11,"high",22
"SUPPRF44058",30,50,51,56,-15,50,71,48,"Pilot 8","Pilot 8: max feedback + text",11,"high",8
"SUPPRF44058",31,45,43,15,-14,24,29,24,"Pilot 8","Pilot 8: max feedback + text",11,"high",-9
"SUPPRF44058",32,52,50,100,20,39,80,41,"Pilot 8","Pilot 8: max feedback + text",11,"high",59
"SUPPRF44058",33,52,50,6,-14,49,20,49,"Pilot 8","Pilot 8: max feedback + text",11,"high",-43
"SUPPRF44058",34,47,47,68,-12,51,80,50,"Pilot 8","Pilot 8: max feedback + text",11,"high",18
"SUPPRF44058",35,49,51,70,-1,36,71,39,"Pilot 8","Pilot 8: max feedback + text",11,"high",31
"SUPPRF44058",36,48,50,20,0,30,20,35,"Pilot 8","Pilot 8: max feedback + text",11,"high",-15
"SUPPRF44058",37,47,49,49,12,16,37,19,"Pilot 8","Pilot 8: max feedback + text",11,"high",30
"SUPPRF44058",38,53,53,55,-16,51,71,44,"Pilot 8","Pilot 8: max feedback + text",11,"high",11
"SUPPRF44058",39,52,52,58,12,65,46,66,"Pilot 8","Pilot 8: max feedback + text",11,"high",-8
"SUPPRF44058",40,51,50,75,29,43,46,40,"Pilot 8","Pilot 8: max feedback + text",11,"high",35
"SUPPRF44058",41,51,50,58,29,50,29,50,"Pilot 8","Pilot 8: max feedback + text",11,"high",8
"SUPPRF44058",42,51,51,22,-15,37,37,45,"Pilot 8","Pilot 8: max feedback + text",11,"high",-23
"SUPPRF44058",43,51,52,61,24,51,37,50,"Pilot 8","Pilot 8: max feedback + text",11,"high",11
"SUPPRF44058",44,48,48,38,-16,50,54,50,"Pilot 8","Pilot 8: max feedback + text",11,"high",-12
"SUPPRF44058",45,39,40,8,-12,50,20,49,"Pilot 8","Pilot 8: max feedback + text",11,"high",-41
"SUPPRF44058",46,50,49,24,-13,51,37,49,"Pilot 8","Pilot 8: max feedback + text",11,"high",-25
"SUPPRF44058",47,49,52,47,27,19,20,15,"Pilot 8","Pilot 8: max feedback + text",11,"high",32
"SUPPRF44058",48,45,49,41,-13,51,54,49,"Pilot 8","Pilot 8: max feedback + text",11,"high",-8
"SUPPRF44350",1,62,14,48,19,75,29,40,"Pilot 7","Pilot 7: bigger feedback + text",5,"low",8
"SUPPRF44350",2,61,17,51,14,61,37,36,"Pilot 7","Pilot 7: bigger feedback + text",5,"low",15
"SUPPRF44350",3,57,9,78,15,80,63,75,"Pilot 7","Pilot 7: bigger feedback + text",5,"low",3
"SUPPRF44350",4,54,15,34,-12,71,46,47,"Pilot 7","Pilot 7: bigger feedback + text",5,"low",-13
"SUPPRF44350",5,58,15,6,-14,80,20,29,"Pilot 7","Pilot 7: bigger feedback + text",5,"low",-23
"SUPPRF44350",6,56,14,49,12,55,37,17,"Pilot 7","Pilot 7: bigger feedback + text",5,"low",32
"SUPPRF44350",7,54,14,8,-12,62,20,22,"Pilot 7","Pilot 7: bigger feedback + text",5,"low",-14
"SUPPRF44350",8,57,8,15,-14,74,29,13,"Pilot 7","Pilot 7: bigger feedback + text",5,"low",2
"SUPPRF44350",9,57,7,46,17,39,29,28,"Pilot 7","Pilot 7: bigger feedback + text",5,"low",18
"SUPPRF44350",10,57,12,41,-13,60,54,65,"Pilot 7","Pilot 7: bigger feedback + text",5,"low",-24
"SUPPRF44350",11,51,14,54,0,45,54,48,"Pilot 7","Pilot 7: bigger feedback + text",5,"low",6
"SUPPRF44350",12,55,11,62,-1,48,63,68,"Pilot 7","Pilot 7: bigger feedback + text",5,"low",-6
"SUPPRF44350",13,60,11,55,-16,69,71,76,"Pilot 7","Pilot 7: bigger feedback + text",5,"low",-21
"SUPPRF44350",14,53,7,46,0,79,46,33,"Pilot 7","Pilot 7: bigger feedback + text",5,"low",13
"SUPPRF44350",15,56,8,65,19,22,46,45,"Pilot 7","Pilot 7: bigger feedback + text",5,"low",20
"SUPPRF44350",16,56,8,45,-1,89,46,12,"Pilot 7","Pilot 7: bigger feedback + text",5,"low",33
"SUPPRF44350",17,51,8,67,-13,37,80,76,"Pilot 7","Pilot 7: bigger feedback + text",5,"low",-9
"SUPPRF44350",18,58,13,22,-15,40,37,30,"Pilot 7","Pilot 7: bigger feedback + text",5,"low",-8
"SUPPRF44350",19,50,15,55,1,63,54,56,"Pilot 7","Pilot 7: bigger feedback + text",5,"low",-1
"SUPPRF44350",20,59,5,38,-16,76,54,41,"Pilot 7","Pilot 7: bigger feedback + text",5,"low",-3
"SUPPRF44350",21,55,11,50,-13,48,63,60,"Pilot 7","Pilot 7: bigger feedback + text",5,"low",-10
"SUPPRF44350",22,52,12,70,-1,40,71,68,"Pilot 7","Pilot 7: bigger feedback + text",5,"low",2
"SUPPRF44350",23,50,20,24,-13,60,37,40,"Pilot 7","Pilot 7: bigger feedback + text",5,"low",-16
"SUPPRF44350",24,62,12,37,17,25,20,19,"Pilot 7","Pilot 7: bigger feedback + text",5,"low",18
"SUPPRF44350",25,62,6,20,0,71,20,18,"Pilot 7","Pilot 7: bigger feedback + text",5,"low",2
"SUPPRF44350",26,56,61,68,14,73,54,52,"Pilot 7","Pilot 7: bigger feedback + text",5,"low",16
"SUPPRF44350",27,52,10,81,1,62,80,78,"Pilot 7","Pilot 7: bigger feedback + text",5,"low",3
"SUPPRF44350",28,59,17,29,0,20,29,20,"Pilot 7","Pilot 7: bigger feedback + text",5,"low",9
"SUPPRF44350",29,57,11,58,12,65,46,40,"Pilot 7","Pilot 7: bigger feedback + text",5,"low",18
"SUPPRF44350",30,62,9,28,-1,39,29,25,"Pilot 7","Pilot 7: bigger feedback + text",5,"low",3
"SUPPRF44350",31,64,8,80,0,61,80,82,"Pilot 7","Pilot 7: bigger feedback + text",5,"low",-2
"SUPPRF44350",32,61,10,38,1,73,37,21,"Pilot 7","Pilot 7: bigger feedback + text",5,"low",17
"SUPPRF44350",33,60,12,71,0,46,71,69,"Pilot 7","Pilot 7: bigger feedback + text",5,"low",2
"SUPPRF44350",34,60,9,56,-15,68,71,59,"Pilot 7","Pilot 7: bigger feedback + text",5,"low",-3
"SUPPRF44350",35,74,10,37,0,67,37,37,"Pilot 7","Pilot 7: bigger feedback + text",5,"low",0
"SUPPRF44350",36,57,58,66,12,32,54,61,"Pilot 7","Pilot 7: bigger feedback + text",5,"low",5
"SUPPRF44350",37,56,61,84,13,47,71,73,"Pilot 7","Pilot 7: bigger feedback + text",5,"low",11
"SUPPRF44350",38,55,11,63,0,31,63,58,"Pilot 7","Pilot 7: bigger feedback + text",5,"low",5
"SUPPRF44350",39,58,9,77,14,52,63,63,"Pilot 7","Pilot 7: bigger feedback + text",5,"low",14
"SUPPRF44350",40,69,14,96,16,69,80,74,"Pilot 7","Pilot 7: bigger feedback + text",5,"low",22
"SUPPRF44350",41,60,19,47,-16,70,63,65,"Pilot 7","Pilot 7: bigger feedback + text",5,"low",-18
"SUPPRF44350",42,43,21,83,12,7,71,55,"Pilot 7","Pilot 7: bigger feedback + text",5,"low",28
"SUPPRF44350",43,50,21,68,-12,68,80,84,"Pilot 7","Pilot 7: bigger feedback + text",5,"low",-16
"SUPPRF44350",44,54,10,16,-13,23,29,34,"Pilot 7","Pilot 7: bigger feedback + text",5,"low",-18
"SUPPRF44350",45,57,15,33,-13,0,46,32,"Pilot 7","Pilot 7: bigger feedback + text",5,"low",1
"SUPPRF44350",46,53,16,19,-1,76,20,27,"Pilot 7","Pilot 7: bigger feedback + text",5,"low",-8
"SUPPRF44350",47,54,15,35,15,62,20,25,"Pilot 7","Pilot 7: bigger feedback + text",5,"low",10
"SUPPRF44350",48,65,10,97,17,83,80,88,"Pilot 7","Pilot 7: bigger feedback + text",5,"low",9
"SUPPRF45081",1,36,35,8,-12,59,20,22,"Pilot 7","Pilot 7: bigger feedback + text",8,"high",-14
"SUPPRF45081",2,41,34,56,-15,5,71,4,"Pilot 7","Pilot 7: bigger feedback + text",8,"high",52
"SUPPRF45081",3,54,38,24,-13,57,37,30,"Pilot 7","Pilot 7: bigger feedback + text",8,"high",-6
"SUPPRF45081",4,30,33,6,-14,23,20,16,"Pilot 7","Pilot 7: bigger feedback + text",8,"high",-10
"SUPPRF45081",5,48,27,54,0,46,54,46,"Pilot 7","Pilot 7: bigger feedback + text",8,"high",8
"SUPPRF45081",6,36,28,38,1,33,37,26,"Pilot 7","Pilot 7: bigger feedback + text",8,"high",12
"SUPPRF45081",7,38,18,45,-1,25,46,30,"Pilot 7","Pilot 7: bigger feedback + text",8,"high",15
"SUPPRF45081",8,35,23,33,-13,40,46,39,"Pilot 7","Pilot 7: bigger feedback + text",8,"high",-6
"SUPPRF45081",9,43,20,38,-16,45,54,48,"Pilot 7","Pilot 7: bigger feedback + text",8,"high",-10
"SUPPRF45081",10,44,16,65,19,47,46,41,"Pilot 7","Pilot 7: bigger feedback + text",8,"high",24
"SUPPRF45081",11,52,20,28,-1,53,29,12,"Pilot 7","Pilot 7: bigger feedback + text",8,"high",16
"SUPPRF45081",12,53,16,84,13,28,71,54,"Pilot 7","Pilot 7: bigger feedback + text",8,"high",30
"SUPPRF45081",13,43,17,55,1,25,54,48,"Pilot 7","Pilot 7: bigger feedback + text",8,"high",7
"SUPPRF45081",14,49,13,97,17,22,80,54,"Pilot 7","Pilot 7: bigger feedback + text",8,"high",43
"SUPPRF45081",15,49,22,62,-1,28,63,55,"Pilot 7","Pilot 7: bigger feedback + text",8,"high",7
"SUPPRF45081",16,48,18,71,0,56,71,59,"Pilot 7","Pilot 7: bigger feedback + text",8,"high",12
"SUPPRF45081",17,44,21,29,0,48,29,10,"Pilot 7","Pilot 7: bigger feedback + text",8,"high",19
"SUPPRF45081",18,35,16,46,17,46,29,14,"Pilot 7","Pilot 7: bigger feedback + text",8,"high",32
"SUPPRF45081",19,48,7,46,0,24,46,46,"Pilot 7","Pilot 7: bigger feedback + text",8,"high",0
"SUPPRF45081",20,42,22,19,-1,8,20,16,"Pilot 7","Pilot 7: bigger feedback + text",8,"high",3
"SUPPRF45081",21,35,9,67,-13,48,80,70,"Pilot 7","Pilot 7: bigger feedback + text",8,"high",-3
"SUPPRF45081",22,49,8,50,-13,25,63,51,"Pilot 7","Pilot 7: bigger feedback + text",8,"high",-1
"SUPPRF45081",23,54,15,47,-16,29,63,49,"Pilot 7","Pilot 7: bigger feedback + text",8,"high",-2
"SUPPRF45081",24,27,4,37,0,7,37,24,"Pilot 7","Pilot 7: bigger feedback + text",8,"high",13
"SUPPRF45081",25,18,5,16,-13,53,29,14,"Pilot 7","Pilot 7: bigger feedback + text",8,"high",2
"SUPPRF45081",26,23,7,70,-1,15,71,50,"Pilot 7","Pilot 7: bigger feedback + text",8,"high",20
"SUPPRF45081",27,11,6,63,0,14,63,46,"Pilot 7","Pilot 7: bigger feedback + text",8,"high",17
"SUPPRF45081",28,16,8,96,16,38,80,68,"Pilot 7","Pilot 7: bigger feedback + text",8,"high",28
"SUPPRF45081",29,13,3,51,14,25,37,45,"Pilot 7","Pilot 7: bigger feedback + text",8,"high",6
"SUPPRF45081",30,12,4,48,19,31,29,12,"Pilot 7","Pilot 7: bigger feedback + text",8,"high",36
"SUPPRF45081",31,10,3,49,12,35,37,32,"Pilot 7","Pilot 7: bigger feedback + text",8,"high",17
"SUPPRF45081",32,12,3,66,12,39,54,53,"Pilot 7","Pilot 7: bigger feedback + text",8,"high",13
"SUPPRF45081",33,11,1,15,-14,22,29,23,"Pilot 7","Pilot 7: bigger feedback + text",8,"high",-8
"SUPPRF45081",34,10,1,35,15,27,20,12,"Pilot 7","Pilot 7: bigger feedback + text",8,"high",23
"SUPPRF45081",35,10,1,83,12,45,71,65,"Pilot 7","Pilot 7: bigger feedback + text",8,"high",18
"SUPPRF45081",36,5,0,41,-13,31,54,48,"Pilot 7","Pilot 7: bigger feedback + text",8,"high",-7
"SUPPRF45081",37,4,2,22,-15,6,37,31,"Pilot 7","Pilot 7: bigger feedback + text",8,"high",-9
"SUPPRF45081",38,7,1,20,0,26,20,10,"Pilot 7","Pilot 7: bigger feedback + text",8,"high",10
"SUPPRF45081",39,9,0,81,1,39,80,76,"Pilot 7","Pilot 7: bigger feedback + text",8,"high",5
"SUPPRF45081",40,13,1,80,0,41,80,70,"Pilot 7","Pilot 7: bigger feedback + text",8,"high",10
"SUPPRF45081",41,14,0,78,15,13,63,41,"Pilot 7","Pilot 7: bigger feedback + text",8,"high",37
"SUPPRF45081",42,11,1,77,14,27,63,55,"Pilot 7","Pilot 7: bigger feedback + text",8,"high",22
"SUPPRF45081",43,8,1,58,12,14,46,32,"Pilot 7","Pilot 7: bigger feedback + text",8,"high",26
"SUPPRF45081",44,11,3,37,17,30,20,11,"Pilot 7","Pilot 7: bigger feedback + text",8,"high",26
"SUPPRF45081",45,11,1,68,-12,46,80,70,"Pilot 7","Pilot 7: bigger feedback + text",8,"high",-2
"SUPPRF45081",46,7,1,55,-16,23,71,53,"Pilot 7","Pilot 7: bigger feedback + text",8,"high",2
"SUPPRF45081",47,6,1,34,-12,20,46,47,"Pilot 7","Pilot 7: bigger feedback + text",8,"high",-13
"SUPPRF45081",48,7,1,68,14,25,54,48,"Pilot 7","Pilot 7: bigger feedback + text",8,"high",20
"SUPPRF45424",1,76,20,8,-12,83,20,24,"Pilot 10","Pilot 10: bigger feedback + video",7,"high",-16
"SUPPRF45424",2,83,14,70,-1,89,71,84,"Pilot 10","Pilot 10: bigger feedback + video",7,"high",-14
"SUPPRF45424",3,86,15,19,-1,89,20,23,"Pilot 10","Pilot 10: bigger feedback + video",7,"high",-4
"SUPPRF45424",4,90,6,58,12,85,46,42,"Pilot 10","Pilot 10: bigger feedback + video",7,"high",16
"SUPPRF45424",5,87,16,47,27,88,20,23,"Pilot 10","Pilot 10: bigger feedback + video",7,"high",24
"SUPPRF45424",6,80,11,62,-1,71,63,77,"Pilot 10","Pilot 10: bigger feedback + video",7,"high",-15
"SUPPRF45424",7,87,8,71,0,69,71,81,"Pilot 10","Pilot 10: bigger feedback + video",7,"high",-10
"SUPPRF45424",8,90,7,20,0,91,20,16,"Pilot 10","Pilot 10: bigger feedback + video",7,"high",4
"SUPPRF45424",9,38,6,16,-13,85,29,35,"Pilot 10","Pilot 10: bigger feedback + video",7,"high",-19
"SUPPRF45424",10,74,18,46,17,28,29,32,"Pilot 10","Pilot 10: bigger feedback + video",7,"high",14
"SUPPRF45424",11,81,11,88,25,86,63,76,"Pilot 10","Pilot 10: bigger feedback + video",7,"high",12
"SUPPRF45424",12,75,18,34,-12,68,46,77,"Pilot 10","Pilot 10: bigger feedback + video",7,"high",-43
"SUPPRF45424",13,79,16,56,-15,16,71,84,"Pilot 10","Pilot 10: bigger feedback + video",7,"high",-28
"SUPPRF45424",14,41,30,75,29,84,46,42,"Pilot 10","Pilot 10: bigger feedback + video",7,"high",33
"SUPPRF45424",15,82,15,55,-16,76,71,80,"Pilot 10","Pilot 10: bigger feedback + video",7,"high",-25
"SUPPRF45424",16,73,17,63,0,64,63,53,"Pilot 10","Pilot 10: bigger feedback + video",7,"high",10
"SUPPRF45424",17,85,9,38,-16,69,54,40,"Pilot 10","Pilot 10: bigger feedback + video",7,"high",-2
"SUPPRF45424",18,72,26,66,12,62,54,43,"Pilot 10","Pilot 10: bigger feedback + video",7,"high",23
"SUPPRF45424",19,69,27,83,12,41,71,85,"Pilot 10","Pilot 10: bigger feedback + video",7,"high",-2
"SUPPRF45424",20,77,16,100,20,62,80,91,"Pilot 10","Pilot 10: bigger feedback + video",7,"high",9
"SUPPRF45424",21,75,18,58,29,56,29,19,"Pilot 10","Pilot 10: bigger feedback + video",7,"high",39
"SUPPRF45424",22,89,8,80,0,79,80,90,"Pilot 10","Pilot 10: bigger feedback + video",7,"high",-10
"SUPPRF45424",23,77,15,45,-1,16,46,85,"Pilot 10","Pilot 10: bigger feedback + video",7,"high",-40
"SUPPRF45424",24,89,10,38,1,77,37,39,"Pilot 10","Pilot 10: bigger feedback + video",7,"high",-1
"SUPPRF45424",25,75,27,41,-13,67,54,41,"Pilot 10","Pilot 10: bigger feedback + video",7,"high",0
"SUPPRF45424",26,73,24,68,-12,70,80,32,"Pilot 10","Pilot 10: bigger feedback + video",7,"high",36
"SUPPRF45424",27,82,14,81,1,82,80,88,"Pilot 10","Pilot 10: bigger feedback + video",7,"high",-7
"SUPPRF45424",28,77,20,24,-13,79,37,17,"Pilot 10","Pilot 10: bigger feedback + video",7,"high",7
"SUPPRF45424",29,73,17,15,-14,73,29,41,"Pilot 10","Pilot 10: bigger feedback + video",7,"high",-26
"SUPPRF45424",30,61,26,55,1,56,54,39,"Pilot 10","Pilot 10: bigger feedback + video",7,"high",16
"SUPPRF45424",31,80,22,46,0,68,46,36,"Pilot 10","Pilot 10: bigger feedback + video",7,"high",10
"SUPPRF45424",32,68,17,96,16,81,80,81,"Pilot 10","Pilot 10: bigger feedback + video",7,"high",15
"SUPPRF45424",33,76,28,37,0,60,37,46,"Pilot 10","Pilot 10: bigger feedback + video",7,"high",-9
"SUPPRF45424",34,70,32,54,0,50,54,32,"Pilot 10","Pilot 10: bigger feedback + video",7,"high",22
"SUPPRF45424",35,77,21,47,-16,73,63,54,"Pilot 10","Pilot 10: bigger feedback + video",7,"high",-7
"SUPPRF45424",36,81,18,49,12,78,37,40,"Pilot 10","Pilot 10: bigger feedback + video",7,"high",9
"SUPPRF45424",37,78,23,78,24,80,54,49,"Pilot 10","Pilot 10: bigger feedback + video",7,"high",29
"SUPPRF45424",38,69,32,50,-13,77,63,71,"Pilot 10","Pilot 10: bigger feedback + video",7,"high",-21
"SUPPRF45424",39,82,13,67,-13,83,80,79,"Pilot 10","Pilot 10: bigger feedback + video",7,"high",-12
"SUPPRF45424",40,27,25,29,0,84,29,77,"Pilot 10","Pilot 10: bigger feedback + video",7,"high",-48
"SUPPRF45424",41,77,23,22,-15,45,37,44,"Pilot 10","Pilot 10: bigger feedback + video",7,"high",-22
"SUPPRF45424",42,87,17,77,14,48,63,61,"Pilot 10","Pilot 10: bigger feedback + video",7,"high",16
"SUPPRF45424",43,74,29,35,15,39,20,63,"Pilot 10","Pilot 10: bigger feedback + video",7,"high",-28
"SUPPRF45424",44,91,11,6,-14,76,20,10,"Pilot 10","Pilot 10: bigger feedback + video",7,"high",-4
"SUPPRF45424",45,86,12,28,-1,93,29,34,"Pilot 10","Pilot 10: bigger feedback + video",7,"high",-6
"SUPPRF45424",46,74,28,61,24,80,37,39,"Pilot 10","Pilot 10: bigger feedback + video",7,"high",22
"SUPPRF45424",47,80,8,94,23,86,71,83,"Pilot 10","Pilot 10: bigger feedback + video",7,"high",11
"SUPPRF45424",48,67,17,33,-13,43,46,56,"Pilot 10","Pilot 10: bigger feedback + video",7,"high",-23
"SUPPRF45704",1,51,55,22,-15,51,37,36,"Pilot 10","Pilot 10: bigger feedback + video",4,"low",-14
"SUPPRF45704",2,47,51,47,-16,50,63,62,"Pilot 10","Pilot 10: bigger feedback + video",4,"low",-15
"SUPPRF45704",3,48,47,19,-1,47,20,18,"Pilot 10","Pilot 10: bigger feedback + video",4,"low",1
"SUPPRF45704",4,52,37,62,-1,45,63,33,"Pilot 10","Pilot 10: bigger feedback + video",4,"low",29
"SUPPRF45704",5,56,36,46,17,49,29,54,"Pilot 10","Pilot 10: bigger feedback + video",4,"low",-8
"SUPPRF45704",6,60,31,58,29,48,29,27,"Pilot 10","Pilot 10: bigger feedback + video",4,"low",31
"SUPPRF45704",7,59,31,41,-13,52,54,59,"Pilot 10","Pilot 10: bigger feedback + video",4,"low",-18
"SUPPRF45704",8,62,34,49,12,48,37,49,"Pilot 10","Pilot 10: bigger feedback + video",4,"low",0
"SUPPRF45704",9,57,40,20,0,13,20,63,"Pilot 10","Pilot 10: bigger feedback + video",4,"low",-43
"SUPPRF45704",10,48,48,67,-13,51,80,49,"Pilot 10","Pilot 10: bigger feedback + video",4,"low",18
"SUPPRF45704",11,48,52,78,24,49,54,51,"Pilot 10","Pilot 10: bigger feedback + video",4,"low",27
"SUPPRF45704",12,99,0,70,-1,52,71,55,"Pilot 10","Pilot 10: bigger feedback + video",4,"low",15
"SUPPRF45704",13,60,32,54,0,55,54,51,"Pilot 10","Pilot 10: bigger feedback + video",4,"low",3
"SUPPRF45704",14,80,17,38,-16,72,54,47,"Pilot 10","Pilot 10: bigger feedback + video",4,"low",-9
"SUPPRF45704",15,73,26,55,1,66,54,55,"Pilot 10","Pilot 10: bigger feedback + video",4,"low",0
"SUPPRF45704",16,69,22,77,14,52,63,55,"Pilot 10","Pilot 10: bigger feedback + video",4,"low",22
"SUPPRF45704",17,67,21,71,0,75,71,26,"Pilot 10","Pilot 10: bigger feedback + video",4,"low",45
"SUPPRF45704",18,77,0,75,29,81,46,41,"Pilot 10","Pilot 10: bigger feedback + video",4,"low",34
"SUPPRF45704",19,70,3,50,-13,83,63,41,"Pilot 10","Pilot 10: bigger feedback + video",4,"low",9
"SUPPRF45704",20,51,2,33,-13,86,46,45,"Pilot 10","Pilot 10: bigger feedback + video",4,"low",-12
"SUPPRF45704",21,53,11,24,-13,47,37,25,"Pilot 10","Pilot 10: bigger feedback + video",4,"low",-1
"SUPPRF45704",22,44,3,15,-14,79,29,6,"Pilot 10","Pilot 10: bigger feedback + video",4,"low",9
"SUPPRF45704",23,73,22,81,1,80,80,78,"Pilot 10","Pilot 10: bigger feedback + video",4,"low",3
"SUPPRF45704",24,47,7,37,0,70,37,38,"Pilot 10","Pilot 10: bigger feedback + video",4,"low",-1
"SUPPRF45704",25,49,2,29,0,45,29,50,"Pilot 10","Pilot 10: bigger feedback + video",4,"low",-21
"SUPPRF45704",26,57,34,66,12,48,54,48,"Pilot 10","Pilot 10: bigger feedback + video",4,"low",18
"SUPPRF45704",27,51,49,38,1,45,37,34,"Pilot 10","Pilot 10: bigger feedback + video",4,"low",4
"SUPPRF45704",28,48,14,83,12,68,71,66,"Pilot 10","Pilot 10: bigger feedback + video",4,"low",17
"SUPPRF45704",29,60,23,34,-12,48,46,37,"Pilot 10","Pilot 10: bigger feedback + video",4,"low",-3
"SUPPRF45704",30,58,30,94,23,74,71,70,"Pilot 10","Pilot 10: bigger feedback + video",4,"low",24
"SUPPRF45704",31,65,29,68,-12,65,80,67,"Pilot 10","Pilot 10: bigger feedback + video",4,"low",1
"SUPPRF45704",32,52,23,45,-1,56,46,69,"Pilot 10","Pilot 10: bigger feedback + video",4,"low",-24
"SUPPRF45704",33,52,25,55,-16,80,71,75,"Pilot 10","Pilot 10: bigger feedback + video",4,"low",-20
"SUPPRF45704",34,63,28,100,20,77,80,70,"Pilot 10","Pilot 10: bigger feedback + video",4,"low",30
"SUPPRF45704",35,51,44,46,0,62,46,64,"Pilot 10","Pilot 10: bigger feedback + video",4,"low",-18
"SUPPRF45704",36,27,37,6,-14,54,20,37,"Pilot 10","Pilot 10: bigger feedback + video",4,"low",-31
"SUPPRF45704",37,5,32,58,12,52,46,15,"Pilot 10","Pilot 10: bigger feedback + video",4,"low",43
"SUPPRF45704",38,2,45,96,16,45,80,46,"Pilot 10","Pilot 10: bigger feedback + video",4,"low",50
"SUPPRF45704",39,69,37,35,15,51,20,51,"Pilot 10","Pilot 10: bigger feedback + video",4,"low",-16
"SUPPRF45704",40,50,49,88,25,49,63,51,"Pilot 10","Pilot 10: bigger feedback + video",4,"low",37
"SUPPRF45704",41,49,51,61,24,53,37,65,"Pilot 10","Pilot 10: bigger feedback + video",4,"low",-4
"SUPPRF45704",42,51,52,47,27,48,20,53,"Pilot 10","Pilot 10: bigger feedback + video",4,"low",-6
"SUPPRF45704",43,47,38,28,-1,48,29,49,"Pilot 10","Pilot 10: bigger feedback + video",4,"low",-21
"SUPPRF45704",44,43,33,16,-13,29,29,29,"Pilot 10","Pilot 10: bigger feedback + video",4,"low",-13
"SUPPRF45704",45,50,47,8,-12,44,20,45,"Pilot 10","Pilot 10: bigger feedback + video",4,"low",-37
"SUPPRF45704",46,41,53,56,-15,49,71,52,"Pilot 10","Pilot 10: bigger feedback + video",4,"low",4
"SUPPRF45704",47,50,49,63,0,48,63,51,"Pilot 10","Pilot 10: bigger feedback + video",4,"low",12
"SUPPRF45704",48,44,41,80,0,51,80,44,"Pilot 10","Pilot 10: bigger feedback + video",4,"low",36
"SUPPRF46237",1,58,52,55,-16,71,71,44,"Pilot 7","Pilot 7: bigger feedback + text",7,"high",11
"SUPPRF46237",2,47,43,83,12,72,71,31,"Pilot 7","Pilot 7: bigger feedback + text",7,"high",52
"SUPPRF46237",3,52,46,78,15,61,63,51,"Pilot 7","Pilot 7: bigger feedback + text",7,"high",27
"SUPPRF46237",4,44,40,16,-13,74,29,24,"Pilot 7","Pilot 7: bigger feedback + text",7,"high",-8
"SUPPRF46237",5,56,35,48,19,53,29,43,"Pilot 7","Pilot 7: bigger feedback + text",7,"high",5
"SUPPRF46237",6,50,34,15,-14,59,29,48,"Pilot 7","Pilot 7: bigger feedback + text",7,"high",-33
"SUPPRF46237",7,54,37,6,-14,59,20,45,"Pilot 7","Pilot 7: bigger feedback + text",7,"high",-39
"SUPPRF46237",8,59,33,58,12,54,46,38,"Pilot 7","Pilot 7: bigger feedback + text",7,"high",20
"SUPPRF46237",9,55,31,19,-1,53,20,39,"Pilot 7","Pilot 7: bigger feedback + text",7,"high",-20
"SUPPRF46237",10,59,33,45,-1,64,46,32,"Pilot 7","Pilot 7: bigger feedback + text",7,"high",13
"SUPPRF46237",11,62,33,68,14,62,54,59,"Pilot 7","Pilot 7: bigger feedback + text",7,"high",9
"SUPPRF46237",12,60,32,80,0,70,80,71,"Pilot 7","Pilot 7: bigger feedback + text",7,"high",9
"SUPPRF46237",13,62,24,49,12,73,37,33,"Pilot 7","Pilot 7: bigger feedback + text",7,"high",16
"SUPPRF46237",14,70,35,38,1,80,37,39,"Pilot 7","Pilot 7: bigger feedback + text",7,"high",-1
"SUPPRF46237",15,53,27,22,-15,76,37,42,"Pilot 7","Pilot 7: bigger feedback + text",7,"high",-20
"SUPPRF46237",16,68,32,97,17,74,80,79,"Pilot 7","Pilot 7: bigger feedback + text",7,"high",18
"SUPPRF46237",17,58,22,29,0,67,29,42,"Pilot 7","Pilot 7: bigger feedback + text",7,"high",-13
"SUPPRF46237",18,63,20,46,0,80,46,37,"Pilot 7","Pilot 7: bigger feedback + text",7,"high",9
"SUPPRF46237",19,71,24,65,19,76,46,47,"Pilot 7","Pilot 7: bigger feedback + text",7,"high",18
"SUPPRF46237",20,69,29,47,-16,54,63,49,"Pilot 7","Pilot 7: bigger feedback + text",7,"high",-2
"SUPPRF46237",21,64,19,77,14,70,63,60,"Pilot 7","Pilot 7: bigger feedback + text",7,"high",17
"SUPPRF46237",22,66,19,24,-13,73,37,38,"Pilot 7","Pilot 7: bigger feedback + text",7,"high",-14
"SUPPRF46237",23,67,19,34,-12,75,46,39,"Pilot 7","Pilot 7: bigger feedback + text",7,"high",-5
"SUPPRF46237",24,75,14,81,1,78,80,85,"Pilot 7","Pilot 7: bigger feedback + text",7,"high",-4
"SUPPRF46237",25,67,22,41,-13,70,54,53,"Pilot 7","Pilot 7: bigger feedback + text",7,"high",-12
"SUPPRF46237",26,64,21,56,-15,77,71,63,"Pilot 7","Pilot 7: bigger feedback + text",7,"high",-7
"SUPPRF46237",27,65,24,37,0,62,37,47,"Pilot 7","Pilot 7: bigger feedback + text",7,"high",-10
"SUPPRF46237",28,66,27,20,0,74,20,27,"Pilot 7","Pilot 7: bigger feedback + text",7,"high",-7
"SUPPRF46237",29,68,21,96,16,83,80,81,"Pilot 7","Pilot 7: bigger feedback + text",7,"high",15
"SUPPRF46237",30,62,18,71,0,74,71,70,"Pilot 7","Pilot 7: bigger feedback + text",7,"high",1
"SUPPRF46237",31,68,24,50,-13,67,63,55,"Pilot 7","Pilot 7: bigger feedback + text",7,"high",-5
"SUPPRF46237",32,64,23,70,-1,68,71,72,"Pilot 7","Pilot 7: bigger feedback + text",7,"high",-2
"SUPPRF46237",33,63,29,46,17,75,29,24,"Pilot 7","Pilot 7: bigger feedback + text",7,"high",22
"SUPPRF46237",34,54,34,37,17,78,20,20,"Pilot 7","Pilot 7: bigger feedback + text",7,"high",17
"SUPPRF46237",35,48,40,28,-1,61,29,37,"Pilot 7","Pilot 7: bigger feedback + text",7,"high",-9
"SUPPRF46237",36,53,40,67,-13,89,80,85,"Pilot 7","Pilot 7: bigger feedback + text",7,"high",-18
"SUPPRF46237",37,53,40,33,-13,74,46,48,"Pilot 7","Pilot 7: bigger feedback + text",7,"high",-15
"SUPPRF46237",38,53,38,38,-16,81,54,44,"Pilot 7","Pilot 7: bigger feedback + text",7,"high",-6
"SUPPRF46237",39,55,43,8,-12,48,20,52,"Pilot 7","Pilot 7: bigger feedback + text",7,"high",-44
"SUPPRF46237",40,41,50,55,1,26,54,19,"Pilot 7","Pilot 7: bigger feedback + text",7,"high",36
"SUPPRF46237",41,49,45,54,0,75,54,54,"Pilot 7","Pilot 7: bigger feedback + text",7,"high",0
"SUPPRF46237",42,45,47,84,13,61,71,60,"Pilot 7","Pilot 7: bigger feedback + text",7,"high",24
"SUPPRF46237",43,48,38,68,-12,79,80,86,"Pilot 7","Pilot 7: bigger feedback + text",7,"high",-18
"SUPPRF46237",44,42,44,66,12,74,54,51,"Pilot 7","Pilot 7: bigger feedback + text",7,"high",15
"SUPPRF46237",45,45,44,51,14,65,37,48,"Pilot 7","Pilot 7: bigger feedback + text",7,"high",3
"SUPPRF46237",46,33,44,35,15,77,20,14,"Pilot 7","Pilot 7: bigger feedback + text",7,"high",21
"SUPPRF46237",47,30,52,63,0,49,63,19,"Pilot 7","Pilot 7: bigger feedback + text",7,"high",44
"SUPPRF46237",48,11,41,62,-1,69,63,56,"Pilot 7","Pilot 7: bigger feedback + text",7,"high",6
"SUPPRF47214",1,15,87,37,0,1,37,42,"Pilot 11","Pilot 11: bigger feedback + video + socially anxious",8,"high",-5
"SUPPRF47214",2,37,89,38,-16,1,54,40,"Pilot 11","Pilot 11: bigger feedback + video + socially anxious",8,"high",-2
"SUPPRF47214",3,62,89,63,0,1,63,63,"Pilot 11","Pilot 11: bigger feedback + video + socially anxious",8,"high",0
"SUPPRF47214",4,50,96,55,-16,0,71,69,"Pilot 11","Pilot 11: bigger feedback + video + socially anxious",8,"high",-14
"SUPPRF47214",5,38,96,50,-13,0,63,86,"Pilot 11","Pilot 11: bigger feedback + video + socially anxious",8,"high",-36
"SUPPRF47214",6,28,91,47,-16,1,63,44,"Pilot 11","Pilot 11: bigger feedback + video + socially anxious",8,"high",3
"SUPPRF47214",7,45,95,66,12,1,54,41,"Pilot 11","Pilot 11: bigger feedback + video + socially anxious",8,"high",25
"SUPPRF47214",8,44,94,58,12,5,46,44,"Pilot 11","Pilot 11: bigger feedback + video + socially anxious",8,"high",14
"SUPPRF47214",9,50,96,78,24,2,54,49,"Pilot 11","Pilot 11: bigger feedback + video + socially anxious",8,"high",29
"SUPPRF47214",10,35,96,46,0,1,46,45,"Pilot 11","Pilot 11: bigger feedback + video + socially anxious",8,"high",1
"SUPPRF47214",11,22,95,22,-15,2,37,38,"Pilot 11","Pilot 11: bigger feedback + video + socially anxious",8,"high",-16
"SUPPRF47214",12,61,96,100,20,2,80,37,"Pilot 11","Pilot 11: bigger feedback + video + socially anxious",8,"high",63
"SUPPRF47214",13,50,77,58,29,2,29,26,"Pilot 11","Pilot 11: bigger feedback + video + socially anxious",8,"high",32
"SUPPRF47214",14,40,91,33,-13,3,46,26,"Pilot 11","Pilot 11: bigger feedback + video + socially anxious",8,"high",7
"SUPPRF47214",15,42,84,15,-14,6,29,23,"Pilot 11","Pilot 11: bigger feedback + video + socially anxious",8,"high",-8
"SUPPRF47214",16,41,85,83,12,4,71,24,"Pilot 11","Pilot 11: bigger feedback + video + socially anxious",8,"high",59
"SUPPRF47214",17,47,79,81,1,4,80,40,"Pilot 11","Pilot 11: bigger feedback + video + socially anxious",8,"high",41
"SUPPRF47214",18,47,95,8,-12,3,20,5,"Pilot 11","Pilot 11: bigger feedback + video + socially anxious",8,"high",3
"SUPPRF47214",19,41,76,45,-1,4,46,24,"Pilot 11","Pilot 11: bigger feedback + video + socially anxious",8,"high",21
"SUPPRF47214",20,57,85,80,0,3,80,24,"Pilot 11","Pilot 11: bigger feedback + video + socially anxious",8,"high",56
"SUPPRF47214",21,54,82,41,-13,4,54,23,"Pilot 11","Pilot 11: bigger feedback + video + socially anxious",8,"high",18
"SUPPRF47214",22,57,83,61,24,6,37,21,"Pilot 11","Pilot 11: bigger feedback + video + socially anxious",8,"high",40
"SUPPRF47214",23,64,87,47,27,0,20,8,"Pilot 11","Pilot 11: bigger feedback + video + socially anxious",8,"high",39
"SUPPRF47214",24,47,82,38,1,6,37,41,"Pilot 11","Pilot 11: bigger feedback + video + socially anxious",8,"high",-3
"SUPPRF47214",25,50,82,24,-13,6,37,31,"Pilot 11","Pilot 11: bigger feedback + video + socially anxious",8,"high",-7
"SUPPRF47214",26,53,88,88,25,2,63,23,"Pilot 11","Pilot 11: bigger feedback + video + socially anxious",8,"high",65
"SUPPRF47214",27,50,81,71,0,5,71,21,"Pilot 11","Pilot 11: bigger feedback + video + socially anxious",8,"high",50
"SUPPRF47214",28,52,89,55,1,3,54,19,"Pilot 11","Pilot 11: bigger feedback + video + socially anxious",8,"high",36
"SUPPRF47214",29,45,90,75,29,2,46,18,"Pilot 11","Pilot 11: bigger feedback + video + socially anxious",8,"high",57
"SUPPRF47214",30,45,82,46,17,7,29,19,"Pilot 11","Pilot 11: bigger feedback + video + socially anxious",8,"high",27
"SUPPRF47214",31,45,85,77,14,5,63,14,"Pilot 11","Pilot 11: bigger feedback + video + socially anxious",8,"high",63
"SUPPRF47214",32,50,84,20,0,3,20,16,"Pilot 11","Pilot 11: bigger feedback + video + socially anxious",8,"high",4
"SUPPRF47214",33,52,79,68,-12,6,80,9,"Pilot 11","Pilot 11: bigger feedback + video + socially anxious",8,"high",59
"SUPPRF47214",34,49,71,94,23,8,71,31,"Pilot 11","Pilot 11: bigger feedback + video + socially anxious",8,"high",63
"SUPPRF47214",35,56,82,62,-1,6,63,21,"Pilot 11","Pilot 11: bigger feedback + video + socially anxious",8,"high",41
"SUPPRF47214",36,33,92,6,-14,5,20,14,"Pilot 11","Pilot 11: bigger feedback + video + socially anxious",8,"high",-8
"SUPPRF47214",37,38,89,34,-12,7,46,24,"Pilot 11","Pilot 11: bigger feedback + video + socially anxious",8,"high",10
"SUPPRF47214",38,43,90,19,-1,3,20,5,"Pilot 11","Pilot 11: bigger feedback + video + socially anxious",8,"high",14
"SUPPRF47214",39,49,83,56,-15,3,71,22,"Pilot 11","Pilot 11: bigger feedback + video + socially anxious",8,"high",34
"SUPPRF47214",40,50,80,96,16,5,80,13,"Pilot 11","Pilot 11: bigger feedback + video + socially anxious",8,"high",83
"SUPPRF47214",41,50,84,49,12,6,37,18,"Pilot 11","Pilot 11: bigger feedback + video + socially anxious",8,"high",31
"SUPPRF47214",42,57,80,35,15,2,20,9,"Pilot 11","Pilot 11: bigger feedback + video + socially anxious",8,"high",26
"SUPPRF47214",43,46,81,29,0,8,29,13,"Pilot 11","Pilot 11: bigger feedback + video + socially anxious",8,"high",16
"SUPPRF47214",44,47,85,28,-1,5,29,16,"Pilot 11","Pilot 11: bigger feedback + video + socially anxious",8,"high",12
"SUPPRF47214",45,44,76,67,-13,3,80,19,"Pilot 11","Pilot 11: bigger feedback + video + socially anxious",8,"high",48
"SUPPRF47214",46,50,75,16,-13,3,29,12,"Pilot 11","Pilot 11: bigger feedback + video + socially anxious",8,"high",4
"SUPPRF47214",47,43,82,54,0,2,54,9,"Pilot 11","Pilot 11: bigger feedback + video + socially anxious",8,"high",45
"SUPPRF47214",48,50,81,70,-1,4,71,9,"Pilot 11","Pilot 11: bigger feedback + video + socially anxious",8,"high",61
"SUPPRF47953",1,50,58,19,-1,63,20,30,"Pilot 11","Pilot 11: bigger feedback + video + socially anxious",8,"high",-11
"SUPPRF47953",2,45,54,56,-15,58,71,69,"Pilot 11","Pilot 11: bigger feedback + video + socially anxious",8,"high",-13
"SUPPRF47953",3,44,50,50,-13,60,63,62,"Pilot 11","Pilot 11: bigger feedback + video + socially anxious",8,"high",-12
"SUPPRF47953",4,51,57,71,0,54,71,66,"Pilot 11","Pilot 11: bigger feedback + video + socially anxious",8,"high",5
"SUPPRF47953",5,51,53,66,12,56,54,58,"Pilot 11","Pilot 11: bigger feedback + video + socially anxious",8,"high",8
"SUPPRF47953",6,52,53,33,-13,64,46,45,"Pilot 11","Pilot 11: bigger feedback + video + socially anxious",8,"high",-12
"SUPPRF47953",7,50,46,35,15,57,20,21,"Pilot 11","Pilot 11: bigger feedback + video + socially anxious",8,"high",14
"SUPPRF47953",8,63,49,81,1,63,80,70,"Pilot 11","Pilot 11: bigger feedback + video + socially anxious",8,"high",11
"SUPPRF47953",9,58,44,62,-1,55,63,61,"Pilot 11","Pilot 11: bigger feedback + video + socially anxious",8,"high",1
"SUPPRF47953",10,56,44,68,-12,63,80,69,"Pilot 11","Pilot 11: bigger feedback + video + socially anxious",8,"high",-1
"SUPPRF47953",11,61,38,46,17,68,29,20,"Pilot 11","Pilot 11: bigger feedback + video + socially anxious",8,"high",26
"SUPPRF47953",12,42,53,6,-14,74,20,17,"Pilot 11","Pilot 11: bigger feedback + video + socially anxious",8,"high",-11
"SUPPRF47953",13,59,47,80,0,78,80,70,"Pilot 11","Pilot 11: bigger feedback + video + socially anxious",8,"high",10
"SUPPRF47953",14,61,39,94,23,84,71,76,"Pilot 11","Pilot 11: bigger feedback + video + socially anxious",8,"high",18
"SUPPRF47953",15,63,32,20,0,84,20,13,"Pilot 11","Pilot 11: bigger feedback + video + socially anxious",8,"high",7
"SUPPRF47953",16,21,48,29,0,74,29,71,"Pilot 11","Pilot 11: bigger feedback + video + socially anxious",8,"high",-42
"SUPPRF47953",17,63,26,61,24,70,37,10,"Pilot 11","Pilot 11: bigger feedback + video + socially anxious",8,"high",51
"SUPPRF47953",18,29,42,22,-15,64,37,37,"Pilot 11","Pilot 11: bigger feedback + video + socially anxious",8,"high",-15
"SUPPRF47953",19,75,32,78,24,61,54,46,"Pilot 11","Pilot 11: bigger feedback + video + socially anxious",8,"high",32
"SUPPRF47953",20,67,45,63,0,78,63,45,"Pilot 11","Pilot 11: bigger feedback + video + socially anxious",8,"high",18
"SUPPRF47953",21,20,36,38,1,64,37,61,"Pilot 11","Pilot 11: bigger feedback + video + socially anxious",8,"high",-23
"SUPPRF47953",22,62,27,77,14,47,63,57,"Pilot 11","Pilot 11: bigger feedback + video + socially anxious",8,"high",20
"SUPPRF47953",23,14,42,38,-16,51,54,56,"Pilot 11","Pilot 11: bigger feedback + video + socially anxious",8,"high",-18
"SUPPRF47953",24,18,38,37,0,49,37,52,"Pilot 11","Pilot 11: bigger feedback + video + socially anxious",8,"high",-15
"SUPPRF47953",25,59,44,70,-1,64,71,65,"Pilot 11","Pilot 11: bigger feedback + video + socially anxious",8,"high",5
"SUPPRF47953",26,77,32,58,29,67,29,21,"Pilot 11","Pilot 11: bigger feedback + video + socially anxious",8,"high",37
"SUPPRF47953",27,80,35,83,12,67,71,69,"Pilot 11","Pilot 11: bigger feedback + video + socially anxious",8,"high",14
"SUPPRF47953",28,58,28,16,-13,46,29,18,"Pilot 11","Pilot 11: bigger feedback + video + socially anxious",8,"high",-2
"SUPPRF47953",29,59,26,47,-16,69,63,52,"Pilot 11","Pilot 11: bigger feedback + video + socially anxious",8,"high",-5
"SUPPRF47953",30,62,35,46,0,26,46,33,"Pilot 11","Pilot 11: bigger feedback + video + socially anxious",8,"high",13
"SUPPRF47953",31,61,40,49,12,64,37,45,"Pilot 11","Pilot 11: bigger feedback + video + socially anxious",8,"high",4
"SUPPRF47953",32,65,31,45,-1,68,46,41,"Pilot 11","Pilot 11: bigger feedback + video + socially anxious",8,"high",4
"SUPPRF47953",33,64,36,28,-1,79,29,17,"Pilot 11","Pilot 11: bigger feedback + video + socially anxious",8,"high",11
"SUPPRF47953",34,76,36,75,29,78,46,42,"Pilot 11","Pilot 11: bigger feedback + video + socially anxious",8,"high",33
"SUPPRF47953",35,82,34,88,25,78,63,64,"Pilot 11","Pilot 11: bigger feedback + video + socially anxious",8,"high",24
"SUPPRF47953",36,72,35,34,-12,68,46,42,"Pilot 11","Pilot 11: bigger feedback + video + socially anxious",8,"high",-8
"SUPPRF47953",37,91,25,100,20,77,80,74,"Pilot 11","Pilot 11: bigger feedback + video + socially anxious",8,"high",26
"SUPPRF47953",38,60,21,41,-13,80,54,47,"Pilot 11","Pilot 11: bigger feedback + video + socially anxious",8,"high",-6
"SUPPRF47953",39,57,29,67,-13,91,80,78,"Pilot 11","Pilot 11: bigger feedback + video + socially anxious",8,"high",-11
"SUPPRF47953",40,89,36,47,27,89,20,16,"Pilot 11","Pilot 11: bigger feedback + video + socially anxious",8,"high",31
"SUPPRF47953",41,60,43,24,-13,81,37,42,"Pilot 11","Pilot 11: bigger feedback + video + socially anxious",8,"high",-18
"SUPPRF47953",42,65,35,58,12,75,46,49,"Pilot 11","Pilot 11: bigger feedback + video + socially anxious",8,"high",9
"SUPPRF47953",43,60,49,8,-12,82,20,12,"Pilot 11","Pilot 11: bigger feedback + video + socially anxious",8,"high",-4
"SUPPRF47953",44,61,29,55,1,68,54,46,"Pilot 11","Pilot 11: bigger feedback + video + socially anxious",8,"high",9
"SUPPRF47953",45,60,41,54,0,77,54,49,"Pilot 11","Pilot 11: bigger feedback + video + socially anxious",8,"high",5
"SUPPRF47953",46,41,39,55,-16,87,71,67,"Pilot 11","Pilot 11: bigger feedback + video + socially anxious",8,"high",-12
"SUPPRF47953",47,77,41,96,16,54,80,49,"Pilot 11","Pilot 11: bigger feedback + video + socially anxious",8,"high",47
"SUPPRF47953",48,56,44,15,-14,80,29,14,"Pilot 11","Pilot 11: bigger feedback + video + socially anxious",8,"high",1
"SUPPRF48856",1,33,48,78,24,0,54,0,"Pilot 8","Pilot 8: max feedback + text",7,"high",78
"SUPPRF48856",2,57,29,96,16,64,80,80,"Pilot 8","Pilot 8: max feedback + text",7,"high",16
"SUPPRF48856",3,57,16,83,12,64,71,71,"Pilot 8","Pilot 8: max feedback + text",7,"high",12
"SUPPRF48856",4,52,13,24,-13,60,37,31,"Pilot 8","Pilot 8: max feedback + text",7,"high",-7
"SUPPRF48856",5,51,6,55,1,58,54,46,"Pilot 8","Pilot 8: max feedback + text",7,"high",9
"SUPPRF48856",6,50,4,45,-1,57,46,39,"Pilot 8","Pilot 8: max feedback + text",7,"high",6
"SUPPRF48856",7,49,2,71,0,50,71,70,"Pilot 8","Pilot 8: max feedback + text",7,"high",1
"SUPPRF48856",8,43,0,8,-12,59,20,20,"Pilot 8","Pilot 8: max feedback + text",7,"high",-12
"SUPPRF48856",9,49,0,58,12,60,46,44,"Pilot 8","Pilot 8: max feedback + text",7,"high",14
"SUPPRF48856",10,49,0,77,14,38,63,70,"Pilot 8","Pilot 8: max feedback + text",7,"high",7
"SUPPRF48856",11,50,0,88,25,39,63,69,"Pilot 8","Pilot 8: max feedback + text",7,"high",19
"SUPPRF48856",12,51,0,67,-13,58,80,90,"Pilot 8","Pilot 8: max feedback + text",7,"high",-23
"SUPPRF48856",13,50,2,6,-14,63,20,20,"Pilot 8","Pilot 8: max feedback + text",7,"high",-14
"SUPPRF48856",14,48,1,37,0,17,37,47,"Pilot 8","Pilot 8: max feedback + text",7,"high",-10
"SUPPRF48856",15,49,0,33,-13,31,46,50,"Pilot 8","Pilot 8: max feedback + text",7,"high",-17
"SUPPRF48856",16,49,0,29,0,48,29,31,"Pilot 8","Pilot 8: max feedback + text",7,"high",-2
"SUPPRF48856",17,50,0,41,-13,52,54,66,"Pilot 8","Pilot 8: max feedback + text",7,"high",-25
"SUPPRF48856",18,49,0,68,-12,62,80,85,"Pilot 8","Pilot 8: max feedback + text",7,"high",-17
"SUPPRF48856",19,51,0,28,-1,12,29,21,"Pilot 8","Pilot 8: max feedback + text",7,"high",7
"SUPPRF48856",20,47,0,46,17,58,29,30,"Pilot 8","Pilot 8: max feedback + text",7,"high",16
"SUPPRF48856",21,49,0,94,23,1,71,50,"Pilot 8","Pilot 8: max feedback + text",7,"high",44
"SUPPRF48856",22,49,0,70,-1,58,71,71,"Pilot 8","Pilot 8: max feedback + text",7,"high",-1
"SUPPRF48856",23,49,0,100,20,58,80,70,"Pilot 8","Pilot 8: max feedback + text",7,"high",30
"SUPPRF48856",24,49,3,46,0,72,46,46,"Pilot 8","Pilot 8: max feedback + text",7,"high",0
"SUPPRF48856",25,50,0,19,-1,67,20,20,"Pilot 8","Pilot 8: max feedback + text",7,"high",-1
"SUPPRF48856",26,49,0,20,0,60,20,20,"Pilot 8","Pilot 8: max feedback + text",7,"high",0
"SUPPRF48856",27,50,1,61,24,1,37,49,"Pilot 8","Pilot 8: max feedback + text",7,"high",12
"SUPPRF48856",28,51,0,81,1,74,80,90,"Pilot 8","Pilot 8: max feedback + text",7,"high",-9
"SUPPRF48856",29,51,0,63,0,69,63,60,"Pilot 8","Pilot 8: max feedback + text",7,"high",3
"SUPPRF48856",30,49,0,47,-16,51,63,50,"Pilot 8","Pilot 8: max feedback + text",7,"high",-3
"SUPPRF48856",31,50,3,56,-15,18,71,90,"Pilot 8","Pilot 8: max feedback + text",7,"high",-34
"SUPPRF48856",32,49,0,62,-1,48,63,50,"Pilot 8","Pilot 8: max feedback + text",7,"high",12
"SUPPRF48856",33,50,1,35,15,62,20,20,"Pilot 8","Pilot 8: max feedback + text",7,"high",15
"SUPPRF48856",34,49,0,22,-15,50,37,40,"Pilot 8","Pilot 8: max feedback + text",7,"high",-18
"SUPPRF48856",35,48,2,54,0,55,54,55,"Pilot 8","Pilot 8: max feedback + text",7,"high",-1
"SUPPRF48856",36,49,0,16,-13,62,29,30,"Pilot 8","Pilot 8: max feedback + text",7,"high",-14
"SUPPRF48856",37,45,1,58,29,66,29,31,"Pilot 8","Pilot 8: max feedback + text",7,"high",27
"SUPPRF48856",38,48,2,38,1,59,37,44,"Pilot 8","Pilot 8: max feedback + text",7,"high",-6
"SUPPRF48856",39,50,0,50,-13,47,63,55,"Pilot 8","Pilot 8: max feedback + text",7,"high",-5
"SUPPRF48856",40,40,1,34,-12,48,46,61,"Pilot 8","Pilot 8: max feedback + text",7,"high",-27
"SUPPRF48856",41,45,0,55,-16,67,71,73,"Pilot 8","Pilot 8: max feedback + text",7,"high",-18
"SUPPRF48856",42,48,1,15,-14,68,29,29,"Pilot 8","Pilot 8: max feedback + text",7,"high",-14
"SUPPRF48856",43,50,0,75,29,66,46,45,"Pilot 8","Pilot 8: max feedback + text",7,"high",30
"SUPPRF48856",44,49,2,80,0,67,80,83,"Pilot 8","Pilot 8: max feedback + text",7,"high",-3
"SUPPRF48856",45,50,0,38,-16,71,54,54,"Pilot 8","Pilot 8: max feedback + text",7,"high",-16
"SUPPRF48856",46,50,1,47,27,74,20,20,"Pilot 8","Pilot 8: max feedback + text",7,"high",27
"SUPPRF48856",47,49,0,66,12,75,54,53,"Pilot 8","Pilot 8: max feedback + text",7,"high",13
"SUPPRF48856",48,47,0,49,12,66,37,45,"Pilot 8","Pilot 8: max feedback + text",7,"high",4
"SUPPRF48951",1,85,23,35,15,58,20,23,"Pilot 7","Pilot 7: bigger feedback + text",7,"high",12
"SUPPRF48951",2,84,16,78,15,71,63,67,"Pilot 7","Pilot 7: bigger feedback + text",7,"high",11
"SUPPRF48951",3,81,11,33,-13,70,46,57,"Pilot 7","Pilot 7: bigger feedback + text",7,"high",-24
"SUPPRF48951",4,83,11,16,-13,66,29,26,"Pilot 7","Pilot 7: bigger feedback + text",7,"high",-10
"SUPPRF48951",5,87,11,45,-1,75,46,30,"Pilot 7","Pilot 7: bigger feedback + text",7,"high",15
"SUPPRF48951",6,100,1,97,17,78,80,76,"Pilot 7","Pilot 7: bigger feedback + text",7,"high",21
"SUPPRF48951",7,99,3,83,12,83,71,77,"Pilot 7","Pilot 7: bigger feedback + text",7,"high",6
"SUPPRF48951",8,88,6,34,-12,88,46,46,"Pilot 7","Pilot 7: bigger feedback + text",7,"high",-12
"SUPPRF48951",9,87,8,15,-14,72,29,60,"Pilot 7","Pilot 7: bigger feedback + text",7,"high",-45
"SUPPRF48951",10,88,7,63,0,87,63,76,"Pilot 7","Pilot 7: bigger feedback + text",7,"high",-13
"SUPPRF48951",11,86,9,77,14,50,63,50,"Pilot 7","Pilot 7: bigger feedback + text",7,"high",27
"SUPPRF48951",12,85,9,81,1,68,80,68,"Pilot 7","Pilot 7: bigger feedback + text",7,"high",13
"SUPPRF48951",13,89,9,41,-13,76,54,57,"Pilot 7","Pilot 7: bigger feedback + text",7,"high",-16
"SUPPRF48951",14,92,9,55,-16,89,71,76,"Pilot 7","Pilot 7: bigger feedback + text",7,"high",-21
"SUPPRF48951",15,90,8,20,0,85,20,21,"Pilot 7","Pilot 7: bigger feedback + text",7,"high",-1
"SUPPRF48951",16,89,9,51,14,75,37,28,"Pilot 7","Pilot 7: bigger feedback + text",7,"high",23
"SUPPRF48951",17,90,7,49,12,93,37,41,"Pilot 7","Pilot 7: bigger feedback + text",7,"high",8
"SUPPRF48951",18,90,11,66,12,85,54,67,"Pilot 7","Pilot 7: bigger feedback + text",7,"high",-1
"SUPPRF48951",19,92,2,96,16,84,80,59,"Pilot 7","Pilot 7: bigger feedback + text",7,"high",37
"SUPPRF48951",20,91,7,70,-1,85,71,75,"Pilot 7","Pilot 7: bigger feedback + text",7,"high",-5
"SUPPRF48951",21,91,6,24,-13,82,37,37,"Pilot 7","Pilot 7: bigger feedback + text",7,"high",-13
"SUPPRF48951",22,89,10,46,0,71,46,34,"Pilot 7","Pilot 7: bigger feedback + text",7,"high",12
"SUPPRF48951",23,83,9,67,-13,91,80,77,"Pilot 7","Pilot 7: bigger feedback + text",7,"high",-10
"SUPPRF48951",24,82,9,56,-15,87,71,74,"Pilot 7","Pilot 7: bigger feedback + text",7,"high",-18
"SUPPRF48951",25,87,21,38,-16,88,54,54,"Pilot 7","Pilot 7: bigger feedback + text",7,"high",-16
"SUPPRF48951",26,82,12,38,1,79,37,36,"Pilot 7","Pilot 7: bigger feedback + text",7,"high",2
"SUPPRF48951",27,82,16,22,-15,86,37,17,"Pilot 7","Pilot 7: bigger feedback + text",7,"high",5
"SUPPRF48951",28,90,6,62,-1,85,63,64,"Pilot 7","Pilot 7: bigger feedback + text",7,"high",-2
"SUPPRF48951",29,83,17,50,-13,69,63,53,"Pilot 7","Pilot 7: bigger feedback + text",7,"high",-3
"SUPPRF48951",30,80,22,46,17,85,29,64,"Pilot 7","Pilot 7: bigger feedback + text",7,"high",-18
"SUPPRF48951",31,75,24,19,-1,65,20,44,"Pilot 7","Pilot 7: bigger feedback + text",7,"high",-25
"SUPPRF48951",32,68,28,37,0,59,37,44,"Pilot 7","Pilot 7: bigger feedback + text",7,"high",-7
"SUPPRF48951",33,74,19,29,0,89,29,32,"Pilot 7","Pilot 7: bigger feedback + text",7,"high",-3
"SUPPRF48951",34,72,25,54,0,90,54,61,"Pilot 7","Pilot 7: bigger feedback + text",7,"high",-7
"SUPPRF48951",35,76,20,68,14,79,54,62,"Pilot 7","Pilot 7: bigger feedback + text",7,"high",6
"SUPPRF48951",36,15,24,71,0,84,71,68,"Pilot 7","Pilot 7: bigger feedback + text",7,"high",3
"SUPPRF48951",37,79,21,58,12,82,46,31,"Pilot 7","Pilot 7: bigger feedback + text",7,"high",27
"SUPPRF48951",38,76,17,28,-1,87,29,33,"Pilot 7","Pilot 7: bigger feedback + text",7,"high",-5
"SUPPRF48951",39,77,22,8,-12,91,20,17,"Pilot 7","Pilot 7: bigger feedback + text",7,"high",-9
"SUPPRF48951",40,87,15,48,19,39,29,46,"Pilot 7","Pilot 7: bigger feedback + text",7,"high",2
"SUPPRF48951",41,56,37,68,-12,51,80,49,"Pilot 7","Pilot 7: bigger feedback + text",7,"high",19
"SUPPRF48951",42,66,41,47,-16,38,63,71,"Pilot 7","Pilot 7: bigger feedback + text",7,"high",-24
"SUPPRF48951",43,75,32,6,-14,94,20,16,"Pilot 7","Pilot 7: bigger feedback + text",7,"high",-10
"SUPPRF48951",44,81,25,84,13,37,71,67,"Pilot 7","Pilot 7: bigger feedback + text",7,"high",17
"SUPPRF48951",45,46,33,55,1,57,54,63,"Pilot 7","Pilot 7: bigger feedback + text",7,"high",-8
"SUPPRF48951",46,83,27,37,17,95,20,13,"Pilot 7","Pilot 7: bigger feedback + text",7,"high",24
"SUPPRF48951",47,79,20,65,19,86,46,42,"Pilot 7","Pilot 7: bigger feedback + text",7,"high",23
"SUPPRF48951",48,57,39,80,0,20,80,53,"Pilot 7","Pilot 7: bigger feedback + text",7,"high",27
"SUPPRF51078",1,58,54,70,-1,61,71,69,"Pilot 10","Pilot 10: bigger feedback + video",6,"high",1
"SUPPRF51078",2,47,49,66,12,54,54,53,"Pilot 10","Pilot 10: bigger feedback + video",6,"high",13
"SUPPRF51078",3,49,42,29,0,66,29,59,"Pilot 10","Pilot 10: bigger feedback + video",6,"high",-30
"SUPPRF51078",4,46,50,83,12,65,71,79,"Pilot 10","Pilot 10: bigger feedback + video",6,"high",4
"SUPPRF51078",5,45,54,35,15,57,20,59,"Pilot 10","Pilot 10: bigger feedback + video",6,"high",-24
"SUPPRF51078",6,59,60,47,-16,68,63,66,"Pilot 10","Pilot 10: bigger feedback + video",6,"high",-19
"SUPPRF51078",7,53,55,55,1,61,54,64,"Pilot 10","Pilot 10: bigger feedback + video",6,"high",-9
"SUPPRF51078",8,56,57,33,-13,54,46,58,"Pilot 10","Pilot 10: bigger feedback + video",6,"high",-25
"SUPPRF51078",9,47,44,94,23,49,71,68,"Pilot 10","Pilot 10: bigger feedback + video",6,"high",26
"SUPPRF51078",10,57,50,61,24,66,37,60,"Pilot 10","Pilot 10: bigger feedback + video",6,"high",1
"SUPPRF51078",11,54,59,50,-13,60,63,64,"Pilot 10","Pilot 10: bigger feedback + video",6,"high",-14
"SUPPRF51078",12,45,52,22,-15,65,37,66,"Pilot 10","Pilot 10: bigger feedback + video",6,"high",-44
"SUPPRF51078",13,49,52,38,-16,55,54,72,"Pilot 10","Pilot 10: bigger feedback + video",6,"high",-34
"SUPPRF51078",14,45,55,46,0,67,46,73,"Pilot 10","Pilot 10: bigger feedback + video",6,"high",-27
"SUPPRF51078",15,59,42,68,-12,46,80,67,"Pilot 10","Pilot 10: bigger feedback + video",6,"high",1
"SUPPRF51078",16,64,47,49,12,45,37,33,"Pilot 10","Pilot 10: bigger feedback + video",6,"high",16
"SUPPRF51078",17,76,47,96,16,53,80,73,"Pilot 10","Pilot 10: bigger feedback + video",6,"high",23
"SUPPRF51078",18,48,51,75,29,68,46,60,"Pilot 10","Pilot 10: bigger feedback + video",6,"high",15
"SUPPRF51078",19,47,56,34,-12,40,46,58,"Pilot 10","Pilot 10: bigger feedback + video",6,"high",-24
"SUPPRF51078",20,50,41,8,-12,37,20,49,"Pilot 10","Pilot 10: bigger feedback + video",6,"high",-41
"SUPPRF51078",21,53,53,41,-13,57,54,51,"Pilot 10","Pilot 10: bigger feedback + video",6,"high",-10
"SUPPRF51078",22,47,47,77,14,43,63,55,"Pilot 10","Pilot 10: bigger feedback + video",6,"high",22
"SUPPRF51078",23,42,41,15,-14,48,29,48,"Pilot 10","Pilot 10: bigger feedback + video",6,"high",-33
"SUPPRF51078",24,55,54,63,0,55,63,55,"Pilot 10","Pilot 10: bigger feedback + video",6,"high",8
"SUPPRF51078",25,45,48,80,0,50,80,53,"Pilot 10","Pilot 10: bigger feedback + video",6,"high",27
"SUPPRF51078",26,51,52,58,29,47,29,52,"Pilot 10","Pilot 10: bigger feedback + video",6,"high",6
"SUPPRF51078",27,51,49,47,27,56,20,56,"Pilot 10","Pilot 10: bigger feedback + video",6,"high",-9
"SUPPRF51078",28,45,47,19,-1,54,20,54,"Pilot 10","Pilot 10: bigger feedback + video",6,"high",-35
"SUPPRF51078",29,54,59,100,20,57,80,57,"Pilot 10","Pilot 10: bigger feedback + video",6,"high",43
"SUPPRF51078",30,43,49,45,-1,46,46,60,"Pilot 10","Pilot 10: bigger feedback + video",6,"high",-15
"SUPPRF51078",31,50,55,58,12,52,46,60,"Pilot 10","Pilot 10: bigger feedback + video",6,"high",-2
"SUPPRF51078",32,47,54,54,0,49,54,57,"Pilot 10","Pilot 10: bigger feedback + video",6,"high",-3
"SUPPRF51078",33,47,58,56,-15,47,71,48,"Pilot 10","Pilot 10: bigger feedback + video",6,"high",8
"SUPPRF51078",34,44,52,28,-1,56,29,60,"Pilot 10","Pilot 10: bigger feedback + video",6,"high",-32
"SUPPRF51078",35,52,53,55,-16,50,71,55,"Pilot 10","Pilot 10: bigger feedback + video",6,"high",0
"SUPPRF51078",36,49,55,24,-13,47,37,58,"Pilot 10","Pilot 10: bigger feedback + video",6,"high",-34
"SUPPRF51078",37,49,48,67,-13,53,80,56,"Pilot 10","Pilot 10: bigger feedback + video",6,"high",11
"SUPPRF51078",38,54,51,38,1,60,37,59,"Pilot 10","Pilot 10: bigger feedback + video",6,"high",-21
"SUPPRF51078",39,50,50,16,-13,54,29,50,"Pilot 10","Pilot 10: bigger feedback + video",6,"high",-34
"SUPPRF51078",40,50,48,20,0,48,20,49,"Pilot 10","Pilot 10: bigger feedback + video",6,"high",-29
"SUPPRF51078",41,49,49,71,0,50,71,51,"Pilot 10","Pilot 10: bigger feedback + video",6,"high",20
"SUPPRF51078",42,22,35,37,0,49,37,49,"Pilot 10","Pilot 10: bigger feedback + video",6,"high",-12
"SUPPRF51078",43,30,58,81,1,49,80,55,"Pilot 10","Pilot 10: bigger feedback + video",6,"high",26
"SUPPRF51078",44,47,47,62,-1,45,63,65,"Pilot 10","Pilot 10: bigger feedback + video",6,"high",-3
"SUPPRF51078",45,28,46,46,17,36,29,50,"Pilot 10","Pilot 10: bigger feedback + video",6,"high",-4
"SUPPRF51078",46,47,53,88,25,46,63,46,"Pilot 10","Pilot 10: bigger feedback + video",6,"high",42
"SUPPRF51078",47,51,50,78,24,45,54,44,"Pilot 10","Pilot 10: bigger feedback + video",6,"high",34
"SUPPRF51078",48,21,45,6,-14,49,20,57,"Pilot 10","Pilot 10: bigger feedback + video",6,"high",-51
"SUPPRF51200",1,51,58,61,24,21,37,32,"Pilot 8","Pilot 8: max feedback + text",4,"low",29
"SUPPRF51200",2,51,44,71,0,37,71,33,"Pilot 8","Pilot 8: max feedback + text",4,"low",38
"SUPPRF51200",3,41,47,6,-14,38,20,31,"Pilot 8","Pilot 8: max feedback + text",4,"low",-25
"SUPPRF51200",4,47,44,15,-14,37,29,39,"Pilot 8","Pilot 8: max feedback + text",4,"low",-24
"SUPPRF51200",5,42,49,62,-1,58,63,54,"Pilot 8","Pilot 8: max feedback + text",4,"low",8
"SUPPRF51200",6,24,11,47,27,86,20,2,"Pilot 8","Pilot 8: max feedback + text",4,"low",45
"SUPPRF51200",7,44,52,58,29,46,29,11,"Pilot 8","Pilot 8: max feedback + text",4,"low",47
"SUPPRF51200",8,47,52,94,23,42,71,29,"Pilot 8","Pilot 8: max feedback + text",4,"low",65
"SUPPRF51200",9,53,13,20,0,49,20,31,"Pilot 8","Pilot 8: max feedback + text",4,"low",-11
"SUPPRF51200",10,52,47,56,-15,48,71,41,"Pilot 8","Pilot 8: max feedback + text",4,"low",15
"SUPPRF51200",11,42,46,46,17,37,29,18,"Pilot 8","Pilot 8: max feedback + text",4,"low",28
"SUPPRF51200",12,34,47,70,-1,53,71,46,"Pilot 8","Pilot 8: max feedback + text",4,"low",24
"SUPPRF51200",13,48,42,24,-13,42,37,19,"Pilot 8","Pilot 8: max feedback + text",4,"low",5
"SUPPRF51200",14,44,49,28,-1,44,29,45,"Pilot 8","Pilot 8: max feedback + text",4,"low",-17
"SUPPRF51200",15,32,33,34,-12,62,46,60,"Pilot 8","Pilot 8: max feedback + text",4,"low",-26
"SUPPRF51200",16,37,34,41,-13,56,54,49,"Pilot 8","Pilot 8: max feedback + text",4,"low",-8
"SUPPRF51200",17,40,48,75,29,44,46,20,"Pilot 8","Pilot 8: max feedback + text",4,"low",55
"SUPPRF51200",18,47,56,37,0,47,37,16,"Pilot 8","Pilot 8: max feedback + text",4,"low",21
"SUPPRF51200",19,46,49,38,-16,70,54,44,"Pilot 8","Pilot 8: max feedback + text",4,"low",-6
"SUPPRF51200",20,42,38,63,0,49,63,50,"Pilot 8","Pilot 8: max feedback + text",4,"low",13
"SUPPRF51200",21,38,38,100,20,46,80,58,"Pilot 8","Pilot 8: max feedback + text",4,"low",42
"SUPPRF51200",22,63,39,47,-16,47,63,42,"Pilot 8","Pilot 8: max feedback + text",4,"low",5
"SUPPRF51200",23,49,49,46,0,41,46,49,"Pilot 8","Pilot 8: max feedback + text",4,"low",-3
"SUPPRF51200",24,52,42,35,15,58,20,16,"Pilot 8","Pilot 8: max feedback + text",4,"low",19
"SUPPRF51200",25,51,47,54,0,87,54,99,"Pilot 8","Pilot 8: max feedback + text",4,"low",-45
"SUPPRF51200",26,50,46,66,12,43,54,25,"Pilot 8","Pilot 8: max feedback + text",4,"low",41
"SUPPRF51200",27,45,40,96,16,49,80,32,"Pilot 8","Pilot 8: max feedback + text",4,"low",64
"SUPPRF51200",28,41,49,78,24,49,54,48,"Pilot 8","Pilot 8: max feedback + text",4,"low",30
"SUPPRF51200",29,39,40,58,12,45,46,44,"Pilot 8","Pilot 8: max feedback + text",4,"low",14
"SUPPRF51200",30,52,46,67,-13,56,80,55,"Pilot 8","Pilot 8: max feedback + text",4,"low",12
"SUPPRF51200",31,50,44,55,-16,57,71,36,"Pilot 8","Pilot 8: max feedback + text",4,"low",19
"SUPPRF51200",32,55,51,50,-13,33,63,61,"Pilot 8","Pilot 8: max feedback + text",4,"low",-11
"SUPPRF51200",33,54,55,81,1,56,80,37,"Pilot 8","Pilot 8: max feedback + text",4,"low",44
"SUPPRF51200",34,14,48,80,0,48,80,13,"Pilot 8","Pilot 8: max feedback + text",4,"low",67
"SUPPRF51200",35,76,31,22,-15,79,37,33,"Pilot 8","Pilot 8: max feedback + text",4,"low",-11
"SUPPRF51200",36,49,41,77,14,60,63,44,"Pilot 8","Pilot 8: max feedback + text",4,"low",33
"SUPPRF51200",37,51,47,45,-1,91,46,42,"Pilot 8","Pilot 8: max feedback + text",4,"low",3
"SUPPRF51200",38,61,27,16,-13,96,29,29,"Pilot 8","Pilot 8: max feedback + text",4,"low",-13
"SUPPRF51200",39,71,36,83,12,63,71,68,"Pilot 8","Pilot 8: max feedback + text",4,"low",15
"SUPPRF51200",40,53,63,88,25,84,63,83,"Pilot 8","Pilot 8: max feedback + text",4,"low",5
"SUPPRF51200",41,33,1,8,-12,28,20,30,"Pilot 8","Pilot 8: max feedback + text",4,"low",-22
"SUPPRF51200",42,74,5,19,-1,18,20,58,"Pilot 8","Pilot 8: max feedback + text",4,"low",-39
"SUPPRF51200",43,49,40,29,0,53,29,62,"Pilot 8","Pilot 8: max feedback + text",4,"low",-33
"SUPPRF51200",44,42,34,68,-12,53,80,51,"Pilot 8","Pilot 8: max feedback + text",4,"low",17
"SUPPRF51200",45,54,43,49,12,19,37,28,"Pilot 8","Pilot 8: max feedback + text",4,"low",21
"SUPPRF51200",46,39,61,55,1,68,54,60,"Pilot 8","Pilot 8: max feedback + text",4,"low",-5
"SUPPRF51200",47,58,47,33,-13,42,46,53,"Pilot 8","Pilot 8: max feedback + text",4,"low",-20
"SUPPRF51200",48,55,33,38,1,39,37,39,"Pilot 8","Pilot 8: max feedback + text",4,"low",-1
"SUPPRF51230",1,56,62,65,19,87,46,45,"Pilot 6","Pilot 6: feedback + text",7,"high",20
"SUPPRF51230",2,63,62,46,17,61,29,34,"Pilot 6","Pilot 6: feedback + text",7,"high",12
"SUPPRF51230",3,64,63,33,-13,74,46,50,"Pilot 6","Pilot 6: feedback + text",7,"high",-17
"SUPPRF51230",4,62,61,78,15,90,63,67,"Pilot 6","Pilot 6: feedback + text",7,"high",11
"SUPPRF51230",5,56,55,83,12,68,71,68,"Pilot 6","Pilot 6: feedback + text",7,"high",15
"SUPPRF51230",6,59,59,55,-16,81,71,63,"Pilot 6","Pilot 6: feedback + text",7,"high",-8
"SUPPRF51230",7,60,59,49,12,33,37,57,"Pilot 6","Pilot 6: feedback + text",7,"high",-8
"SUPPRF51230",8,57,58,20,0,69,20,32,"Pilot 6","Pilot 6: feedback + text",7,"high",-12
"SUPPRF51230",9,56,56,34,-12,74,46,57,"Pilot 6","Pilot 6: feedback + text",7,"high",-23
"SUPPRF51230",10,51,53,29,0,53,29,40,"Pilot 6","Pilot 6: feedback + text",7,"high",-11
"SUPPRF51230",11,58,58,22,-15,63,37,35,"Pilot 6","Pilot 6: feedback + text",7,"high",-13
"SUPPRF51230",12,56,55,24,-13,59,37,39,"Pilot 6","Pilot 6: feedback + text",7,"high",-15
"SUPPRF51230",13,52,51,55,1,62,54,41,"Pilot 6","Pilot 6: feedback + text",7,"high",14
"SUPPRF51230",14,55,54,6,-14,65,20,36,"Pilot 6","Pilot 6: feedback + text",7,"high",-30
"SUPPRF51230",15,56,56,16,-13,61,29,34,"Pilot 6","Pilot 6: feedback + text",7,"high",-18
"SUPPRF51230",16,50,51,63,0,44,63,46,"Pilot 6","Pilot 6: feedback + text",7,"high",17
"SUPPRF51230",17,52,54,8,-12,67,20,14,"Pilot 6","Pilot 6: feedback + text",7,"high",-6
"SUPPRF51230",18,56,56,56,-15,75,71,70,"Pilot 6","Pilot 6: feedback + text",7,"high",-14
"SUPPRF51230",19,54,57,47,-16,77,63,64,"Pilot 6","Pilot 6: feedback + text",7,"high",-17
"SUPPRF51230",20,53,57,50,-13,37,63,54,"Pilot 6","Pilot 6: feedback + text",7,"high",-4
"SUPPRF51230",21,55,56,81,1,76,80,80,"Pilot 6","Pilot 6: feedback + text",7,"high",1
"SUPPRF51230",22,56,55,41,-13,34,54,63,"Pilot 6","Pilot 6: feedback + text",7,"high",-22
"SUPPRF51230",23,55,52,28,-1,81,29,24,"Pilot 6","Pilot 6: feedback + text",7,"high",4
"SUPPRF51230",24,62,64,35,15,82,20,16,"Pilot 6","Pilot 6: feedback + text",7,"high",19
"SUPPRF51230",25,52,52,96,16,64,80,68,"Pilot 6","Pilot 6: feedback + text",7,"high",28
"SUPPRF51230",26,54,53,58,12,58,46,53,"Pilot 6","Pilot 6: feedback + text",7,"high",5
"SUPPRF51230",27,52,50,97,17,56,80,70,"Pilot 6","Pilot 6: feedback + text",7,"high",27
"SUPPRF51230",28,46,55,67,-13,58,80,70,"Pilot 6","Pilot 6: feedback + text",7,"high",-3
"SUPPRF51230",29,41,56,38,-16,67,54,67,"Pilot 6","Pilot 6: feedback + text",7,"high",-29
"SUPPRF51230",30,38,57,19,-1,55,20,34,"Pilot 6","Pilot 6: feedback + text",7,"high",-15
"SUPPRF51230",31,40,56,37,0,23,37,50,"Pilot 6","Pilot 6: feedback + text",7,"high",-13
"SUPPRF51230",32,33,53,80,0,62,80,81,"Pilot 6","Pilot 6: feedback + text",7,"high",-1
"SUPPRF51230",33,40,57,84,13,56,71,64,"Pilot 6","Pilot 6: feedback + text",7,"high",20
"SUPPRF51230",34,34,60,70,-1,54,71,49,"Pilot 6","Pilot 6: feedback + text",7,"high",21
"SUPPRF51230",35,35,63,77,14,52,63,49,"Pilot 6","Pilot 6: feedback + text",7,"high",28
"SUPPRF51230",36,39,62,46,0,39,46,56,"Pilot 6","Pilot 6: feedback + text",7,"high",-10
"SUPPRF51230",37,36,65,71,0,66,71,51,"Pilot 6","Pilot 6: feedback + text",7,"high",20
"SUPPRF51230",38,38,59,15,-14,58,29,62,"Pilot 6","Pilot 6: feedback + text",7,"high",-47
"SUPPRF51230",39,33,61,66,12,61,54,52,"Pilot 6","Pilot 6: feedback + text",7,"high",14
"SUPPRF51230",40,32,60,62,-1,63,63,51,"Pilot 6","Pilot 6: feedback + text",7,"high",11
"SUPPRF51230",41,32,59,68,-12,34,80,65,"Pilot 6","Pilot 6: feedback + text",7,"high",3
"SUPPRF51230",42,36,61,48,19,65,29,38,"Pilot 6","Pilot 6: feedback + text",7,"high",10
"SUPPRF51230",43,39,58,51,14,54,37,38,"Pilot 6","Pilot 6: feedback + text",7,"high",13
"SUPPRF51230",44,33,58,45,-1,59,46,44,"Pilot 6","Pilot 6: feedback + text",7,"high",1
"SUPPRF51230",45,39,59,38,1,48,37,33,"Pilot 6","Pilot 6: feedback + text",7,"high",5
"SUPPRF51230",46,35,59,54,0,48,54,40,"Pilot 6","Pilot 6: feedback + text",7,"high",14
"SUPPRF51230",47,39,58,37,17,57,20,16,"Pilot 6","Pilot 6: feedback + text",7,"high",21
"SUPPRF51230",48,36,59,68,14,71,54,54,"Pilot 6","Pilot 6: feedback + text",7,"high",14
"SUPPRF51534",1,52,65,24,-13,59,37,33,"Pilot 6","Pilot 6: feedback + text",5,"low",-9
"SUPPRF51534",2,49,57,46,0,62,46,41,"Pilot 6","Pilot 6: feedback + text",5,"low",5
"SUPPRF51534",3,67,49,45,-1,64,46,44,"Pilot 6","Pilot 6: feedback + text",5,"low",1
"SUPPRF51534",4,73,37,70,-1,73,71,66,"Pilot 6","Pilot 6: feedback + text",5,"low",4
"SUPPRF51534",5,69,31,83,12,75,71,72,"Pilot 6","Pilot 6: feedback + text",5,"low",11
"SUPPRF51534",6,73,19,62,-1,75,63,60,"Pilot 6","Pilot 6: feedback + text",5,"low",2
"SUPPRF51534",7,46,51,50,-13,73,63,67,"Pilot 6","Pilot 6: feedback + text",5,"low",-17
"SUPPRF51534",8,48,55,28,-1,69,29,24,"Pilot 6","Pilot 6: feedback + text",5,"low",4
"SUPPRF51534",9,53,52,41,-13,83,54,49,"Pilot 6","Pilot 6: feedback + text",5,"low",-8
"SUPPRF51534",10,52,50,67,-13,69,80,66,"Pilot 6","Pilot 6: feedback + text",5,"low",1
"SUPPRF51534",11,42,57,55,1,70,54,64,"Pilot 6","Pilot 6: feedback + text",5,"low",-9
"SUPPRF51534",12,63,44,37,17,78,20,19,"Pilot 6","Pilot 6: feedback + text",5,"low",18
"SUPPRF51534",13,72,44,68,-12,70,80,49,"Pilot 6","Pilot 6: feedback + text",5,"low",19
"SUPPRF51534",14,22,63,15,-14,65,29,37,"Pilot 6","Pilot 6: feedback + text",5,"low",-22
"SUPPRF51534",15,55,52,48,19,61,29,24,"Pilot 6","Pilot 6: feedback + text",5,"low",24
"SUPPRF51534",16,51,53,8,-12,17,20,36,"Pilot 6","Pilot 6: feedback + text",5,"low",-28
"SUPPRF51534",17,66,47,54,0,51,54,46,"Pilot 6","Pilot 6: feedback + text",5,"low",8
"SUPPRF51534",18,59,40,38,1,56,37,40,"Pilot 6","Pilot 6: feedback + text",5,"low",-2
"SUPPRF51534",19,67,35,71,0,55,71,48,"Pilot 6","Pilot 6: feedback + text",5,"low",23
"SUPPRF51534",20,60,42,63,0,68,63,70,"Pilot 6","Pilot 6: feedback + text",5,"low",-7
"SUPPRF51534",21,67,31,35,15,64,20,24,"Pilot 6","Pilot 6: feedback + text",5,"low",11
"SUPPRF51534",22,38,59,6,-14,65,20,22,"Pilot 6","Pilot 6: feedback + text",5,"low",-16
"SUPPRF51534",23,68,35,78,15,61,63,65,"Pilot 6","Pilot 6: feedback + text",5,"low",13
"SUPPRF51534",24,54,30,65,19,56,46,55,"Pilot 6","Pilot 6: feedback + text",5,"low",10
"SUPPRF51534",25,67,33,20,0,82,20,22,"Pilot 6","Pilot 6: feedback + text",5,"low",-2
"SUPPRF51534",26,57,34,58,12,65,46,43,"Pilot 6","Pilot 6: feedback + text",5,"low",15
"SUPPRF51534",27,60,37,49,12,71,37,50,"Pilot 6","Pilot 6: feedback + text",5,"low",-1
"SUPPRF51534",28,65,32,84,13,71,71,56,"Pilot 6","Pilot 6: feedback + text",5,"low",28
"SUPPRF51534",29,72,22,46,17,83,29,32,"Pilot 6","Pilot 6: feedback + text",5,"low",14
"SUPPRF51534",30,71,34,80,0,72,80,40,"Pilot 6","Pilot 6: feedback + text",5,"low",40
"SUPPRF51534",31,74,31,29,0,64,29,34,"Pilot 6","Pilot 6: feedback + text",5,"low",-5
"SUPPRF51534",32,64,23,51,14,65,37,40,"Pilot 6","Pilot 6: feedback + text",5,"low",11
"SUPPRF51534",33,48,51,19,-1,69,20,20,"Pilot 6","Pilot 6: feedback + text",5,"low",-1
"SUPPRF51534",34,72,28,68,14,84,54,53,"Pilot 6","Pilot 6: feedback + text",5,"low",15
"SUPPRF51534",35,47,45,33,-13,58,46,44,"Pilot 6","Pilot 6: feedback + text",5,"low",-11
"SUPPRF51534",36,49,49,56,-15,64,71,68,"Pilot 6","Pilot 6: feedback + text",5,"low",-12
"SUPPRF51534",37,41,61,22,-15,69,37,43,"Pilot 6","Pilot 6: feedback + text",5,"low",-21
"SUPPRF51534",38,48,51,37,0,71,37,31,"Pilot 6","Pilot 6: feedback + text",5,"low",6
"SUPPRF51534",39,44,58,38,-16,66,54,54,"Pilot 6","Pilot 6: feedback + text",5,"low",-16
"SUPPRF51534",40,64,30,77,14,63,63,60,"Pilot 6","Pilot 6: feedback + text",5,"low",17
"SUPPRF51534",41,39,59,16,-13,60,29,30,"Pilot 6","Pilot 6: feedback + text",5,"low",-14
"SUPPRF51534",42,74,42,96,16,64,80,59,"Pilot 6","Pilot 6: feedback + text",5,"low",37
"SUPPRF51534",43,43,53,47,-16,74,63,61,"Pilot 6","Pilot 6: feedback + text",5,"low",-14
"SUPPRF51534",44,65,34,97,17,76,80,75,"Pilot 6","Pilot 6: feedback + text",5,"low",22
"SUPPRF51534",45,46,46,34,-12,51,46,42,"Pilot 6","Pilot 6: feedback + text",5,"low",-8
"SUPPRF51534",46,58,32,81,1,52,80,62,"Pilot 6","Pilot 6: feedback + text",5,"low",19
"SUPPRF51534",47,61,44,55,-16,40,71,49,"Pilot 6","Pilot 6: feedback + text",5,"low",6
"SUPPRF51534",48,59,35,66,12,64,54,53,"Pilot 6","Pilot 6: feedback + text",5,"low",13
"SUPPRF53463",1,99,2,6,-14,1,20,20,"Pilot 10","Pilot 10: bigger feedback + video",5,"low",-14
"SUPPRF53463",2,99,1,96,16,1,80,80,"Pilot 10","Pilot 10: bigger feedback + video",5,"low",16
"SUPPRF53463",3,98,1,81,1,1,80,68,"Pilot 10","Pilot 10: bigger feedback + video",5,"low",13
"SUPPRF53463",4,98,1,94,23,0,71,70,"Pilot 10","Pilot 10: bigger feedback + video",5,"low",24
"SUPPRF53463",5,99,0,56,-15,1,71,82,"Pilot 10","Pilot 10: bigger feedback + video",5,"low",-26
"SUPPRF53463",6,99,0,15,-14,0,29,25,"Pilot 10","Pilot 10: bigger feedback + video",5,"low",-10
"SUPPRF53463",7,98,1,83,12,1,71,22,"Pilot 10","Pilot 10: bigger feedback + video",5,"low",61
"SUPPRF53463",8,99,0,8,-12,1,20,17,"Pilot 10","Pilot 10: bigger feedback + video",5,"low",-9
"SUPPRF53463",9,99,1,22,-15,1,37,31,"Pilot 10","Pilot 10: bigger feedback + video",5,"low",-9
"SUPPRF53463",10,98,2,20,0,1,20,19,"Pilot 10","Pilot 10: bigger feedback + video",5,"low",1
"SUPPRF53463",11,99,1,71,0,1,71,67,"Pilot 10","Pilot 10: bigger feedback + video",5,"low",4
"SUPPRF53463",12,98,1,63,0,1,63,76,"Pilot 10","Pilot 10: bigger feedback + video",5,"low",-13
"SUPPRF53463",13,99,0,47,27,3,20,20,"Pilot 10","Pilot 10: bigger feedback + video",5,"low",27
"SUPPRF53463",14,100,0,29,0,0,29,20,"Pilot 10","Pilot 10: bigger feedback + video",5,"low",9
"SUPPRF53463",15,98,1,80,0,1,80,65,"Pilot 10","Pilot 10: bigger feedback + video",5,"low",15
"SUPPRF53463",16,98,1,47,-16,2,63,67,"Pilot 10","Pilot 10: bigger feedback + video",5,"low",-20
"SUPPRF53463",17,98,1,37,0,3,37,28,"Pilot 10","Pilot 10: bigger feedback + video",5,"low",9
"SUPPRF53463",18,98,1,35,15,5,20,20,"Pilot 10","Pilot 10: bigger feedback + video",5,"low",15
"SUPPRF53463",19,98,1,78,24,6,54,58,"Pilot 10","Pilot 10: bigger feedback + video",5,"low",20
"SUPPRF53463",20,98,1,66,12,6,54,57,"Pilot 10","Pilot 10: bigger feedback + video",5,"low",9
"SUPPRF53463",21,99,1,88,25,5,63,59,"Pilot 10","Pilot 10: bigger feedback + video",5,"low",29
"SUPPRF53463",22,99,1,62,-1,9,63,71,"Pilot 10","Pilot 10: bigger feedback + video",5,"low",-9
"SUPPRF53463",23,97,0,61,24,7,37,43,"Pilot 10","Pilot 10: bigger feedback + video",5,"low",18
"SUPPRF53463",24,99,1,50,-13,6,63,69,"Pilot 10","Pilot 10: bigger feedback + video",5,"low",-19
"SUPPRF53463",25,98,1,45,-1,5,46,47,"Pilot 10","Pilot 10: bigger feedback + video",5,"low",-2
"SUPPRF53463",26,98,0,28,-1,5,29,30,"Pilot 10","Pilot 10: bigger feedback + video",5,"low",-2
"SUPPRF53463",27,99,1,46,17,6,29,26,"Pilot 10","Pilot 10: bigger feedback + video",5,"low",20
"SUPPRF53463",28,99,1,38,-16,5,54,56,"Pilot 10","Pilot 10: bigger feedback + video",5,"low",-18
"SUPPRF53463",29,99,1,16,-13,4,29,26,"Pilot 10","Pilot 10: bigger feedback + video",5,"low",-10
"SUPPRF53463",30,99,1,55,1,8,54,55,"Pilot 10","Pilot 10: bigger feedback + video",5,"low",0
"SUPPRF53463",31,99,0,49,12,5,37,48,"Pilot 10","Pilot 10: bigger feedback + video",5,"low",1
"SUPPRF53463",32,98,1,54,0,8,54,55,"Pilot 10","Pilot 10: bigger feedback + video",5,"low",-1
"SUPPRF53463",33,98,0,34,-12,9,46,45,"Pilot 10","Pilot 10: bigger feedback + video",5,"low",-11
"SUPPRF53463",34,99,1,100,20,7,80,80,"Pilot 10","Pilot 10: bigger feedback + video",5,"low",20
"SUPPRF53463",35,99,0,75,29,6,46,43,"Pilot 10","Pilot 10: bigger feedback + video",5,"low",32
"SUPPRF53463",36,99,1,58,29,6,29,30,"Pilot 10","Pilot 10: bigger feedback + video",5,"low",28
"SUPPRF53463",37,98,1,19,-1,8,20,19,"Pilot 10","Pilot 10: bigger feedback + video",5,"low",0
"SUPPRF53463",38,98,0,33,-13,12,46,48,"Pilot 10","Pilot 10: bigger feedback + video",5,"low",-15
"SUPPRF53463",39,99,2,24,-13,8,37,40,"Pilot 10","Pilot 10: bigger feedback + video",5,"low",-16
"SUPPRF53463",40,100,1,67,-13,10,80,83,"Pilot 10","Pilot 10: bigger feedback + video",5,"low",-16
"SUPPRF53463",41,98,2,41,-13,11,54,54,"Pilot 10","Pilot 10: bigger feedback + video",5,"low",-13
"SUPPRF53463",42,98,1,38,1,8,37,38,"Pilot 10","Pilot 10: bigger feedback + video",5,"low",0
"SUPPRF53463",43,98,0,70,-1,9,71,70,"Pilot 10","Pilot 10: bigger feedback + video",5,"low",0
"SUPPRF53463",44,99,1,68,-12,8,80,83,"Pilot 10","Pilot 10: bigger feedback + video",5,"low",-15
"SUPPRF53463",45,99,0,46,0,7,46,43,"Pilot 10","Pilot 10: bigger feedback + video",5,"low",3
"SUPPRF53463",46,98,2,55,-16,11,71,72,"Pilot 10","Pilot 10: bigger feedback + video",5,"low",-17
"SUPPRF53463",47,98,0,77,14,8,63,66,"Pilot 10","Pilot 10: bigger feedback + video",5,"low",11
"SUPPRF53463",48,99,2,58,12,10,46,65,"Pilot 10","Pilot 10: bigger feedback + video",5,"low",-7
"SUPPRF53834",1,57,50,28,-1,98,29,15,"Pilot 11","Pilot 11: bigger feedback + video + socially anxious",5,"low",13
"SUPPRF53834",2,51,31,35,15,88,20,17,"Pilot 11","Pilot 11: bigger feedback + video + socially anxious",5,"low",18
"SUPPRF53834",3,53,32,37,0,44,37,33,"Pilot 11","Pilot 11: bigger feedback + video + socially anxious",5,"low",4
"SUPPRF53834",4,60,18,100,20,60,80,49,"Pilot 11","Pilot 11: bigger feedback + video + socially anxious",5,"low",51
"SUPPRF53834",5,54,24,62,-1,67,63,58,"Pilot 11","Pilot 11: bigger feedback + video + socially anxious",5,"low",4
"SUPPRF53834",6,55,10,75,29,80,46,42,"Pilot 11","Pilot 11: bigger feedback + video + socially anxious",5,"low",33
"SUPPRF53834",7,58,8,94,23,75,71,37,"Pilot 11","Pilot 11: bigger feedback + video + socially anxious",5,"low",57
"SUPPRF53834",8,62,6,54,0,29,54,64,"Pilot 11","Pilot 11: bigger feedback + video + socially anxious",5,"low",-10
"SUPPRF53834",9,59,11,67,-13,80,80,79,"Pilot 11","Pilot 11: bigger feedback + video + socially anxious",5,"low",-12
"SUPPRF53834",10,60,7,19,-1,92,20,14,"Pilot 11","Pilot 11: bigger feedback + video + socially anxious",5,"low",5
"SUPPRF53834",11,69,3,88,25,78,63,39,"Pilot 11","Pilot 11: bigger feedback + video + socially anxious",5,"low",49
"SUPPRF53834",12,63,4,16,-13,92,29,21,"Pilot 11","Pilot 11: bigger feedback + video + socially anxious",5,"low",-5
"SUPPRF53834",13,56,5,8,-12,78,20,24,"Pilot 11","Pilot 11: bigger feedback + video + socially anxious",5,"low",-16
"SUPPRF53834",14,53,3,46,0,76,46,31,"Pilot 11","Pilot 11: bigger feedback + video + socially anxious",5,"low",15
"SUPPRF53834",15,60,11,38,-16,89,54,51,"Pilot 11","Pilot 11: bigger feedback + video + socially anxious",5,"low",-13
"SUPPRF53834",16,48,5,61,24,59,37,41,"Pilot 11","Pilot 11: bigger feedback + video + socially anxious",5,"low",20
"SUPPRF53834",17,54,2,22,-15,89,37,35,"Pilot 11","Pilot 11: bigger feedback + video + socially anxious",5,"low",-13
"SUPPRF53834",18,60,1,47,-16,49,63,55,"Pilot 11","Pilot 11: bigger feedback + video + socially anxious",5,"low",-8
"SUPPRF53834",19,65,1,77,14,64,63,66,"Pilot 11","Pilot 11: bigger feedback + video + socially anxious",5,"low",11
"SUPPRF53834",20,51,1,38,1,84,37,50,"Pilot 11","Pilot 11: bigger feedback + video + socially anxious",5,"low",-12
"SUPPRF53834",21,58,4,34,-12,26,46,46,"Pilot 11","Pilot 11: bigger feedback + video + socially anxious",5,"low",-12
"SUPPRF53834",22,60,2,47,27,91,20,26,"Pilot 11","Pilot 11: bigger feedback + video + socially anxious",5,"low",21
"SUPPRF53834",23,51,0,56,-15,75,71,76,"Pilot 11","Pilot 11: bigger feedback + video + socially anxious",5,"low",-20
"SUPPRF53834",24,49,0,6,-14,91,20,21,"Pilot 11","Pilot 11: bigger feedback + video + socially anxious",5,"low",-15
"SUPPRF53834",25,53,0,70,-1,63,71,78,"Pilot 11","Pilot 11: bigger feedback + video + socially anxious",5,"low",-8
"SUPPRF53834",26,56,0,71,0,72,71,70,"Pilot 11","Pilot 11: bigger feedback + video + socially anxious",5,"low",1
"SUPPRF53834",27,57,2,45,-1,50,46,55,"Pilot 11","Pilot 11: bigger feedback + video + socially anxious",5,"low",-10
"SUPPRF53834",28,58,1,49,12,87,37,28,"Pilot 11","Pilot 11: bigger feedback + video + socially anxious",5,"low",21
"SUPPRF53834",29,52,4,24,-13,90,37,29,"Pilot 11","Pilot 11: bigger feedback + video + socially anxious",5,"low",-5
"SUPPRF53834",30,55,1,41,-13,61,54,44,"Pilot 11","Pilot 11: bigger feedback + video + socially anxious",5,"low",-3
"SUPPRF53834",31,52,32,46,17,39,29,34,"Pilot 11","Pilot 11: bigger feedback + video + socially anxious",5,"low",12
"SUPPRF53834",32,51,15,66,12,22,54,40,"Pilot 11","Pilot 11: bigger feedback + video + socially anxious",5,"low",26
"SUPPRF53834",33,56,5,58,29,82,29,28,"Pilot 11","Pilot 11: bigger feedback + video + socially anxious",5,"low",30
"SUPPRF53834",34,57,3,15,-14,66,29,22,"Pilot 11","Pilot 11: bigger feedback + video + socially anxious",5,"low",-7
"SUPPRF53834",35,50,2,50,-13,72,63,51,"Pilot 11","Pilot 11: bigger feedback + video + socially anxious",5,"low",-1
"SUPPRF53834",36,45,7,63,0,69,63,55,"Pilot 11","Pilot 11: bigger feedback + video + socially anxious",5,"low",8
"SUPPRF53834",37,51,11,55,-16,59,71,70,"Pilot 11","Pilot 11: bigger feedback + video + socially anxious",5,"low",-15
"SUPPRF53834",38,56,5,80,0,18,80,68,"Pilot 11","Pilot 11: bigger feedback + video + socially anxious",5,"low",12
"SUPPRF53834",39,48,8,33,-13,7,46,55,"Pilot 11","Pilot 11: bigger feedback + video + socially anxious",5,"low",-22
"SUPPRF53834",40,51,6,29,0,32,29,30,"Pilot 11","Pilot 11: bigger feedback + video + socially anxious",5,"low",-1
"SUPPRF53834",41,41,9,20,0,93,20,11,"Pilot 11","Pilot 11: bigger feedback + video + socially anxious",5,"low",9
"SUPPRF53834",42,49,18,96,16,62,80,71,"Pilot 11","Pilot 11: bigger feedback + video + socially anxious",5,"low",25
"SUPPRF53834",43,47,17,58,12,12,46,29,"Pilot 11","Pilot 11: bigger feedback + video + socially anxious",5,"low",29
"SUPPRF53834",44,47,13,83,12,78,71,60,"Pilot 11","Pilot 11: bigger feedback + video + socially anxious",5,"low",23
"SUPPRF53834",45,59,10,78,24,88,54,70,"Pilot 11","Pilot 11: bigger feedback + video + socially anxious",5,"low",8
"SUPPRF53834",46,59,4,81,1,77,80,88,"Pilot 11","Pilot 11: bigger feedback + video + socially anxious",5,"low",-7
"SUPPRF53834",47,47,11,55,1,24,54,64,"Pilot 11","Pilot 11: bigger feedback + video + socially anxious",5,"low",-9
"SUPPRF53834",48,50,6,68,-12,75,80,68,"Pilot 11","Pilot 11: bigger feedback + video + socially anxious",5,"low",0
"SUPPRF53839",1,77,64,78,24,38,54,26,"Pilot 8","Pilot 8: max feedback + text",9,"high",52
"SUPPRF53839",2,69,61,41,-13,62,54,31,"Pilot 8","Pilot 8: max feedback + text",9,"high",10
"SUPPRF53839",3,27,49,28,-1,5,29,28,"Pilot 8","Pilot 8: max feedback + text",9,"high",0
"SUPPRF53839",4,48,53,56,-15,26,71,35,"Pilot 8","Pilot 8: max feedback + text",9,"high",21
"SUPPRF53839",5,34,51,16,-13,72,29,31,"Pilot 8","Pilot 8: max feedback + text",9,"high",-15
"SUPPRF53839",6,50,49,63,0,81,63,80,"Pilot 8","Pilot 8: max feedback + text",9,"high",-17
"SUPPRF53839",7,48,47,49,12,1,37,23,"Pilot 8","Pilot 8: max feedback + text",9,"high",26
"SUPPRF53839",8,37,37,45,-1,50,46,41,"Pilot 8","Pilot 8: max feedback + text",9,"high",4
"SUPPRF53839",9,45,63,24,-13,20,37,35,"Pilot 8","Pilot 8: max feedback + text",9,"high",-11
"SUPPRF53839",10,95,31,100,20,68,80,78,"Pilot 8","Pilot 8: max feedback + text",9,"high",22
"SUPPRF53839",11,78,37,29,0,73,29,11,"Pilot 8","Pilot 8: max feedback + text",9,"high",18
"SUPPRF53839",12,33,72,61,24,8,37,72,"Pilot 8","Pilot 8: max feedback + text",9,"high",-11
"SUPPRF53839",13,30,52,62,-1,86,63,95,"Pilot 8","Pilot 8: max feedback + text",9,"high",-33
"SUPPRF53839",14,41,60,33,-13,20,46,52,"Pilot 8","Pilot 8: max feedback + text",9,"high",-19
"SUPPRF53839",15,34,42,38,1,20,37,23,"Pilot 8","Pilot 8: max feedback + text",9,"high",15
"SUPPRF53839",16,52,42,58,12,35,46,29,"Pilot 8","Pilot 8: max feedback + text",9,"high",29
"SUPPRF53839",17,47,47,88,25,72,63,66,"Pilot 8","Pilot 8: max feedback + text",9,"high",22
"SUPPRF53839",18,44,51,68,-12,87,80,89,"Pilot 8","Pilot 8: max feedback + text",9,"high",-21
"SUPPRF53839",19,24,28,38,-16,69,54,71,"Pilot 8","Pilot 8: max feedback + text",9,"high",-33
"SUPPRF53839",20,11,66,8,-12,74,20,15,"Pilot 8","Pilot 8: max feedback + text",9,"high",-7
"SUPPRF53839",21,23,62,20,0,89,20,10,"Pilot 8","Pilot 8: max feedback + text",9,"high",10
"SUPPRF53839",22,19,75,55,-16,75,71,74,"Pilot 8","Pilot 8: max feedback + text",9,"high",-19
"SUPPRF53839",23,23,78,50,-13,57,63,54,"Pilot 8","Pilot 8: max feedback + text",9,"high",-4
"SUPPRF53839",24,78,21,96,16,65,80,77,"Pilot 8","Pilot 8: max feedback + text",9,"high",19
"SUPPRF53839",25,21,77,34,-12,71,46,40,"Pilot 8","Pilot 8: max feedback + text",9,"high",-6
"SUPPRF53839",26,82,71,80,0,72,80,37,"Pilot 8","Pilot 8: max feedback + text",9,"high",43
"SUPPRF53839",27,40,77,55,1,83,54,75,"Pilot 8","Pilot 8: max feedback + text",9,"high",-20
"SUPPRF53839",28,14,87,6,-14,78,20,19,"Pilot 8","Pilot 8: max feedback + text",9,"high",-13
"SUPPRF53839",29,24,75,54,0,79,54,64,"Pilot 8","Pilot 8: max feedback + text",9,"high",-10
"SUPPRF53839",30,38,63,58,29,2,29,56,"Pilot 8","Pilot 8: max feedback + text",9,"high",2
"SUPPRF53839",31,75,55,77,14,40,63,43,"Pilot 8","Pilot 8: max feedback + text",9,"high",34
"SUPPRF53839",32,57,67,81,1,62,80,61,"Pilot 8","Pilot 8: max feedback + text",9,"high",20
"SUPPRF53839",33,52,65,22,-15,0,37,49,"Pilot 8","Pilot 8: max feedback + text",9,"high",-27
"SUPPRF53839",34,75,54,19,-1,6,20,14,"Pilot 8","Pilot 8: max feedback + text",9,"high",5
"SUPPRF53839",35,91,59,94,23,77,71,63,"Pilot 8","Pilot 8: max feedback + text",9,"high",31
"SUPPRF53839",36,88,47,83,12,69,71,65,"Pilot 8","Pilot 8: max feedback + text",9,"high",18
"SUPPRF53839",37,61,72,47,-16,60,63,45,"Pilot 8","Pilot 8: max feedback + text",9,"high",2
"SUPPRF53839",38,65,73,66,12,44,54,38,"Pilot 8","Pilot 8: max feedback + text",9,"high",28
"SUPPRF53839",39,68,48,75,29,75,46,64,"Pilot 8","Pilot 8: max feedback + text",9,"high",11
"SUPPRF53839",40,57,49,46,0,57,46,61,"Pilot 8","Pilot 8: max feedback + text",9,"high",-15
"SUPPRF53839",41,60,49,67,-13,93,80,84,"Pilot 8","Pilot 8: max feedback + text",9,"high",-17
"SUPPRF53839",42,73,73,35,15,58,20,11,"Pilot 8","Pilot 8: max feedback + text",9,"high",24
"SUPPRF53839",43,57,63,46,17,55,29,57,"Pilot 8","Pilot 8: max feedback + text",9,"high",-11
"SUPPRF53839",44,54,55,47,27,81,20,8,"Pilot 8","Pilot 8: max feedback + text",9,"high",39
"SUPPRF53839",45,39,64,70,-1,60,71,58,"Pilot 8","Pilot 8: max feedback + text",9,"high",12
"SUPPRF53839",46,70,73,37,0,64,37,22,"Pilot 8","Pilot 8: max feedback + text",9,"high",15
"SUPPRF53839",47,45,62,71,0,44,71,52,"Pilot 8","Pilot 8: max feedback + text",9,"high",19
"SUPPRF53839",48,63,70,15,-14,75,29,51,"Pilot 8","Pilot 8: max feedback + text",9,"high",-36
"SUPPRF54185",1,69,11,58,29,68,29,34,"Pilot 10","Pilot 10: bigger feedback + video",0,"low",24
"SUPPRF54185",2,70,10,46,0,64,46,63,"Pilot 10","Pilot 10: bigger feedback + video",0,"low",-17
"SUPPRF54185",3,68,5,83,12,58,71,66,"Pilot 10","Pilot 10: bigger feedback + video",0,"low",17
"SUPPRF54185",4,69,9,41,-13,55,54,62,"Pilot 10","Pilot 10: bigger feedback + video",0,"low",-21
"SUPPRF54185",5,70,5,67,-13,49,80,65,"Pilot 10","Pilot 10: bigger feedback + video",0,"low",2
"SUPPRF54185",6,71,7,16,-13,49,29,60,"Pilot 10","Pilot 10: bigger feedback + video",0,"low",-44
"SUPPRF54185",7,69,6,88,25,47,63,55,"Pilot 10","Pilot 10: bigger feedback + video",0,"low",33
"SUPPRF54185",8,67,3,71,0,49,71,67,"Pilot 10","Pilot 10: bigger feedback + video",0,"low",4
"SUPPRF54185",9,70,7,22,-15,56,37,62,"Pilot 10","Pilot 10: bigger feedback + video",0,"low",-40
"SUPPRF54185",10,75,8,56,-15,62,71,70,"Pilot 10","Pilot 10: bigger feedback + video",0,"low",-14
"SUPPRF54185",11,74,6,38,1,61,37,66,"Pilot 10","Pilot 10: bigger feedback + video",0,"low",-28
"SUPPRF54185",12,72,5,80,0,60,80,47,"Pilot 10","Pilot 10: bigger feedback + video",0,"low",33
"SUPPRF54185",13,67,6,28,-1,67,29,52,"Pilot 10","Pilot 10: bigger feedback + video",0,"low",-24
"SUPPRF54185",14,68,4,29,0,68,29,30,"Pilot 10","Pilot 10: bigger feedback + video",0,"low",-1
"SUPPRF54185",15,68,6,94,23,54,71,52,"Pilot 10","Pilot 10: bigger feedback + video",0,"low",42
"SUPPRF54185",16,70,6,77,14,66,63,59,"Pilot 10","Pilot 10: bigger feedback + video",0,"low",18
"SUPPRF54185",17,69,6,37,0,49,37,62,"Pilot 10","Pilot 10: bigger feedback + video",0,"low",-25
"SUPPRF54185",18,70,6,61,24,64,37,53,"Pilot 10","Pilot 10: bigger feedback + video",0,"low",8
"SUPPRF54185",19,72,4,24,-13,62,37,46,"Pilot 10","Pilot 10: bigger feedback + video",0,"low",-22
"SUPPRF54185",20,70,8,70,-1,62,71,54,"Pilot 10","Pilot 10: bigger feedback + video",0,"low",16
"SUPPRF54185",21,71,4,46,17,68,29,66,"Pilot 10","Pilot 10: bigger feedback + video",0,"low",-20
"SUPPRF54185",22,73,8,8,-12,16,20,64,"Pilot 10","Pilot 10: bigger feedback + video",0,"low",-56
"SUPPRF54185",23,75,9,55,1,63,54,59,"Pilot 10","Pilot 10: bigger feedback + video",0,"low",-4
"SUPPRF54185",24,84,6,47,-16,5,63,58,"Pilot 10","Pilot 10: bigger feedback + video",0,"low",-11
"SUPPRF54185",25,74,5,62,-1,63,63,53,"Pilot 10","Pilot 10: bigger feedback + video",0,"low",9
"SUPPRF54185",26,73,5,63,0,57,63,58,"Pilot 10","Pilot 10: bigger feedback + video",0,"low",5
"SUPPRF54185",27,84,5,33,-13,64,46,54,"Pilot 10","Pilot 10: bigger feedback + video",0,"low",-21
"SUPPRF54185",28,71,6,45,-1,67,46,64,"Pilot 10","Pilot 10: bigger feedback + video",0,"low",-19
"SUPPRF54185",29,82,6,81,1,81,80,82,"Pilot 10","Pilot 10: bigger feedback + video",0,"low",-1
"SUPPRF54185",30,79,6,6,-14,19,20,67,"Pilot 10","Pilot 10: bigger feedback + video",0,"low",-61
"SUPPRF54185",31,78,10,15,-14,59,29,23,"Pilot 10","Pilot 10: bigger feedback + video",0,"low",-8
"SUPPRF54185",32,77,4,35,15,60,20,63,"Pilot 10","Pilot 10: bigger feedback + video",0,"low",-28
"SUPPRF54185",33,69,4,100,20,70,80,76,"Pilot 10","Pilot 10: bigger feedback + video",0,"low",24
"SUPPRF54185",34,73,7,96,16,74,80,79,"Pilot 10","Pilot 10: bigger feedback + video",0,"low",17
"SUPPRF54185",35,72,1,34,-12,62,46,52,"Pilot 10","Pilot 10: bigger feedback + video",0,"low",-18
"SUPPRF54185",36,74,6,50,-13,56,63,66,"Pilot 10","Pilot 10: bigger feedback + video",0,"low",-16
"SUPPRF54185",37,4,5,54,0,62,54,54,"Pilot 10","Pilot 10: bigger feedback + video",0,"low",0
"SUPPRF54185",38,59,9,58,12,55,46,55,"Pilot 10","Pilot 10: bigger feedback + video",0,"low",3
"SUPPRF54185",39,63,9,75,29,53,46,55,"Pilot 10","Pilot 10: bigger feedback + video",0,"low",20
"SUPPRF54185",40,61,5,38,-16,60,54,56,"Pilot 10","Pilot 10: bigger feedback + video",0,"low",-18
"SUPPRF54185",41,59,5,47,27,59,20,14,"Pilot 10","Pilot 10: bigger feedback + video",0,"low",33
"SUPPRF54185",42,61,2,20,0,61,20,15,"Pilot 10","Pilot 10: bigger feedback + video",0,"low",5
"SUPPRF54185",43,4,4,68,-12,78,80,73,"Pilot 10","Pilot 10: bigger feedback + video",0,"low",-5
"SUPPRF54185",44,53,5,78,24,53,54,54,"Pilot 10","Pilot 10: bigger feedback + video",0,"low",24
"SUPPRF54185",45,61,6,66,12,54,54,53,"Pilot 10","Pilot 10: bigger feedback + video",0,"low",13
"SUPPRF54185",46,47,5,49,12,53,37,58,"Pilot 10","Pilot 10: bigger feedback + video",0,"low",-9
"SUPPRF54185",47,10,7,19,-1,52,20,30,"Pilot 10","Pilot 10: bigger feedback + video",0,"low",-11
"SUPPRF54185",48,15,5,55,-16,58,71,62,"Pilot 10","Pilot 10: bigger feedback + video",0,"low",-7
"SUPPRF54374",1,99,0,28,-1,69,29,21,"Pilot 6","Pilot 6: feedback + text",3,"low",7
"SUPPRF54374",2,99,1,29,0,89,29,27,"Pilot 6","Pilot 6: feedback + text",3,"low",2
"SUPPRF54374",3,99,1,41,-13,74,54,55,"Pilot 6","Pilot 6: feedback + text",3,"low",-14
"SUPPRF54374",4,99,1,51,14,74,37,41,"Pilot 6","Pilot 6: feedback + text",3,"low",10
"SUPPRF54374",5,99,0,46,0,81,46,57,"Pilot 6","Pilot 6: feedback + text",3,"low",-11
"SUPPRF54374",6,99,0,56,-15,82,71,65,"Pilot 6","Pilot 6: feedback + text",3,"low",-9
"SUPPRF54374",7,100,2,47,-16,84,63,67,"Pilot 6","Pilot 6: feedback + text",3,"low",-20
"SUPPRF54374",8,100,1,54,0,78,54,53,"Pilot 6","Pilot 6: feedback + text",3,"low",1
"SUPPRF54374",9,100,1,46,17,83,29,28,"Pilot 6","Pilot 6: feedback + text",3,"low",18
"SUPPRF54374",10,85,1,24,-13,81,37,26,"Pilot 6","Pilot 6: feedback + text",3,"low",-2
"SUPPRF54374",11,82,1,71,0,72,71,73,"Pilot 6","Pilot 6: feedback + text",3,"low",-2
"SUPPRF54374",12,85,3,22,-15,71,37,24,"Pilot 6","Pilot 6: feedback + text",3,"low",-2
"SUPPRF54374",13,75,7,8,-12,63,20,51,"Pilot 6","Pilot 6: feedback + text",3,"low",-43
"SUPPRF54374",14,73,8,62,-1,88,63,72,"Pilot 6","Pilot 6: feedback + text",3,"low",-10
"SUPPRF54374",15,83,7,33,-13,76,46,27,"Pilot 6","Pilot 6: feedback + text",3,"low",6
"SUPPRF54374",16,79,7,34,-12,77,46,11,"Pilot 6","Pilot 6: feedback + text",3,"low",23
"SUPPRF54374",17,87,8,70,-1,60,71,23,"Pilot 6","Pilot 6: feedback + text",3,"low",47
"SUPPRF54374",18,88,12,45,-1,73,46,46,"Pilot 6","Pilot 6: feedback + text",3,"low",-1
"SUPPRF54374",19,83,9,6,-14,89,20,14,"Pilot 6","Pilot 6: feedback + text",3,"low",-8
"SUPPRF54374",20,82,8,16,-13,81,29,13,"Pilot 6","Pilot 6: feedback + text",3,"low",3
"SUPPRF54374",21,91,10,37,17,81,20,8,"Pilot 6","Pilot 6: feedback + text",3,"low",29
"SUPPRF54374",22,87,13,63,0,59,63,59,"Pilot 6","Pilot 6: feedback + text",3,"low",4
"SUPPRF54374",23,82,21,66,12,50,54,50,"Pilot 6","Pilot 6: feedback + text",3,"low",16
"SUPPRF54374",24,81,10,35,15,81,20,14,"Pilot 6","Pilot 6: feedback + text",3,"low",21
"SUPPRF54374",25,81,9,55,1,80,54,57,"Pilot 6","Pilot 6: feedback + text",3,"low",-2
"SUPPRF54374",26,89,4,97,17,75,80,74,"Pilot 6","Pilot 6: feedback + text",3,"low",23
"SUPPRF54374",27,86,8,78,15,68,63,68,"Pilot 6","Pilot 6: feedback + text",3,"low",10
"SUPPRF54374",28,82,12,48,19,73,29,21,"Pilot 6","Pilot 6: feedback + text",3,"low",27
"SUPPRF54374",29,76,10,49,12,81,37,20,"Pilot 6","Pilot 6: feedback + text",3,"low",29
"SUPPRF54374",30,84,12,58,12,77,46,26,"Pilot 6","Pilot 6: feedback + text",3,"low",32
"SUPPRF54374",31,77,13,50,-13,73,63,85,"Pilot 6","Pilot 6: feedback + text",3,"low",-35
"SUPPRF54374",32,79,8,15,-14,66,29,17,"Pilot 6","Pilot 6: feedback + text",3,"low",-2
"SUPPRF54374",33,81,83,20,0,90,20,13,"Pilot 6","Pilot 6: feedback + text",3,"low",7
"SUPPRF54374",34,72,28,19,-1,81,20,8,"Pilot 6","Pilot 6: feedback + text",3,"low",11
"SUPPRF54374",35,79,17,65,19,74,46,41,"Pilot 6","Pilot 6: feedback + text",3,"low",24
"SUPPRF54374",36,83,17,84,13,78,71,52,"Pilot 6","Pilot 6: feedback + text",3,"low",32
"SUPPRF54374",37,80,12,77,14,68,63,71,"Pilot 6","Pilot 6: feedback + text",3,"low",6
"SUPPRF54374",38,84,8,37,0,79,37,35,"Pilot 6","Pilot 6: feedback + text",3,"low",2
"SUPPRF54374",39,91,8,38,-16,82,54,54,"Pilot 6","Pilot 6: feedback + text",3,"low",-16
"SUPPRF54374",40,86,9,83,12,87,71,70,"Pilot 6","Pilot 6: feedback + text",3,"low",13
"SUPPRF54374",41,86,9,38,1,82,37,41,"Pilot 6","Pilot 6: feedback + text",3,"low",-3
"SUPPRF54374",42,85,12,81,1,81,80,78,"Pilot 6","Pilot 6: feedback + text",3,"low",3
"SUPPRF54374",43,92,9,68,-12,78,80,70,"Pilot 6","Pilot 6: feedback + text",3,"low",-2
"SUPPRF54374",44,82,11,67,-13,85,80,76,"Pilot 6","Pilot 6: feedback + text",3,"low",-9
"SUPPRF54374",45,81,13,55,-16,71,71,62,"Pilot 6","Pilot 6: feedback + text",3,"low",-7
"SUPPRF54374",46,84,12,80,0,66,80,59,"Pilot 6","Pilot 6: feedback + text",3,"low",21
"SUPPRF54374",47,86,11,68,14,72,54,53,"Pilot 6","Pilot 6: feedback + text",3,"low",15
"SUPPRF54374",48,79,16,96,16,81,80,67,"Pilot 6","Pilot 6: feedback + text",3,"low",29
"SUPPRF54475",1,40,57,62,-1,79,63,73,"Pilot 9","Pilot 9: bigger feedback + text",3,"low",-11
"SUPPRF54475",2,22,70,68,-12,68,80,86,"Pilot 9","Pilot 9: bigger feedback + text",3,"low",-18
"SUPPRF54475",3,12,78,6,-14,67,20,16,"Pilot 9","Pilot 9: bigger feedback + text",3,"low",-10
"SUPPRF54475",4,6,75,16,-13,63,29,34,"Pilot 9","Pilot 9: bigger feedback + text",3,"low",-18
"SUPPRF54475",5,85,38,94,23,69,71,67,"Pilot 9","Pilot 9: bigger feedback + text",3,"low",27
"SUPPRF54475",6,58,64,49,12,71,37,22,"Pilot 9","Pilot 9: bigger feedback + text",3,"low",27
"SUPPRF54475",7,41,52,50,-13,47,63,57,"Pilot 9","Pilot 9: bigger feedback + text",3,"low",-7
"SUPPRF54475",8,58,30,71,0,60,71,58,"Pilot 9","Pilot 9: bigger feedback + text",3,"low",13
"SUPPRF54475",9,49,56,55,1,63,54,41,"Pilot 9","Pilot 9: bigger feedback + text",3,"low",14
"SUPPRF54475",10,43,51,54,0,49,54,34,"Pilot 9","Pilot 9: bigger feedback + text",3,"low",20
"SUPPRF54475",11,31,60,38,1,41,37,39,"Pilot 9","Pilot 9: bigger feedback + text",3,"low",-1
"SUPPRF54475",12,18,59,28,-1,37,29,37,"Pilot 9","Pilot 9: bigger feedback + text",3,"low",-9
"SUPPRF54475",13,80,4,100,20,78,80,72,"Pilot 9","Pilot 9: bigger feedback + text",3,"low",28
"SUPPRF54475",14,39,40,35,15,52,20,24,"Pilot 9","Pilot 9: bigger feedback + text",3,"low",11
"SUPPRF54475",15,57,38,70,-1,54,71,51,"Pilot 9","Pilot 9: bigger feedback + text",3,"low",19
"SUPPRF54475",16,66,44,61,24,57,37,29,"Pilot 9","Pilot 9: bigger feedback + text",3,"low",32
"SUPPRF54475",17,49,45,45,-1,46,46,49,"Pilot 9","Pilot 9: bigger feedback + text",3,"low",-4
"SUPPRF54475",18,64,33,47,27,65,20,11,"Pilot 9","Pilot 9: bigger feedback + text",3,"low",36
"SUPPRF54475",19,45,40,20,0,63,20,17,"Pilot 9","Pilot 9: bigger feedback + text",3,"low",3
"SUPPRF54475",20,22,60,56,-15,79,71,76,"Pilot 9","Pilot 9: bigger feedback + text",3,"low",-20
"SUPPRF54475",21,41,53,29,0,63,29,22,"Pilot 9","Pilot 9: bigger feedback + text",3,"low",7
"SUPPRF54475",22,53,29,33,-13,52,46,20,"Pilot 9","Pilot 9: bigger feedback + text",3,"low",13
"SUPPRF54475",23,46,42,66,12,58,54,42,"Pilot 9","Pilot 9: bigger feedback + text",3,"low",24
"SUPPRF54475",24,21,57,67,-13,64,80,86,"Pilot 9","Pilot 9: bigger feedback + text",3,"low",-19
"SUPPRF54475",25,54,42,80,0,39,80,54,"Pilot 9","Pilot 9: bigger feedback + text",3,"low",26
"SUPPRF54475",26,74,34,88,25,49,63,45,"Pilot 9","Pilot 9: bigger feedback + text",3,"low",43
"SUPPRF54475",27,45,53,41,-13,38,54,46,"Pilot 9","Pilot 9: bigger feedback + text",3,"low",-5
"SUPPRF54475",28,58,42,81,1,74,80,71,"Pilot 9","Pilot 9: bigger feedback + text",3,"low",10
"SUPPRF54475",29,58,28,83,12,54,71,56,"Pilot 9","Pilot 9: bigger feedback + text",3,"low",27
"SUPPRF54475",30,60,33,46,0,35,46,34,"Pilot 9","Pilot 9: bigger feedback + text",3,"low",12
"SUPPRF54475",31,60,14,8,-12,39,20,21,"Pilot 9","Pilot 9: bigger feedback + text",3,"low",-13
"SUPPRF54475",32,65,25,37,0,28,37,14,"Pilot 9","Pilot 9: bigger feedback + text",3,"low",23
"SUPPRF54475",33,51,31,46,17,57,29,26,"Pilot 9","Pilot 9: bigger feedback + text",3,"low",20
"SUPPRF54475",34,25,28,15,-14,36,29,59,"Pilot 9","Pilot 9: bigger feedback + text",3,"low",-44
"SUPPRF54475",35,82,30,58,29,61,29,10,"Pilot 9","Pilot 9: bigger feedback + text",3,"low",48
"SUPPRF54475",36,70,4,63,0,59,63,64,"Pilot 9","Pilot 9: bigger feedback + text",3,"low",-1
"SUPPRF54475",37,60,20,75,29,48,46,34,"Pilot 9","Pilot 9: bigger feedback + text",3,"low",41
"SUPPRF54475",38,41,31,38,-16,62,54,50,"Pilot 9","Pilot 9: bigger feedback + text",3,"low",-12
"SUPPRF54475",39,36,63,22,-15,56,37,41,"Pilot 9","Pilot 9: bigger feedback + text",3,"low",-19
"SUPPRF54475",40,63,15,78,24,48,54,52,"Pilot 9","Pilot 9: bigger feedback + text",3,"low",26
"SUPPRF54475",41,67,39,55,-16,43,71,61,"Pilot 9","Pilot 9: bigger feedback + text",3,"low",-6
"SUPPRF54475",42,69,24,24,-13,58,37,34,"Pilot 9","Pilot 9: bigger feedback + text",3,"low",-10
"SUPPRF54475",43,41,47,47,-16,63,63,55,"Pilot 9","Pilot 9: bigger feedback + text",3,"low",-8
"SUPPRF54475",44,70,23,96,16,70,80,66,"Pilot 9","Pilot 9: bigger feedback + text",3,"low",30
"SUPPRF54475",45,51,48,58,12,51,46,60,"Pilot 9","Pilot 9: bigger feedback + text",3,"low",-2
"SUPPRF54475",46,60,27,77,14,56,63,64,"Pilot 9","Pilot 9: bigger feedback + text",3,"low",13
"SUPPRF54475",47,46,48,19,-1,53,20,11,"Pilot 9","Pilot 9: bigger feedback + text",3,"low",8
"SUPPRF54475",48,36,64,34,-12,43,46,50,"Pilot 9","Pilot 9: bigger feedback + text",3,"low",-16
"SUPPRF54483",1,64,74,77,14,79,63,25,"Pilot 11","Pilot 11: bigger feedback + video + socially anxious",12,"high",52
"SUPPRF54483",2,63,75,66,12,84,54,36,"Pilot 11","Pilot 11: bigger feedback + video + socially anxious",12,"high",30
"SUPPRF54483",3,54,46,75,29,67,46,37,"Pilot 11","Pilot 11: bigger feedback + video + socially anxious",12,"high",38
"SUPPRF54483",4,70,10,96,16,98,80,4,"Pilot 11","Pilot 11: bigger feedback + video + socially anxious",12,"high",92
"SUPPRF54483",5,50,27,68,-12,57,80,29,"Pilot 11","Pilot 11: bigger feedback + video + socially anxious",12,"high",39
"SUPPRF54483",6,65,24,46,17,14,29,59,"Pilot 11","Pilot 11: bigger feedback + video + socially anxious",12,"high",-13
"SUPPRF54483",7,59,16,15,-14,98,29,15,"Pilot 11","Pilot 11: bigger feedback + video + socially anxious",12,"high",0
"SUPPRF54483",8,57,11,83,12,78,71,46,"Pilot 11","Pilot 11: bigger feedback + video + socially anxious",12,"high",37
"SUPPRF54483",9,54,33,41,-13,78,54,54,"Pilot 11","Pilot 11: bigger feedback + video + socially anxious",12,"high",-13
"SUPPRF54483",10,68,74,20,0,11,20,18,"Pilot 11","Pilot 11: bigger feedback + video + socially anxious",12,"high",2
"SUPPRF54483",11,59,62,88,25,13,63,63,"Pilot 11","Pilot 11: bigger feedback + video + socially anxious",12,"high",25
"SUPPRF54483",12,53,34,46,0,88,46,33,"Pilot 11","Pilot 11: bigger feedback + video + socially anxious",12,"high",13
"SUPPRF54483",13,46,30,8,-12,99,20,23,"Pilot 11","Pilot 11: bigger feedback + video + socially anxious",12,"high",-15
"SUPPRF54483",14,52,64,28,-1,70,29,22,"Pilot 11","Pilot 11: bigger feedback + video + socially anxious",12,"high",6
"SUPPRF54483",15,58,37,55,1,72,54,42,"Pilot 11","Pilot 11: bigger feedback + video + socially anxious",12,"high",13
"SUPPRF54483",16,58,58,19,-1,98,20,3,"Pilot 11","Pilot 11: bigger feedback + video + socially anxious",12,"high",16
"SUPPRF54483",17,52,68,55,-16,84,71,53,"Pilot 11","Pilot 11: bigger feedback + video + socially anxious",12,"high",2
"SUPPRF54483",18,67,31,100,20,37,80,58,"Pilot 11","Pilot 11: bigger feedback + video + socially anxious",12,"high",42
"SUPPRF54483",19,63,30,62,-1,63,63,68,"Pilot 11","Pilot 11: bigger feedback + video + socially anxious",12,"high",-6
"SUPPRF54483",20,56,36,16,-13,95,29,15,"Pilot 11","Pilot 11: bigger feedback + video + socially anxious",12,"high",1
"SUPPRF54483",21,51,57,94,23,31,71,66,"Pilot 11","Pilot 11: bigger feedback + video + socially anxious",12,"high",28
"SUPPRF54483",22,50,39,47,-16,73,63,48,"Pilot 11","Pilot 11: bigger feedback + video + socially anxious",12,"high",-1
"SUPPRF54483",23,48,34,56,-15,98,71,63,"Pilot 11","Pilot 11: bigger feedback + video + socially anxious",12,"high",-7
"SUPPRF54483",24,23,57,6,-14,97,20,16,"Pilot 11","Pilot 11: bigger feedback + video + socially anxious",12,"high",-10
"SUPPRF54483",25,57,27,71,0,8,71,44,"Pilot 11","Pilot 11: bigger feedback + video + socially anxious",12,"high",27
"SUPPRF54483",26,67,33,58,12,32,46,52,"Pilot 11","Pilot 11: bigger feedback + video + socially anxious",12,"high",6
"SUPPRF54483",27,43,49,34,-12,93,46,15,"Pilot 11","Pilot 11: bigger feedback + video + socially anxious",12,"high",19
"SUPPRF54483",28,71,13,38,1,93,37,3,"Pilot 11","Pilot 11: bigger feedback + video + socially anxious",12,"high",35
"SUPPRF54483",29,88,32,80,0,85,80,71,"Pilot 11","Pilot 11: bigger feedback + video + socially anxious",12,"high",9
"SUPPRF54483",30,61,20,70,-1,76,71,25,"Pilot 11","Pilot 11: bigger feedback + video + socially anxious",12,"high",45
"SUPPRF54483",31,80,26,67,-13,88,80,61,"Pilot 11","Pilot 11: bigger feedback + video + socially anxious",12,"high",6
"SUPPRF54483",32,54,39,37,0,24,37,48,"Pilot 11","Pilot 11: bigger feedback + video + socially anxious",12,"high",-11
"SUPPRF54483",33,70,23,58,29,94,29,24,"Pilot 11","Pilot 11: bigger feedback + video + socially anxious",12,"high",34
"SUPPRF54483",34,68,25,47,27,65,20,16,"Pilot 11","Pilot 11: bigger feedback + video + socially anxious",12,"high",31
"SUPPRF54483",35,83,24,81,1,94,80,10,"Pilot 11","Pilot 11: bigger feedback + video + socially anxious",12,"high",71
"SUPPRF54483",36,13,47,24,-13,96,37,65,"Pilot 11","Pilot 11: bigger feedback + video + socially anxious",12,"high",-41
"SUPPRF54483",37,71,32,50,-13,98,63,2,"Pilot 11","Pilot 11: bigger feedback + video + socially anxious",12,"high",48
"SUPPRF54483",38,60,24,63,0,29,63,55,"Pilot 11","Pilot 11: bigger feedback + video + socially anxious",12,"high",8
"SUPPRF54483",39,52,17,78,24,85,54,41,"Pilot 11","Pilot 11: bigger feedback + video + socially anxious",12,"high",37
"SUPPRF54483",40,52,19,45,-1,93,46,26,"Pilot 11","Pilot 11: bigger feedback + video + socially anxious",12,"high",19
"SUPPRF54483",41,61,23,61,24,57,37,28,"Pilot 11","Pilot 11: bigger feedback + video + socially anxious",12,"high",33
"SUPPRF54483",42,39,16,22,-15,8,37,56,"Pilot 11","Pilot 11: bigger feedback + video + socially anxious",12,"high",-34
"SUPPRF54483",43,57,30,35,15,78,20,12,"Pilot 11","Pilot 11: bigger feedback + video + socially anxious",12,"high",23
"SUPPRF54483",44,52,29,38,-16,62,54,54,"Pilot 11","Pilot 11: bigger feedback + video + socially anxious",12,"high",-16
"SUPPRF54483",45,38,32,49,12,89,37,50,"Pilot 11","Pilot 11: bigger feedback + video + socially anxious",12,"high",-1
"SUPPRF54483",46,52,34,54,0,86,54,54,"Pilot 11","Pilot 11: bigger feedback + video + socially anxious",12,"high",0
"SUPPRF54483",47,50,24,29,0,27,29,23,"Pilot 11","Pilot 11: bigger feedback + video + socially anxious",12,"high",6
"SUPPRF54483",48,33,55,33,-13,76,46,47,"Pilot 11","Pilot 11: bigger feedback + video + socially anxious",12,"high",-14
"SUPPRF54929",1,59,57,35,15,82,20,34,"Pilot 11","Pilot 11: bigger feedback + video + socially anxious",2,"low",1
"SUPPRF54929",2,22,26,6,-14,75,20,40,"Pilot 11","Pilot 11: bigger feedback + video + socially anxious",2,"low",-34
"SUPPRF54929",3,32,68,61,24,71,37,35,"Pilot 11","Pilot 11: bigger feedback + video + socially anxious",2,"low",26
"SUPPRF54929",4,69,62,78,24,65,54,50,"Pilot 11","Pilot 11: bigger feedback + video + socially anxious",2,"low",28
"SUPPRF54929",5,82,27,83,12,89,71,82,"Pilot 11","Pilot 11: bigger feedback + video + socially anxious",2,"low",1
"SUPPRF54929",6,57,67,20,0,19,20,14,"Pilot 11","Pilot 11: bigger feedback + video + socially anxious",2,"low",6
"SUPPRF54929",7,19,27,16,-13,38,29,22,"Pilot 11","Pilot 11: bigger feedback + video + socially anxious",2,"low",-6
"SUPPRF54929",8,66,30,71,0,65,71,62,"Pilot 11","Pilot 11: bigger feedback + video + socially anxious",2,"low",9
"SUPPRF54929",9,57,23,22,-15,70,37,25,"Pilot 11","Pilot 11: bigger feedback + video + socially anxious",2,"low",-3
"SUPPRF54929",10,58,18,49,12,21,37,16,"Pilot 11","Pilot 11: bigger feedback + video + socially anxious",2,"low",33
"SUPPRF54929",11,22,33,56,-15,87,71,66,"Pilot 11","Pilot 11: bigger feedback + video + socially anxious",2,"low",-10
"SUPPRF54929",12,32,18,38,-16,34,54,55,"Pilot 11","Pilot 11: bigger feedback + video + socially anxious",2,"low",-17
"SUPPRF54929",13,89,19,24,-13,34,37,25,"Pilot 11","Pilot 11: bigger feedback + video + socially anxious",2,"low",-1
"SUPPRF54929",14,22,12,77,14,7,63,42,"Pilot 11","Pilot 11: bigger feedback + video + socially anxious",2,"low",35
"SUPPRF54929",15,74,17,66,12,29,54,42,"Pilot 11","Pilot 11: bigger feedback + video + socially anxious",2,"low",24
"SUPPRF54929",16,73,15,94,23,19,71,70,"Pilot 11","Pilot 11: bigger feedback + video + socially anxious",2,"low",24
"SUPPRF54929",17,62,20,55,1,80,54,40,"Pilot 11","Pilot 11: bigger feedback + video + socially anxious",2,"low",15
"SUPPRF54929",18,17,30,8,-12,16,20,16,"Pilot 11","Pilot 11: bigger feedback + video + socially anxious",2,"low",-8
"SUPPRF54929",19,34,26,33,-13,68,46,40,"Pilot 11","Pilot 11: bigger feedback + video + socially anxious",2,"low",-7
"SUPPRF54929",20,95,23,100,20,92,80,82,"Pilot 11","Pilot 11: bigger feedback + video + socially anxious",2,"low",18
"SUPPRF54929",21,37,33,67,-13,26,80,81,"Pilot 11","Pilot 11: bigger feedback + video + socially anxious",2,"low",-14
"SUPPRF54929",22,72,25,45,-1,59,46,35,"Pilot 11","Pilot 11: bigger feedback + video + socially anxious",2,"low",10
"SUPPRF54929",23,70,28,29,0,72,29,35,"Pilot 11","Pilot 11: bigger feedback + video + socially anxious",2,"low",-6
"SUPPRF54929",24,90,17,28,-1,84,29,30,"Pilot 11","Pilot 11: bigger feedback + video + socially anxious",2,"low",-2
"SUPPRF54929",25,90,19,37,0,82,37,40,"Pilot 11","Pilot 11: bigger feedback + video + socially anxious",2,"low",-3
"SUPPRF54929",26,69,13,34,-12,80,46,45,"Pilot 11","Pilot 11: bigger feedback + video + socially anxious",2,"low",-11
"SUPPRF54929",27,39,27,15,-14,83,29,33,"Pilot 11","Pilot 11: bigger feedback + video + socially anxious",2,"low",-18
"SUPPRF54929",28,64,16,46,0,48,46,20,"Pilot 11","Pilot 11: bigger feedback + video + socially anxious",2,"low",26
"SUPPRF54929",29,75,12,62,-1,84,63,55,"Pilot 11","Pilot 11: bigger feedback + video + socially anxious",2,"low",7
"SUPPRF54929",30,47,32,80,0,87,80,96,"Pilot 11","Pilot 11: bigger feedback + video + socially anxious",2,"low",-16
"SUPPRF54929",31,54,20,47,27,83,20,17,"Pilot 11","Pilot 11: bigger feedback + video + socially anxious",2,"low",30
"SUPPRF54929",32,78,11,68,-12,35,80,70,"Pilot 11","Pilot 11: bigger feedback + video + socially anxious",2,"low",-2
"SUPPRF54929",33,92,4,70,-1,88,71,73,"Pilot 11","Pilot 11: bigger feedback + video + socially anxious",2,"low",-3
"SUPPRF54929",34,80,18,54,0,24,54,45,"Pilot 11","Pilot 11: bigger feedback + video + socially anxious",2,"low",9
"SUPPRF54929",35,94,9,81,1,70,80,80,"Pilot 11","Pilot 11: bigger feedback + video + socially anxious",2,"low",1
"SUPPRF54929",36,59,33,55,-16,28,71,70,"Pilot 11","Pilot 11: bigger feedback + video + socially anxious",2,"low",-15
"SUPPRF54929",37,70,17,46,17,20,29,31,"Pilot 11","Pilot 11: bigger feedback + video + socially anxious",2,"low",15
"SUPPRF54929",38,72,75,88,25,67,63,34,"Pilot 11","Pilot 11: bigger feedback + video + socially anxious",2,"low",54
"SUPPRF54929",39,53,73,58,29,68,29,20,"Pilot 11","Pilot 11: bigger feedback + video + socially anxious",2,"low",38
"SUPPRF54929",40,67,25,50,-13,67,63,65,"Pilot 11","Pilot 11: bigger feedback + video + socially anxious",2,"low",-15
"SUPPRF54929",41,74,16,58,12,66,46,55,"Pilot 11","Pilot 11: bigger feedback + video + socially anxious",2,"low",3
"SUPPRF54929",42,66,17,63,0,68,63,49,"Pilot 11","Pilot 11: bigger feedback + video + socially anxious",2,"low",14
"SUPPRF54929",43,24,80,41,-13,20,54,27,"Pilot 11","Pilot 11: bigger feedback + video + socially anxious",2,"low",14
"SUPPRF54929",44,27,72,47,-16,58,63,55,"Pilot 11","Pilot 11: bigger feedback + video + socially anxious",2,"low",-8
"SUPPRF54929",45,72,68,19,-1,76,20,19,"Pilot 11","Pilot 11: bigger feedback + video + socially anxious",2,"low",0
"SUPPRF54929",46,28,81,75,29,67,46,42,"Pilot 11","Pilot 11: bigger feedback + video + socially anxious",2,"low",33
"SUPPRF54929",47,75,18,96,16,83,80,73,"Pilot 11","Pilot 11: bigger feedback + video + socially anxious",2,"low",23
"SUPPRF54929",48,40,61,38,1,67,37,45,"Pilot 11","Pilot 11: bigger feedback + video + socially anxious",2,"low",-7
"SUPPRF55556",1,55,42,83,12,56,71,65,"Pilot 7","Pilot 7: bigger feedback + text",10,"high",18
"SUPPRF55556",2,60,39,96,16,29,80,56,"Pilot 7","Pilot 7: bigger feedback + text",10,"high",40
"SUPPRF55556",3,49,33,63,0,54,63,22,"Pilot 7","Pilot 7: bigger feedback + text",10,"high",41
"SUPPRF55556",4,59,30,70,-1,66,71,81,"Pilot 7","Pilot 7: bigger feedback + text",10,"high",-11
"SUPPRF55556",5,43,37,54,0,62,54,38,"Pilot 7","Pilot 7: bigger feedback + text",10,"high",16
"SUPPRF55556",6,58,32,67,-13,61,80,61,"Pilot 7","Pilot 7: bigger feedback + text",10,"high",6
"SUPPRF55556",7,39,55,22,-15,71,37,46,"Pilot 7","Pilot 7: bigger feedback + text",10,"high",-24
"SUPPRF55556",8,37,57,37,0,57,37,57,"Pilot 7","Pilot 7: bigger feedback + text",10,"high",-20
"SUPPRF55556",9,58,47,58,12,24,46,40,"Pilot 7","Pilot 7: bigger feedback + text",10,"high",18
"SUPPRF55556",10,57,35,55,1,58,54,52,"Pilot 7","Pilot 7: bigger feedback + text",10,"high",3
"SUPPRF55556",11,39,28,28,-1,69,29,25,"Pilot 7","Pilot 7: bigger feedback + text",10,"high",3
"SUPPRF55556",12,47,42,24,-13,73,37,32,"Pilot 7","Pilot 7: bigger feedback + text",10,"high",-8
"SUPPRF55556",13,81,14,78,15,65,63,78,"Pilot 7","Pilot 7: bigger feedback + text",10,"high",0
"SUPPRF55556",14,81,12,97,17,70,80,32,"Pilot 7","Pilot 7: bigger feedback + text",10,"high",65
"SUPPRF55556",15,33,36,15,-14,62,29,26,"Pilot 7","Pilot 7: bigger feedback + text",10,"high",-11
"SUPPRF55556",16,52,44,71,0,28,71,57,"Pilot 7","Pilot 7: bigger feedback + text",10,"high",14
"SUPPRF55556",17,53,28,81,1,24,80,61,"Pilot 7","Pilot 7: bigger feedback + text",10,"high",20
"SUPPRF55556",18,49,53,66,12,56,54,71,"Pilot 7","Pilot 7: bigger feedback + text",10,"high",-5
"SUPPRF55556",19,45,40,80,0,56,80,50,"Pilot 7","Pilot 7: bigger feedback + text",10,"high",30
"SUPPRF55556",20,62,33,38,-16,66,54,39,"Pilot 7","Pilot 7: bigger feedback + text",10,"high",-1
"SUPPRF55556",21,16,49,8,-12,70,20,20,"Pilot 7","Pilot 7: bigger feedback + text",10,"high",-12
"SUPPRF55556",22,64,54,45,-1,35,46,41,"Pilot 7","Pilot 7: bigger feedback + text",10,"high",4
"SUPPRF55556",23,67,39,62,-1,71,63,63,"Pilot 7","Pilot 7: bigger feedback + text",10,"high",-1
"SUPPRF55556",24,45,51,20,0,70,20,13,"Pilot 7","Pilot 7: bigger feedback + text",10,"high",7
"SUPPRF55556",25,22,62,16,-13,74,29,26,"Pilot 7","Pilot 7: bigger feedback + text",10,"high",-10
"SUPPRF55556",26,33,51,56,-15,75,71,73,"Pilot 7","Pilot 7: bigger feedback + text",10,"high",-17
"SUPPRF55556",27,11,56,6,-14,72,20,14,"Pilot 7","Pilot 7: bigger feedback + text",10,"high",-8
"SUPPRF55556",28,43,53,46,17,61,29,24,"Pilot 7","Pilot 7: bigger feedback + text",10,"high",22
"SUPPRF55556",29,84,19,77,14,49,63,30,"Pilot 7","Pilot 7: bigger feedback + text",10,"high",47
"SUPPRF55556",30,18,61,34,-12,33,46,57,"Pilot 7","Pilot 7: bigger feedback + text",10,"high",-23
"SUPPRF55556",31,44,48,37,17,63,20,15,"Pilot 7","Pilot 7: bigger feedback + text",10,"high",22
"SUPPRF55556",32,51,38,48,19,62,29,39,"Pilot 7","Pilot 7: bigger feedback + text",10,"high",9
"SUPPRF55556",33,42,30,68,-12,18,80,44,"Pilot 7","Pilot 7: bigger feedback + text",10,"high",24
"SUPPRF55556",34,35,66,33,-13,53,46,38,"Pilot 7","Pilot 7: bigger feedback + text",10,"high",-5
"SUPPRF55556",35,58,32,68,14,42,54,27,"Pilot 7","Pilot 7: bigger feedback + text",10,"high",41
"SUPPRF55556",36,29,35,49,12,69,37,26,"Pilot 7","Pilot 7: bigger feedback + text",10,"high",23
"SUPPRF55556",37,19,87,35,15,82,20,28,"Pilot 7","Pilot 7: bigger feedback + text",10,"high",7
"SUPPRF55556",38,17,80,19,-1,57,20,26,"Pilot 7","Pilot 7: bigger feedback + text",10,"high",-7
"SUPPRF55556",39,18,78,50,-13,10,63,31,"Pilot 7","Pilot 7: bigger feedback + text",10,"high",19
"SUPPRF55556",40,9,90,29,0,14,29,36,"Pilot 7","Pilot 7: bigger feedback + text",10,"high",-7
"SUPPRF55556",41,9,88,41,-13,43,54,56,"Pilot 7","Pilot 7: bigger feedback + text",10,"high",-15
"SUPPRF55556",42,2,91,38,1,52,37,30,"Pilot 7","Pilot 7: bigger feedback + text",10,"high",8
"SUPPRF55556",43,8,94,65,19,26,46,33,"Pilot 7","Pilot 7: bigger feedback + text",10,"high",32
"SUPPRF55556",44,7,92,47,-16,61,63,62,"Pilot 7","Pilot 7: bigger feedback + text",10,"high",-15
"SUPPRF55556",45,5,93,46,0,32,46,62,"Pilot 7","Pilot 7: bigger feedback + text",10,"high",-16
"SUPPRF55556",46,1,99,84,13,1,71,1,"Pilot 7","Pilot 7: bigger feedback + text",10,"high",83
"SUPPRF55556",47,2,96,51,14,81,37,22,"Pilot 7","Pilot 7: bigger feedback + text",10,"high",29
"SUPPRF55556",48,3,97,55,-16,71,71,62,"Pilot 7","Pilot 7: bigger feedback + text",10,"high",-7
"SUPPRF55923",1,47,48,41,-13,27,54,49,"Pilot 7","Pilot 7: bigger feedback + text",10,"high",-8
"SUPPRF55923",2,50,49,80,0,44,80,74,"Pilot 7","Pilot 7: bigger feedback + text",10,"high",6
"SUPPRF55923",3,46,50,71,0,51,71,64,"Pilot 7","Pilot 7: bigger feedback + text",10,"high",7
"SUPPRF55923",4,49,47,37,17,24,20,36,"Pilot 7","Pilot 7: bigger feedback + text",10,"high",1
"SUPPRF55923",5,64,32,19,-1,28,20,19,"Pilot 7","Pilot 7: bigger feedback + text",10,"high",0
"SUPPRF55923",6,46,23,55,1,43,54,44,"Pilot 7","Pilot 7: bigger feedback + text",10,"high",11
"SUPPRF55923",7,63,30,46,17,30,29,51,"Pilot 7","Pilot 7: bigger feedback + text",10,"high",-5
"SUPPRF55923",8,47,43,6,-14,32,20,38,"Pilot 7","Pilot 7: bigger feedback + text",10,"high",-32
"SUPPRF55923",9,51,22,97,17,12,80,34,"Pilot 7","Pilot 7: bigger feedback + text",10,"high",63
"SUPPRF55923",10,54,51,45,-1,23,46,39,"Pilot 7","Pilot 7: bigger feedback + text",10,"high",6
"SUPPRF55923",11,48,28,83,12,47,71,61,"Pilot 7","Pilot 7: bigger feedback + text",10,"high",22
"SUPPRF55923",12,41,30,34,-12,34,46,67,"Pilot 7","Pilot 7: bigger feedback + text",10,"high",-33
"SUPPRF55923",13,41,21,20,0,61,20,17,"Pilot 7","Pilot 7: bigger feedback + text",10,"high",3
"SUPPRF55923",14,28,26,70,-1,23,71,47,"Pilot 7","Pilot 7: bigger feedback + text",10,"high",23
"SUPPRF55923",15,28,17,35,15,83,20,22,"Pilot 7","Pilot 7: bigger feedback + text",10,"high",13
"SUPPRF55923",16,36,23,62,-1,53,63,41,"Pilot 7","Pilot 7: bigger feedback + text",10,"high",21
"SUPPRF55923",17,29,27,96,16,39,80,49,"Pilot 7","Pilot 7: bigger feedback + text",10,"high",47
"SUPPRF55923",18,40,22,68,14,36,54,63,"Pilot 7","Pilot 7: bigger feedback + text",10,"high",5
"SUPPRF55923",19,22,19,77,14,36,63,37,"Pilot 7","Pilot 7: bigger feedback + text",10,"high",40
"SUPPRF55923",20,25,36,49,12,52,37,30,"Pilot 7","Pilot 7: bigger feedback + text",10,"high",19
"SUPPRF55923",21,42,34,67,-13,37,80,72,"Pilot 7","Pilot 7: bigger feedback + text",10,"high",-5
"SUPPRF55923",22,29,33,24,-13,38,37,30,"Pilot 7","Pilot 7: bigger feedback + text",10,"high",-6
"SUPPRF55923",23,33,33,48,19,31,29,39,"Pilot 7","Pilot 7: bigger feedback + text",10,"high",9
"SUPPRF55923",24,42,41,58,12,34,46,36,"Pilot 7","Pilot 7: bigger feedback + text",10,"high",22
"SUPPRF55923",25,45,37,56,-15,56,71,49,"Pilot 7","Pilot 7: bigger feedback + text",10,"high",7
"SUPPRF55923",26,33,38,81,1,37,80,39,"Pilot 7","Pilot 7: bigger feedback + text",10,"high",42
"SUPPRF55923",27,25,26,37,0,21,37,32,"Pilot 7","Pilot 7: bigger feedback + text",10,"high",5
"SUPPRF55923",28,22,23,63,0,6,63,40,"Pilot 7","Pilot 7: bigger feedback + text",10,"high",23
"SUPPRF55923",29,29,26,28,-1,42,29,50,"Pilot 7","Pilot 7: bigger feedback + text",10,"high",-22
"SUPPRF55923",30,24,34,78,15,41,63,48,"Pilot 7","Pilot 7: bigger feedback + text",10,"high",30
"SUPPRF55923",31,27,22,38,1,60,37,46,"Pilot 7","Pilot 7: bigger feedback + text",10,"high",-8
"SUPPRF55923",32,30,36,66,12,21,54,39,"Pilot 7","Pilot 7: bigger feedback + text",10,"high",27
"SUPPRF55923",33,26,19,8,-12,74,20,15,"Pilot 7","Pilot 7: bigger feedback + text",10,"high",-7
"SUPPRF55923",34,29,28,55,-16,21,71,55,"Pilot 7","Pilot 7: bigger feedback + text",10,"high",0
"SUPPRF55923",35,23,26,33,-13,26,46,52,"Pilot 7","Pilot 7: bigger feedback + text",10,"high",-19
"SUPPRF55923",36,34,31,50,-13,66,63,63,"Pilot 7","Pilot 7: bigger feedback + text",10,"high",-13
"SUPPRF55923",37,46,44,38,-16,49,54,56,"Pilot 7","Pilot 7: bigger feedback + text",10,"high",-18
"SUPPRF55923",38,45,37,68,-12,57,80,84,"Pilot 7","Pilot 7: bigger feedback + text",10,"high",-16
"SUPPRF55923",39,32,30,46,0,21,46,45,"Pilot 7","Pilot 7: bigger feedback + text",10,"high",1
"SUPPRF55923",40,45,30,84,13,41,71,64,"Pilot 7","Pilot 7: bigger feedback + text",10,"high",20
"SUPPRF55923",41,26,25,22,-15,66,37,43,"Pilot 7","Pilot 7: bigger feedback + text",10,"high",-21
"SUPPRF55923",42,38,39,47,-16,31,63,31,"Pilot 7","Pilot 7: bigger feedback + text",10,"high",16
"SUPPRF55923",43,11,21,65,19,13,46,39,"Pilot 7","Pilot 7: bigger feedback + text",10,"high",26
"SUPPRF55923",44,13,33,29,0,33,29,30,"Pilot 7","Pilot 7: bigger feedback + text",10,"high",-1
"SUPPRF55923",45,11,30,54,0,13,54,60,"Pilot 7","Pilot 7: bigger feedback + text",10,"high",-6
"SUPPRF55923",46,0,19,51,14,21,37,46,"Pilot 7","Pilot 7: bigger feedback + text",10,"high",5
"SUPPRF55923",47,19,16,15,-14,18,29,60,"Pilot 7","Pilot 7: bigger feedback + text",10,"high",-45
"SUPPRF55923",48,16,14,16,-13,44,29,20,"Pilot 7","Pilot 7: bigger feedback + text",10,"high",-4
"SUPPRF56321",1,65,0,41,-13,83,54,60,"Pilot 7","Pilot 7: bigger feedback + text",2,"low",-19
"SUPPRF56321",2,64,0,68,14,80,54,36,"Pilot 7","Pilot 7: bigger feedback + text",2,"low",32
"SUPPRF56321",3,65,0,66,12,90,54,55,"Pilot 7","Pilot 7: bigger feedback + text",2,"low",11
"SUPPRF56321",4,69,0,50,-13,64,63,72,"Pilot 7","Pilot 7: bigger feedback + text",2,"low",-22
"SUPPRF56321",5,63,0,65,19,70,46,48,"Pilot 7","Pilot 7: bigger feedback + text",2,"low",17
"SUPPRF56321",6,71,0,67,-13,83,80,70,"Pilot 7","Pilot 7: bigger feedback + text",2,"low",-3
"SUPPRF56321",7,63,0,62,-1,84,63,66,"Pilot 7","Pilot 7: bigger feedback + text",2,"low",-4
"SUPPRF56321",8,59,0,46,0,88,46,64,"Pilot 7","Pilot 7: bigger feedback + text",2,"low",-18
"SUPPRF56321",9,68,0,19,-1,99,20,19,"Pilot 7","Pilot 7: bigger feedback + text",2,"low",0
"SUPPRF56321",10,62,0,51,14,21,37,51,"Pilot 7","Pilot 7: bigger feedback + text",2,"low",0
"SUPPRF56321",11,62,0,28,-1,67,29,36,"Pilot 7","Pilot 7: bigger feedback + text",2,"low",-8
"SUPPRF56321",12,71,0,37,0,87,37,35,"Pilot 7","Pilot 7: bigger feedback + text",2,"low",2
"SUPPRF56321",13,74,0,70,-1,100,71,77,"Pilot 7","Pilot 7: bigger feedback + text",2,"low",-7
"SUPPRF56321",14,70,0,55,1,0,54,45,"Pilot 7","Pilot 7: bigger feedback + text",2,"low",10
"SUPPRF56321",15,65,0,24,-13,93,37,36,"Pilot 7","Pilot 7: bigger feedback + text",2,"low",-12
"SUPPRF56321",16,59,0,46,17,74,29,21,"Pilot 7","Pilot 7: bigger feedback + text",2,"low",25
"SUPPRF56321",17,65,0,63,0,100,63,56,"Pilot 7","Pilot 7: bigger feedback + text",2,"low",7
"SUPPRF56321",18,68,1,54,0,84,54,49,"Pilot 7","Pilot 7: bigger feedback + text",2,"low",5
"SUPPRF56321",19,61,10,84,13,63,71,44,"Pilot 7","Pilot 7: bigger feedback + text",2,"low",40
"SUPPRF56321",20,55,11,20,0,89,20,18,"Pilot 7","Pilot 7: bigger feedback + text",2,"low",2
"SUPPRF56321",21,54,4,58,12,35,46,43,"Pilot 7","Pilot 7: bigger feedback + text",2,"low",15
"SUPPRF56321",22,48,3,49,12,26,37,49,"Pilot 7","Pilot 7: bigger feedback + text",2,"low",0
"SUPPRF56321",23,50,0,71,0,93,71,74,"Pilot 7","Pilot 7: bigger feedback + text",2,"low",-3
"SUPPRF56321",24,11,0,34,-12,78,46,52,"Pilot 7","Pilot 7: bigger feedback + text",2,"low",-18
"SUPPRF56321",25,50,0,15,-14,73,29,39,"Pilot 7","Pilot 7: bigger feedback + text",2,"low",-24
"SUPPRF56321",26,54,0,8,-12,85,20,24,"Pilot 7","Pilot 7: bigger feedback + text",2,"low",-16
"SUPPRF56321",27,59,0,97,17,100,80,80,"Pilot 7","Pilot 7: bigger feedback + text",2,"low",17
"SUPPRF56321",28,60,2,68,-12,90,80,100,"Pilot 7","Pilot 7: bigger feedback + text",2,"low",-32
"SUPPRF56321",29,48,0,56,-15,69,71,55,"Pilot 7","Pilot 7: bigger feedback + text",2,"low",1
"SUPPRF56321",30,53,0,29,0,80,29,34,"Pilot 7","Pilot 7: bigger feedback + text",2,"low",-5
"SUPPRF56321",31,49,4,55,-16,93,71,75,"Pilot 7","Pilot 7: bigger feedback + text",2,"low",-20
"SUPPRF56321",32,65,0,77,14,91,63,63,"Pilot 7","Pilot 7: bigger feedback + text",2,"low",14
"SUPPRF56321",33,50,0,83,12,36,71,59,"Pilot 7","Pilot 7: bigger feedback + text",2,"low",24
"SUPPRF56321",34,48,0,45,-1,69,46,48,"Pilot 7","Pilot 7: bigger feedback + text",2,"low",-3
"SUPPRF56321",35,49,2,33,-13,36,46,56,"Pilot 7","Pilot 7: bigger feedback + text",2,"low",-23
"SUPPRF56321",36,50,0,81,1,84,80,78,"Pilot 7","Pilot 7: bigger feedback + text",2,"low",3
"SUPPRF56321",37,48,0,35,15,90,20,9,"Pilot 7","Pilot 7: bigger feedback + text",2,"low",26
"SUPPRF56321",38,46,0,22,-15,63,37,48,"Pilot 7","Pilot 7: bigger feedback + text",2,"low",-26
"SUPPRF56321",39,44,0,6,-14,97,20,17,"Pilot 7","Pilot 7: bigger feedback + text",2,"low",-11
"SUPPRF56321",40,47,3,37,17,91,20,19,"Pilot 7","Pilot 7: bigger feedback + text",2,"low",18
"SUPPRF56321",41,45,0,38,-16,77,54,32,"Pilot 7","Pilot 7: bigger feedback + text",2,"low",6
"SUPPRF56321",42,47,0,47,-16,84,63,67,"Pilot 7","Pilot 7: bigger feedback + text",2,"low",-20
"SUPPRF56321",43,48,0,48,19,88,29,32,"Pilot 7","Pilot 7: bigger feedback + text",2,"low",16
"SUPPRF56321",44,47,2,96,16,88,80,73,"Pilot 7","Pilot 7: bigger feedback + text",2,"low",23
"SUPPRF56321",45,51,0,38,1,80,37,38,"Pilot 7","Pilot 7: bigger feedback + text",2,"low",0
"SUPPRF56321",46,50,0,80,0,90,80,75,"Pilot 7","Pilot 7: bigger feedback + text",2,"low",5
"SUPPRF56321",47,49,0,78,15,88,63,56,"Pilot 7","Pilot 7: bigger feedback + text",2,"low",22
"SUPPRF56321",48,45,7,16,-13,61,29,22,"Pilot 7","Pilot 7: bigger feedback + text",2,"low",-6
"SUPPRF56870",1,77,2,94,23,21,71,33,"Pilot 10","Pilot 10: bigger feedback + video",4,"low",61
"SUPPRF56870",2,72,0,46,17,12,29,40,"Pilot 10","Pilot 10: bigger feedback + video",4,"low",6
"SUPPRF56870",3,70,0,61,24,2,37,47,"Pilot 10","Pilot 10: bigger feedback + video",4,"low",14
"SUPPRF56870",4,87,0,34,-12,50,46,39,"Pilot 10","Pilot 10: bigger feedback + video",4,"low",-5
"SUPPRF56870",5,94,0,37,0,65,37,42,"Pilot 10","Pilot 10: bigger feedback + video",4,"low",-5
"SUPPRF56870",6,88,0,70,-1,82,71,82,"Pilot 10","Pilot 10: bigger feedback + video",4,"low",-12
"SUPPRF56870",7,96,0,47,27,24,20,38,"Pilot 10","Pilot 10: bigger feedback + video",4,"low",9
"SUPPRF56870",8,82,0,58,12,6,46,76,"Pilot 10","Pilot 10: bigger feedback + video",4,"low",-18
"SUPPRF56870",9,100,0,28,-1,47,29,51,"Pilot 10","Pilot 10: bigger feedback + video",4,"low",-23
"SUPPRF56870",10,100,0,49,12,66,37,42,"Pilot 10","Pilot 10: bigger feedback + video",4,"low",7
"SUPPRF56870",11,100,0,38,1,72,37,51,"Pilot 10","Pilot 10: bigger feedback + video",4,"low",-13
"SUPPRF56870",12,100,0,63,0,43,63,90,"Pilot 10","Pilot 10: bigger feedback + video",4,"low",-27
"SUPPRF56870",13,100,0,15,-14,20,29,47,"Pilot 10","Pilot 10: bigger feedback + video",4,"low",-32
"SUPPRF56870",14,100,0,54,0,54,54,77,"Pilot 10","Pilot 10: bigger feedback + video",4,"low",-23
"SUPPRF56870",15,100,0,62,-1,22,63,83,"Pilot 10","Pilot 10: bigger feedback + video",4,"low",-21
"SUPPRF56870",16,100,0,67,-13,33,80,92,"Pilot 10","Pilot 10: bigger feedback + video",4,"low",-25
"SUPPRF56870",17,100,0,78,24,50,54,24,"Pilot 10","Pilot 10: bigger feedback + video",4,"low",54
"SUPPRF56870",18,100,0,45,-1,14,46,30,"Pilot 10","Pilot 10: bigger feedback + video",4,"low",15
"SUPPRF56870",19,100,0,80,0,90,80,90,"Pilot 10","Pilot 10: bigger feedback + video",4,"low",-10
"SUPPRF56870",20,100,0,56,-15,46,71,48,"Pilot 10","Pilot 10: bigger feedback + video",4,"low",8
"SUPPRF56870",21,100,0,19,-1,18,20,84,"Pilot 10","Pilot 10: bigger feedback + video",4,"low",-65
"SUPPRF56870",22,100,0,88,25,5,63,94,"Pilot 10","Pilot 10: bigger feedback + video",4,"low",-6
"SUPPRF56870",23,100,0,22,-15,4,37,10,"Pilot 10","Pilot 10: bigger feedback + video",4,"low",12
"SUPPRF56870",24,100,0,96,16,15,80,22,"Pilot 10","Pilot 10: bigger feedback + video",4,"low",74
"SUPPRF56870",25,100,0,6,-14,50,20,30,"Pilot 10","Pilot 10: bigger feedback + video",4,"low",-24
"SUPPRF56870",26,100,0,38,-16,0,54,40,"Pilot 10","Pilot 10: bigger feedback + video",4,"low",-2
"SUPPRF56870",27,100,0,8,-12,3,20,66,"Pilot 10","Pilot 10: bigger feedback + video",4,"low",-58
"SUPPRF56870",28,100,0,20,0,75,20,11,"Pilot 10","Pilot 10: bigger feedback + video",4,"low",9
"SUPPRF56870",29,100,0,24,-13,18,37,53,"Pilot 10","Pilot 10: bigger feedback + video",4,"low",-29
"SUPPRF56870",30,100,0,75,29,100,46,70,"Pilot 10","Pilot 10: bigger feedback + video",4,"low",5
"SUPPRF56870",31,100,0,16,-13,34,29,54,"Pilot 10","Pilot 10: bigger feedback + video",4,"low",-38
"SUPPRF56870",32,100,0,47,-16,15,63,18,"Pilot 10","Pilot 10: bigger feedback + video",4,"low",29
"SUPPRF56870",33,100,0,81,1,0,80,100,"Pilot 10","Pilot 10: bigger feedback + video",4,"low",-19
"SUPPRF56870",34,100,0,66,12,0,54,8,"Pilot 10","Pilot 10: bigger feedback + video",4,"low",58
"SUPPRF56870",35,98,0,55,1,1,54,64,"Pilot 10","Pilot 10: bigger feedback + video",4,"low",-9
"SUPPRF56870",36,100,0,41,-13,0,54,88,"Pilot 10","Pilot 10: bigger feedback + video",4,"low",-47
"SUPPRF56870",37,94,0,68,-12,0,80,100,"Pilot 10","Pilot 10: bigger feedback + video",4,"low",-32
"SUPPRF56870",38,100,8,77,14,0,63,82,"Pilot 10","Pilot 10: bigger feedback + video",4,"low",-5
"SUPPRF56870",39,100,9,58,29,0,29,5,"Pilot 10","Pilot 10: bigger feedback + video",4,"low",53
"SUPPRF56870",40,100,0,100,20,16,80,97,"Pilot 10","Pilot 10: bigger feedback + video",4,"low",3
"SUPPRF56870",41,100,0,50,-13,6,63,77,"Pilot 10","Pilot 10: bigger feedback + video",4,"low",-27
"SUPPRF56870",42,100,0,83,12,0,71,81,"Pilot 10","Pilot 10: bigger feedback + video",4,"low",2
"SUPPRF56870",43,100,0,71,0,0,71,81,"Pilot 10","Pilot 10: bigger feedback + video",4,"low",-10
"SUPPRF56870",44,100,0,55,-16,0,71,35,"Pilot 10","Pilot 10: bigger feedback + video",4,"low",20
"SUPPRF56870",45,100,0,46,0,1,46,96,"Pilot 10","Pilot 10: bigger feedback + video",4,"low",-50
"SUPPRF56870",46,100,0,29,0,93,29,92,"Pilot 10","Pilot 10: bigger feedback + video",4,"low",-63
"SUPPRF56870",47,100,0,35,15,77,20,10,"Pilot 10","Pilot 10: bigger feedback + video",4,"low",25
"SUPPRF56870",48,100,0,33,-13,0,46,56,"Pilot 10","Pilot 10: bigger feedback + video",4,"low",-23
"SUPPRF57557",1,74,27,81,1,72,80,79,"Pilot 10","Pilot 10: bigger feedback + video",8,"high",2
"SUPPRF57557",2,72,25,38,1,33,37,36,"Pilot 10","Pilot 10: bigger feedback + video",8,"high",2
"SUPPRF57557",3,76,28,8,-12,35,20,28,"Pilot 10","Pilot 10: bigger feedback + video",8,"high",-20
"SUPPRF57557",4,40,22,67,-13,75,80,82,"Pilot 10","Pilot 10: bigger feedback + video",8,"high",-15
"SUPPRF57557",5,51,21,47,27,45,20,25,"Pilot 10","Pilot 10: bigger feedback + video",8,"high",22
"SUPPRF57557",6,69,23,83,12,23,71,42,"Pilot 10","Pilot 10: bigger feedback + video",8,"high",41
"SUPPRF57557",7,77,24,68,-12,69,80,74,"Pilot 10","Pilot 10: bigger feedback + video",8,"high",-6
"SUPPRF57557",8,43,20,100,20,57,80,71,"Pilot 10","Pilot 10: bigger feedback + video",8,"high",29
"SUPPRF57557",9,68,20,61,24,62,37,69,"Pilot 10","Pilot 10: bigger feedback + video",8,"high",-8
"SUPPRF57557",10,58,20,6,-14,29,20,69,"Pilot 10","Pilot 10: bigger feedback + video",8,"high",-63
"SUPPRF57557",11,64,27,75,29,32,46,39,"Pilot 10","Pilot 10: bigger feedback + video",8,"high",36
"SUPPRF57557",12,84,25,50,-13,67,63,69,"Pilot 10","Pilot 10: bigger feedback + video",8,"high",-19
"SUPPRF57557",13,69,30,45,-1,24,46,64,"Pilot 10","Pilot 10: bigger feedback + video",8,"high",-19
"SUPPRF57557",14,71,26,70,-1,26,71,64,"Pilot 10","Pilot 10: bigger feedback + video",8,"high",6
"SUPPRF57557",15,66,31,55,1,52,54,65,"Pilot 10","Pilot 10: bigger feedback + video",8,"high",-10
"SUPPRF57557",16,58,31,33,-13,60,46,45,"Pilot 10","Pilot 10: bigger feedback + video",8,"high",-12
"SUPPRF57557",17,57,23,58,29,72,29,25,"Pilot 10","Pilot 10: bigger feedback + video",8,"high",33
"SUPPRF57557",18,58,25,41,-13,34,54,58,"Pilot 10","Pilot 10: bigger feedback + video",8,"high",-17
"SUPPRF57557",19,67,33,29,0,30,29,39,"Pilot 10","Pilot 10: bigger feedback + video",8,"high",-10
"SUPPRF57557",20,69,24,88,25,65,63,52,"Pilot 10","Pilot 10: bigger feedback + video",8,"high",36
"SUPPRF57557",21,69,24,66,12,48,54,65,"Pilot 10","Pilot 10: bigger feedback + video",8,"high",1
"SUPPRF57557",22,72,22,28,-1,62,29,28,"Pilot 10","Pilot 10: bigger feedback + video",8,"high",0
"SUPPRF57557",23,64,25,54,0,69,54,54,"Pilot 10","Pilot 10: bigger feedback + video",8,"high",0
"SUPPRF57557",24,70,35,38,-16,52,54,43,"Pilot 10","Pilot 10: bigger feedback + video",8,"high",-5
"SUPPRF57557",25,63,27,47,-16,61,63,42,"Pilot 10","Pilot 10: bigger feedback + video",8,"high",5
"SUPPRF57557",26,80,37,71,0,46,71,73,"Pilot 10","Pilot 10: bigger feedback + video",8,"high",-2
"SUPPRF57557",27,46,22,16,-13,42,29,63,"Pilot 10","Pilot 10: bigger feedback + video",8,"high",-47
"SUPPRF57557",28,65,27,24,-13,47,37,39,"Pilot 10","Pilot 10: bigger feedback + video",8,"high",-15
"SUPPRF57557",29,77,17,55,-16,61,71,54,"Pilot 10","Pilot 10: bigger feedback + video",8,"high",1
"SUPPRF57557",30,67,25,62,-1,64,63,73,"Pilot 10","Pilot 10: bigger feedback + video",8,"high",-11
"SUPPRF57557",31,69,15,94,23,68,71,58,"Pilot 10","Pilot 10: bigger feedback + video",8,"high",36
"SUPPRF57557",32,72,26,20,0,50,20,37,"Pilot 10","Pilot 10: bigger feedback + video",8,"high",-17
"SUPPRF57557",33,52,23,15,-14,64,29,33,"Pilot 10","Pilot 10: bigger feedback + video",8,"high",-18
"SUPPRF57557",34,44,29,19,-1,41,20,35,"Pilot 10","Pilot 10: bigger feedback + video",8,"high",-16
"SUPPRF57557",35,60,22,37,0,61,37,33,"Pilot 10","Pilot 10: bigger feedback + video",8,"high",4
"SUPPRF57557",36,77,35,77,14,71,63,70,"Pilot 10","Pilot 10: bigger feedback + video",8,"high",7
"SUPPRF57557",37,70,27,80,0,73,80,80,"Pilot 10","Pilot 10: bigger feedback + video",8,"high",0
"SUPPRF57557",38,71,24,63,0,66,63,63,"Pilot 10","Pilot 10: bigger feedback + video",8,"high",0
"SUPPRF57557",39,65,37,22,-15,55,37,34,"Pilot 10","Pilot 10: bigger feedback + video",8,"high",-12
"SUPPRF57557",40,57,23,35,15,32,20,40,"Pilot 10","Pilot 10: bigger feedback + video",8,"high",-5
"SUPPRF57557",41,66,25,34,-12,68,46,37,"Pilot 10","Pilot 10: bigger feedback + video",8,"high",-3
"SUPPRF57557",42,74,34,78,24,35,54,43,"Pilot 10","Pilot 10: bigger feedback + video",8,"high",35
"SUPPRF57557",43,73,31,96,16,38,80,56,"Pilot 10","Pilot 10: bigger feedback + video",8,"high",40
"SUPPRF57557",44,58,4,58,12,39,46,56,"Pilot 10","Pilot 10: bigger feedback + video",8,"high",2
"SUPPRF57557",45,69,27,56,-15,26,71,35,"Pilot 10","Pilot 10: bigger feedback + video",8,"high",21
"SUPPRF57557",46,66,11,49,12,72,37,43,"Pilot 10","Pilot 10: bigger feedback + video",8,"high",6
"SUPPRF57557",47,68,23,46,17,57,29,41,"Pilot 10","Pilot 10: bigger feedback + video",8,"high",5
"SUPPRF57557",48,78,27,46,0,62,46,53,"Pilot 10","Pilot 10: bigger feedback + video",8,"high",-7
"SUPPRF57890",1,43,41,34,-12,63,46,41,"Pilot 7","Pilot 7: bigger feedback + text",2,"low",-7
"SUPPRF57890",2,50,50,46,17,83,29,26,"Pilot 7","Pilot 7: bigger feedback + text",2,"low",20
"SUPPRF57890",3,69,36,45,-1,68,46,42,"Pilot 7","Pilot 7: bigger feedback + text",2,"low",3
"SUPPRF57890",4,52,41,66,12,80,54,52,"Pilot 7","Pilot 7: bigger feedback + text",2,"low",14
"SUPPRF57890",5,71,22,62,-1,94,63,69,"Pilot 7","Pilot 7: bigger feedback + text",2,"low",-7
"SUPPRF57890",6,76,21,49,12,66,37,40,"Pilot 7","Pilot 7: bigger feedback + text",2,"low",9
"SUPPRF57890",7,66,27,37,17,68,20,28,"Pilot 7","Pilot 7: bigger feedback + text",2,"low",9
"SUPPRF57890",8,57,27,78,15,76,63,31,"Pilot 7","Pilot 7: bigger feedback + text",2,"low",47
"SUPPRF57890",9,77,17,51,14,40,37,54,"Pilot 7","Pilot 7: bigger feedback + text",2,"low",-3
"SUPPRF57890",10,66,26,28,-1,46,29,30,"Pilot 7","Pilot 7: bigger feedback + text",2,"low",-2
"SUPPRF57890",11,53,29,54,0,76,54,71,"Pilot 7","Pilot 7: bigger feedback + text",2,"low",-17
"SUPPRF57890",12,83,16,63,0,65,63,40,"Pilot 7","Pilot 7: bigger feedback + text",2,"low",23
"SUPPRF57890",13,76,18,80,0,76,80,74,"Pilot 7","Pilot 7: bigger feedback + text",2,"low",6
"SUPPRF57890",14,81,19,46,0,70,46,35,"Pilot 7","Pilot 7: bigger feedback + text",2,"low",11
"SUPPRF57890",15,76,14,29,0,70,29,39,"Pilot 7","Pilot 7: bigger feedback + text",2,"low",-10
"SUPPRF57890",16,60,22,50,-13,31,63,40,"Pilot 7","Pilot 7: bigger feedback + text",2,"low",10
"SUPPRF57890",17,76,16,77,14,64,63,71,"Pilot 7","Pilot 7: bigger feedback + text",2,"low",6
"SUPPRF57890",18,69,26,6,-14,64,20,36,"Pilot 7","Pilot 7: bigger feedback + text",2,"low",-30
"SUPPRF57890",19,72,12,67,-13,41,80,44,"Pilot 7","Pilot 7: bigger feedback + text",2,"low",23
"SUPPRF57890",20,74,14,68,-12,66,80,83,"Pilot 7","Pilot 7: bigger feedback + text",2,"low",-15
"SUPPRF57890",21,77,12,47,-16,77,63,60,"Pilot 7","Pilot 7: bigger feedback + text",2,"low",-13
"SUPPRF57890",22,66,11,58,12,46,46,46,"Pilot 7","Pilot 7: bigger feedback + text",2,"low",12
"SUPPRF57890",23,76,12,38,1,47,37,39,"Pilot 7","Pilot 7: bigger feedback + text",2,"low",-1
"SUPPRF57890",24,77,19,41,-13,84,54,66,"Pilot 7","Pilot 7: bigger feedback + text",2,"low",-25
"SUPPRF57890",25,78,15,70,-1,51,71,67,"Pilot 7","Pilot 7: bigger feedback + text",2,"low",3
"SUPPRF57890",26,85,16,83,12,87,71,66,"Pilot 7","Pilot 7: bigger feedback + text",2,"low",17
"SUPPRF57890",27,76,11,8,-12,73,20,23,"Pilot 7","Pilot 7: bigger feedback + text",2,"low",-15
"SUPPRF57890",28,86,7,97,17,68,80,82,"Pilot 7","Pilot 7: bigger feedback + text",2,"low",15
"SUPPRF57890",29,60,12,22,-15,35,37,59,"Pilot 7","Pilot 7: bigger feedback + text",2,"low",-37
"SUPPRF57890",30,70,12,71,0,53,71,55,"Pilot 7","Pilot 7: bigger feedback + text",2,"low",16
"SUPPRF57890",31,84,15,56,-15,64,71,76,"Pilot 7","Pilot 7: bigger feedback + text",2,"low",-20
"SUPPRF57890",32,95,9,96,16,25,80,49,"Pilot 7","Pilot 7: bigger feedback + text",2,"low",47
"SUPPRF57890",33,91,9,48,19,67,29,49,"Pilot 7","Pilot 7: bigger feedback + text",2,"low",-1
"SUPPRF57890",34,88,21,55,1,83,54,61,"Pilot 7","Pilot 7: bigger feedback + text",2,"low",-6
"SUPPRF57890",35,79,15,65,19,78,46,40,"Pilot 7","Pilot 7: bigger feedback + text",2,"low",25
"SUPPRF57890",36,77,10,68,14,79,54,60,"Pilot 7","Pilot 7: bigger feedback + text",2,"low",8
"SUPPRF57890",37,81,28,33,-13,79,46,76,"Pilot 7","Pilot 7: bigger feedback + text",2,"low",-43
"SUPPRF57890",38,90,23,15,-14,71,29,39,"Pilot 7","Pilot 7: bigger feedback + text",2,"low",-24
"SUPPRF57890",39,84,8,37,0,53,37,57,"Pilot 7","Pilot 7: bigger feedback + text",2,"low",-20
"SUPPRF57890",40,86,9,20,0,83,20,22,"Pilot 7","Pilot 7: bigger feedback + text",2,"low",-2
"SUPPRF57890",41,83,14,16,-13,74,29,25,"Pilot 7","Pilot 7: bigger feedback + text",2,"low",-9
"SUPPRF57890",42,78,35,84,13,68,71,43,"Pilot 7","Pilot 7: bigger feedback + text",2,"low",41
"SUPPRF57890",43,84,13,81,1,78,80,44,"Pilot 7","Pilot 7: bigger feedback + text",2,"low",37
"SUPPRF57890",44,86,15,19,-1,85,20,27,"Pilot 7","Pilot 7: bigger feedback + text",2,"low",-8
"SUPPRF57890",45,73,14,24,-13,67,37,62,"Pilot 7","Pilot 7: bigger feedback + text",2,"low",-38
"SUPPRF57890",46,76,12,55,-16,82,71,68,"Pilot 7","Pilot 7: bigger feedback + text",2,"low",-13
"SUPPRF57890",47,79,12,38,-16,71,54,60,"Pilot 7","Pilot 7: bigger feedback + text",2,"low",-22
"SUPPRF57890",48,84,13,35,15,80,20,17,"Pilot 7","Pilot 7: bigger feedback + text",2,"low",18
"SUPPRF59066",1,57,20,58,12,33,46,46,"Pilot 7","Pilot 7: bigger feedback + text",9,"high",12
"SUPPRF59066",2,64,6,20,0,29,20,20,"Pilot 7","Pilot 7: bigger feedback + text",9,"high",0
"SUPPRF59066",3,68,25,35,15,35,20,20,"Pilot 7","Pilot 7: bigger feedback + text",9,"high",15
"SUPPRF59066",4,40,40,22,-15,16,37,35,"Pilot 7","Pilot 7: bigger feedback + text",9,"high",-13
"SUPPRF59066",5,76,19,84,13,22,71,38,"Pilot 7","Pilot 7: bigger feedback + text",9,"high",46
"SUPPRF59066",6,43,38,56,-15,28,71,50,"Pilot 7","Pilot 7: bigger feedback + text",9,"high",6
"SUPPRF59066",7,40,65,29,0,29,29,50,"Pilot 7","Pilot 7: bigger feedback + text",9,"high",-21
"SUPPRF59066",8,58,41,37,0,29,37,41,"Pilot 7","Pilot 7: bigger feedback + text",9,"high",-4
"SUPPRF59066",9,75,31,78,15,50,63,60,"Pilot 7","Pilot 7: bigger feedback + text",9,"high",18
"SUPPRF59066",10,79,25,83,12,60,71,65,"Pilot 7","Pilot 7: bigger feedback + text",9,"high",18
"SUPPRF59066",11,77,14,81,1,60,80,71,"Pilot 7","Pilot 7: bigger feedback + text",9,"high",10
"SUPPRF59066",12,41,25,50,-13,65,63,50,"Pilot 7","Pilot 7: bigger feedback + text",9,"high",0
"SUPPRF59066",13,81,0,70,-1,60,71,70,"Pilot 7","Pilot 7: bigger feedback + text",9,"high",0
"SUPPRF59066",14,23,24,34,-12,70,46,45,"Pilot 7","Pilot 7: bigger feedback + text",9,"high",-11
"SUPPRF59066",15,40,29,46,0,70,46,35,"Pilot 7","Pilot 7: bigger feedback + text",9,"high",11
"SUPPRF59066",16,35,13,37,17,55,20,30,"Pilot 7","Pilot 7: bigger feedback + text",9,"high",7
"SUPPRF59066",17,68,19,66,12,35,54,50,"Pilot 7","Pilot 7: bigger feedback + text",9,"high",16
"SUPPRF59066",18,27,18,38,-16,45,54,50,"Pilot 7","Pilot 7: bigger feedback + text",9,"high",-12
"SUPPRF59066",19,21,5,15,-14,20,29,24,"Pilot 7","Pilot 7: bigger feedback + text",9,"high",-9
"SUPPRF59066",20,97,1,97,17,20,80,50,"Pilot 7","Pilot 7: bigger feedback + text",9,"high",47
"SUPPRF59066",21,72,0,68,14,25,54,35,"Pilot 7","Pilot 7: bigger feedback + text",9,"high",33
"SUPPRF59066",22,62,8,48,19,70,29,25,"Pilot 7","Pilot 7: bigger feedback + text",9,"high",23
"SUPPRF59066",23,27,8,67,-13,25,80,70,"Pilot 7","Pilot 7: bigger feedback + text",9,"high",-3
"SUPPRF59066",24,55,18,62,-1,25,63,60,"Pilot 7","Pilot 7: bigger feedback + text",9,"high",2
"SUPPRF59066",25,93,8,51,14,25,37,30,"Pilot 7","Pilot 7: bigger feedback + text",9,"high",21
"SUPPRF59066",26,84,7,49,12,45,37,24,"Pilot 7","Pilot 7: bigger feedback + text",9,"high",25
"SUPPRF59066",27,87,14,63,0,69,63,29,"Pilot 7","Pilot 7: bigger feedback + text",9,"high",34
"SUPPRF59066",28,99,0,96,16,40,80,60,"Pilot 7","Pilot 7: bigger feedback + text",9,"high",36
"SUPPRF59066",29,38,0,8,-12,70,20,25,"Pilot 7","Pilot 7: bigger feedback + text",9,"high",-17
"SUPPRF59066",30,73,7,68,-12,75,80,85,"Pilot 7","Pilot 7: bigger feedback + text",9,"high",-17
"SUPPRF59066",31,86,5,77,14,10,63,40,"Pilot 7","Pilot 7: bigger feedback + text",9,"high",37
"SUPPRF59066",32,60,6,46,17,55,29,30,"Pilot 7","Pilot 7: bigger feedback + text",9,"high",16
"SUPPRF59066",33,93,8,80,0,16,80,49,"Pilot 7","Pilot 7: bigger feedback + text",9,"high",31
"SUPPRF59066",34,97,5,54,0,30,54,51,"Pilot 7","Pilot 7: bigger feedback + text",9,"high",3
"SUPPRF59066",35,13,6,6,-14,20,20,26,"Pilot 7","Pilot 7: bigger feedback + text",9,"high",-20
"SUPPRF59066",36,36,17,41,-13,60,54,45,"Pilot 7","Pilot 7: bigger feedback + text",9,"high",-4
"SUPPRF59066",37,76,14,65,19,40,46,40,"Pilot 7","Pilot 7: bigger feedback + text",9,"high",25
"SUPPRF59066",38,12,13,24,-13,29,37,48,"Pilot 7","Pilot 7: bigger feedback + text",9,"high",-24
"SUPPRF59066",39,56,0,28,-1,80,29,0,"Pilot 7","Pilot 7: bigger feedback + text",9,"high",28
"SUPPRF59066",40,11,4,19,-1,80,20,10,"Pilot 7","Pilot 7: bigger feedback + text",9,"high",9
"SUPPRF59066",41,65,9,55,1,35,54,49,"Pilot 7","Pilot 7: bigger feedback + text",9,"high",6
"SUPPRF59066",42,58,37,47,-16,45,63,55,"Pilot 7","Pilot 7: bigger feedback + text",9,"high",-8
"SUPPRF59066",43,61,15,38,1,71,37,24,"Pilot 7","Pilot 7: bigger feedback + text",9,"high",14
"SUPPRF59066",44,32,21,16,-13,49,29,25,"Pilot 7","Pilot 7: bigger feedback + text",9,"high",-9
"SUPPRF59066",45,29,15,33,-13,34,46,51,"Pilot 7","Pilot 7: bigger feedback + text",9,"high",-18
"SUPPRF59066",46,93,16,71,0,19,71,35,"Pilot 7","Pilot 7: bigger feedback + text",9,"high",36
"SUPPRF59066",47,37,15,45,-1,65,46,40,"Pilot 7","Pilot 7: bigger feedback + text",9,"high",5
"SUPPRF59066",48,85,16,55,-16,48,71,69,"Pilot 7","Pilot 7: bigger feedback + text",9,"high",-14
"SUPPRF59606",1,60,32,58,12,56,46,47,"Pilot 7","Pilot 7: bigger feedback + text",4,"low",11
"SUPPRF59606",2,62,28,84,13,87,71,78,"Pilot 7","Pilot 7: bigger feedback + text",4,"low",6
"SUPPRF59606",3,67,32,38,1,35,37,40,"Pilot 7","Pilot 7: bigger feedback + text",4,"low",-2
"SUPPRF59606",4,68,20,68,14,26,54,45,"Pilot 7","Pilot 7: bigger feedback + text",4,"low",23
"SUPPRF59606",5,71,30,77,14,69,63,66,"Pilot 7","Pilot 7: bigger feedback + text",4,"low",11
"SUPPRF59606",6,83,22,97,17,87,80,87,"Pilot 7","Pilot 7: bigger feedback + text",4,"low",10
"SUPPRF59606",7,35,61,15,-14,31,29,29,"Pilot 7","Pilot 7: bigger feedback + text",4,"low",-14
"SUPPRF59606",8,57,40,46,17,36,29,39,"Pilot 7","Pilot 7: bigger feedback + text",4,"low",7
"SUPPRF59606",9,77,24,54,0,74,54,57,"Pilot 7","Pilot 7: bigger feedback + text",4,"low",-3
"SUPPRF59606",10,74,28,96,16,61,80,73,"Pilot 7","Pilot 7: bigger feedback + text",4,"low",23
"SUPPRF59606",11,80,17,71,0,79,71,72,"Pilot 7","Pilot 7: bigger feedback + text",4,"low",-1
"SUPPRF59606",12,66,33,37,17,35,20,47,"Pilot 7","Pilot 7: bigger feedback + text",4,"low",-10
"SUPPRF59606",13,75,26,63,0,37,63,63,"Pilot 7","Pilot 7: bigger feedback + text",4,"low",0
"SUPPRF59606",14,52,28,20,0,46,20,32,"Pilot 7","Pilot 7: bigger feedback + text",4,"low",-12
"SUPPRF59606",15,37,62,6,-14,42,20,58,"Pilot 7","Pilot 7: bigger feedback + text",4,"low",-52
"SUPPRF59606",16,55,29,41,-13,43,54,43,"Pilot 7","Pilot 7: bigger feedback + text",4,"low",-2
"SUPPRF59606",17,57,34,66,12,31,54,53,"Pilot 7","Pilot 7: bigger feedback + text",4,"low",13
"SUPPRF59606",18,74,14,80,0,69,80,57,"Pilot 7","Pilot 7: bigger feedback + text",4,"low",23
"SUPPRF59606",19,59,45,22,-15,61,37,38,"Pilot 7","Pilot 7: bigger feedback + text",4,"low",-16
"SUPPRF59606",20,31,56,35,15,69,20,65,"Pilot 7","Pilot 7: bigger feedback + text",4,"low",-30
"SUPPRF59606",21,61,41,70,-1,28,71,51,"Pilot 7","Pilot 7: bigger feedback + text",4,"low",19
"SUPPRF59606",22,59,38,55,-16,76,71,75,"Pilot 7","Pilot 7: bigger feedback + text",4,"low",-20
"SUPPRF59606",23,22,62,16,-13,46,29,53,"Pilot 7","Pilot 7: bigger feedback + text",4,"low",-37
"SUPPRF59606",24,56,35,65,19,39,46,51,"Pilot 7","Pilot 7: bigger feedback + text",4,"low",14
"SUPPRF59606",25,70,28,50,-13,21,63,43,"Pilot 7","Pilot 7: bigger feedback + text",4,"low",7
"SUPPRF59606",26,70,23,48,19,61,29,25,"Pilot 7","Pilot 7: bigger feedback + text",4,"low",23
"SUPPRF59606",27,57,30,37,0,25,37,42,"Pilot 7","Pilot 7: bigger feedback + text",4,"low",-5
"SUPPRF59606",28,42,54,56,-15,78,71,88,"Pilot 7","Pilot 7: bigger feedback + text",4,"low",-32
"SUPPRF59606",29,12,64,8,-12,32,20,20,"Pilot 7","Pilot 7: bigger feedback + text",4,"low",-12
"SUPPRF59606",30,49,53,51,14,40,37,41,"Pilot 7","Pilot 7: bigger feedback + text",4,"low",10
"SUPPRF59606",31,65,26,62,-1,43,63,61,"Pilot 7","Pilot 7: bigger feedback + text",4,"low",1
"SUPPRF59606",32,70,37,49,12,29,37,38,"Pilot 7","Pilot 7: bigger feedback + text",4,"low",11
"SUPPRF59606",33,25,61,38,-16,34,54,64,"Pilot 7","Pilot 7: bigger feedback + text",4,"low",-26
"SUPPRF59606",34,56,30,33,-13,19,46,32,"Pilot 7","Pilot 7: bigger feedback + text",4,"low",1
"SUPPRF59606",35,67,24,46,0,28,46,43,"Pilot 7","Pilot 7: bigger feedback + text",4,"low",3
"SUPPRF59606",36,57,49,24,-13,30,37,43,"Pilot 7","Pilot 7: bigger feedback + text",4,"low",-19
"SUPPRF59606",37,62,40,45,-1,29,46,55,"Pilot 7","Pilot 7: bigger feedback + text",4,"low",-10
"SUPPRF59606",38,68,22,55,1,52,54,59,"Pilot 7","Pilot 7: bigger feedback + text",4,"low",-4
"SUPPRF59606",39,85,29,83,12,76,71,71,"Pilot 7","Pilot 7: bigger feedback + text",4,"low",12
"SUPPRF59606",40,40,65,67,-13,83,80,85,"Pilot 7","Pilot 7: bigger feedback + text",4,"low",-18
"SUPPRF59606",41,36,60,47,-16,35,63,61,"Pilot 7","Pilot 7: bigger feedback + text",4,"low",-14
"SUPPRF59606",42,84,20,81,1,27,80,44,"Pilot 7","Pilot 7: bigger feedback + text",4,"low",37
"SUPPRF59606",43,15,77,29,0,31,29,45,"Pilot 7","Pilot 7: bigger feedback + text",4,"low",-16
"SUPPRF59606",44,10,84,19,-1,21,20,50,"Pilot 7","Pilot 7: bigger feedback + text",4,"low",-31
"SUPPRF59606",45,59,31,34,-12,30,46,32,"Pilot 7","Pilot 7: bigger feedback + text",4,"low",2
"SUPPRF59606",46,78,29,68,-12,27,80,64,"Pilot 7","Pilot 7: bigger feedback + text",4,"low",4
"SUPPRF59606",47,79,23,78,15,29,63,51,"Pilot 7","Pilot 7: bigger feedback + text",4,"low",27
"SUPPRF59606",48,49,16,28,-1,21,29,39,"Pilot 7","Pilot 7: bigger feedback + text",4,"low",-11
"SUPPRF60832",1,27,72,41,-13,62,54,60,"Pilot 9","Pilot 9: bigger feedback + text",6,"high",-19
"SUPPRF60832",2,96,1,100,20,89,80,89,"Pilot 9","Pilot 9: bigger feedback + text",6,"high",11
"SUPPRF60832",3,18,85,34,-12,77,46,27,"Pilot 9","Pilot 9: bigger feedback + text",6,"high",7
"SUPPRF60832",4,9,86,49,12,81,37,30,"Pilot 9","Pilot 9: bigger feedback + text",6,"high",19
"SUPPRF60832",5,68,43,58,12,83,46,41,"Pilot 9","Pilot 9: bigger feedback + text",6,"high",17
"SUPPRF60832",6,18,68,38,-16,47,54,27,"Pilot 9","Pilot 9: bigger feedback + text",6,"high",11
"SUPPRF60832",7,83,25,55,1,49,54,6,"Pilot 9","Pilot 9: bigger feedback + text",6,"high",49
"SUPPRF60832",8,64,35,47,-16,35,63,54,"Pilot 9","Pilot 9: bigger feedback + text",6,"high",-7
"SUPPRF60832",9,84,12,68,-12,30,80,67,"Pilot 9","Pilot 9: bigger feedback + text",6,"high",1
"SUPPRF60832",10,77,31,61,24,75,37,17,"Pilot 9","Pilot 9: bigger feedback + text",6,"high",44
"SUPPRF60832",11,1,99,15,-14,59,29,71,"Pilot 9","Pilot 9: bigger feedback + text",6,"high",-56
"SUPPRF60832",12,32,59,19,-1,91,20,14,"Pilot 9","Pilot 9: bigger feedback + text",6,"high",5
"SUPPRF60832",13,76,34,55,-16,45,71,33,"Pilot 9","Pilot 9: bigger feedback + text",6,"high",22
"SUPPRF60832",14,3,98,6,-14,13,20,22,"Pilot 9","Pilot 9: bigger feedback + text",6,"high",-16
"SUPPRF60832",15,98,4,96,16,80,80,66,"Pilot 9","Pilot 9: bigger feedback + text",6,"high",30
"SUPPRF60832",16,92,8,78,24,25,54,42,"Pilot 9","Pilot 9: bigger feedback + text",6,"high",36
"SUPPRF60832",17,24,86,28,-1,51,29,45,"Pilot 9","Pilot 9: bigger feedback + text",6,"high",-17
"SUPPRF60832",18,21,72,37,0,14,37,64,"Pilot 9","Pilot 9: bigger feedback + text",6,"high",-27
"SUPPRF60832",19,74,27,71,0,33,71,56,"Pilot 9","Pilot 9: bigger feedback + text",6,"high",15
"SUPPRF60832",20,84,28,77,14,49,63,45,"Pilot 9","Pilot 9: bigger feedback + text",6,"high",32
"SUPPRF60832",21,65,32,47,27,76,20,21,"Pilot 9","Pilot 9: bigger feedback + text",6,"high",26
"SUPPRF60832",22,67,31,58,29,80,29,71,"Pilot 9","Pilot 9: bigger feedback + text",6,"high",-13
"SUPPRF60832",23,81,31,75,29,58,46,52,"Pilot 9","Pilot 9: bigger feedback + text",6,"high",23
"SUPPRF60832",24,69,23,63,0,82,63,68,"Pilot 9","Pilot 9: bigger feedback + text",6,"high",-5
"SUPPRF60832",25,5,92,16,-13,35,29,54,"Pilot 9","Pilot 9: bigger feedback + text",6,"high",-38
"SUPPRF60832",26,61,42,56,-15,53,71,51,"Pilot 9","Pilot 9: bigger feedback + text",6,"high",5
"SUPPRF60832",27,72,32,50,-13,19,63,34,"Pilot 9","Pilot 9: bigger feedback + text",6,"high",16
"SUPPRF60832",28,79,34,66,12,30,54,46,"Pilot 9","Pilot 9: bigger feedback + text",6,"high",20
"SUPPRF60832",29,70,25,67,-13,71,80,72,"Pilot 9","Pilot 9: bigger feedback + text",6,"high",-5
"SUPPRF60832",30,18,65,38,1,20,37,54,"Pilot 9","Pilot 9: bigger feedback + text",6,"high",-16
"SUPPRF60832",31,71,16,83,12,9,71,23,"Pilot 9","Pilot 9: bigger feedback + text",6,"high",60
"SUPPRF60832",32,80,30,62,-1,26,63,65,"Pilot 9","Pilot 9: bigger feedback + text",6,"high",-3
"SUPPRF60832",33,98,1,70,-1,1,71,68,"Pilot 9","Pilot 9: bigger feedback + text",6,"high",2
"SUPPRF60832",34,12,85,24,-13,36,37,38,"Pilot 9","Pilot 9: bigger feedback + text",6,"high",-14
"SUPPRF60832",35,20,84,22,-15,56,37,34,"Pilot 9","Pilot 9: bigger feedback + text",6,"high",-12
"SUPPRF60832",36,98,1,94,23,1,71,45,"Pilot 9","Pilot 9: bigger feedback + text",6,"high",49
"SUPPRF60832",37,2,97,8,-12,84,20,23,"Pilot 9","Pilot 9: bigger feedback + text",6,"high",-15
"SUPPRF60832",38,61,33,33,-13,16,46,35,"Pilot 9","Pilot 9: bigger feedback + text",6,"high",-2
"SUPPRF60832",39,88,11,80,0,16,80,54,"Pilot 9","Pilot 9: bigger feedback + text",6,"high",26
"SUPPRF60832",40,96,10,81,1,61,80,50,"Pilot 9","Pilot 9: bigger feedback + text",6,"high",31
"SUPPRF60832",41,72,39,35,15,87,20,16,"Pilot 9","Pilot 9: bigger feedback + text",6,"high",19
"SUPPRF60832",42,41,53,20,0,71,20,25,"Pilot 9","Pilot 9: bigger feedback + text",6,"high",-5
"SUPPRF60832",43,75,24,46,0,86,46,24,"Pilot 9","Pilot 9: bigger feedback + text",6,"high",22
"SUPPRF60832",44,39,70,46,17,30,29,29,"Pilot 9","Pilot 9: bigger feedback + text",6,"high",17
"SUPPRF60832",45,93,16,88,25,21,63,59,"Pilot 9","Pilot 9: bigger feedback + text",6,"high",29
"SUPPRF60832",46,63,34,54,0,44,54,67,"Pilot 9","Pilot 9: bigger feedback + text",6,"high",-13
"SUPPRF60832",47,58,43,45,-1,71,46,52,"Pilot 9","Pilot 9: bigger feedback + text",6,"high",-7
"SUPPRF60832",48,70,26,29,0,77,29,28,"Pilot 9","Pilot 9: bigger feedback + text",6,"high",1
"SUPPRF61000",1,34,40,22,-15,34,37,35,"Pilot 10","Pilot 10: bigger feedback + video",5,"low",-13
"SUPPRF61000",2,70,37,100,20,30,80,36,"Pilot 10","Pilot 10: bigger feedback + video",5,"low",64
"SUPPRF61000",3,54,35,66,12,41,54,35,"Pilot 10","Pilot 10: bigger feedback + video",5,"low",31
"SUPPRF61000",4,54,44,75,29,54,46,42,"Pilot 10","Pilot 10: bigger feedback + video",5,"low",33
"SUPPRF61000",5,46,56,50,-13,46,63,53,"Pilot 10","Pilot 10: bigger feedback + video",5,"low",-3
"SUPPRF61000",6,54,44,46,17,28,29,19,"Pilot 10","Pilot 10: bigger feedback + video",5,"low",27
"SUPPRF61000",7,51,44,58,12,32,46,33,"Pilot 10","Pilot 10: bigger feedback + video",5,"low",25
"SUPPRF61000",8,32,39,20,0,20,20,13,"Pilot 10","Pilot 10: bigger feedback + video",5,"low",7
"SUPPRF61000",9,49,53,38,1,39,37,34,"Pilot 10","Pilot 10: bigger feedback + video",5,"low",4
"SUPPRF61000",10,52,47,80,0,60,80,47,"Pilot 10","Pilot 10: bigger feedback + video",5,"low",33
"SUPPRF61000",11,45,42,24,-13,33,37,39,"Pilot 10","Pilot 10: bigger feedback + video",5,"low",-15
"SUPPRF61000",12,51,47,33,-13,42,46,33,"Pilot 10","Pilot 10: bigger feedback + video",5,"low",0
"SUPPRF61000",13,54,50,96,16,16,80,38,"Pilot 10","Pilot 10: bigger feedback + video",5,"low",58
"SUPPRF61000",14,44,46,37,0,34,37,32,"Pilot 10","Pilot 10: bigger feedback + video",5,"low",5
"SUPPRF61000",15,33,71,15,-14,44,29,24,"Pilot 10","Pilot 10: bigger feedback + video",5,"low",-9
"SUPPRF61000",16,29,49,29,0,31,29,26,"Pilot 10","Pilot 10: bigger feedback + video",5,"low",3
"SUPPRF61000",17,45,48,47,-16,40,63,35,"Pilot 10","Pilot 10: bigger feedback + video",5,"low",12
"SUPPRF61000",18,50,46,62,-1,19,63,41,"Pilot 10","Pilot 10: bigger feedback + video",5,"low",21
"SUPPRF61000",19,38,45,55,1,33,54,35,"Pilot 10","Pilot 10: bigger feedback + video",5,"low",20
"SUPPRF61000",20,17,62,83,12,16,71,26,"Pilot 10","Pilot 10: bigger feedback + video",5,"low",57
"SUPPRF61000",21,29,26,56,-15,26,71,31,"Pilot 10","Pilot 10: bigger feedback + video",5,"low",25
"SUPPRF61000",22,24,36,54,0,43,54,37,"Pilot 10","Pilot 10: bigger feedback + video",5,"low",17
"SUPPRF61000",23,29,65,28,-1,44,29,17,"Pilot 10","Pilot 10: bigger feedback + video",5,"low",11
"SUPPRF61000",24,32,60,35,15,79,20,13,"Pilot 10","Pilot 10: bigger feedback + video",5,"low",22
"SUPPRF61000",25,28,58,68,-12,53,80,68,"Pilot 10","Pilot 10: bigger feedback + video",5,"low",0
"SUPPRF61000",26,41,63,46,0,33,46,24,"Pilot 10","Pilot 10: bigger feedback + video",5,"low",22
"SUPPRF61000",27,56,53,61,24,11,37,21,"Pilot 10","Pilot 10: bigger feedback + video",5,"low",40
"SUPPRF61000",28,50,49,45,-1,62,46,26,"Pilot 10","Pilot 10: bigger feedback + video",5,"low",19
"SUPPRF61000",29,23,51,8,-12,60,20,9,"Pilot 10","Pilot 10: bigger feedback + video",5,"low",-1
"SUPPRF61000",30,48,47,67,-13,31,80,37,"Pilot 10","Pilot 10: bigger feedback + video",5,"low",30
"SUPPRF61000",31,47,53,55,-16,42,71,41,"Pilot 10","Pilot 10: bigger feedback + video",5,"low",14
"SUPPRF61000",32,64,46,71,0,37,71,36,"Pilot 10","Pilot 10: bigger feedback + video",5,"low",35
"SUPPRF61000",33,52,45,41,-13,33,54,35,"Pilot 10","Pilot 10: bigger feedback + video",5,"low",6
"SUPPRF61000",34,19,60,6,-14,30,20,15,"Pilot 10","Pilot 10: bigger feedback + video",5,"low",-9
"SUPPRF61000",35,29,57,49,12,47,37,20,"Pilot 10","Pilot 10: bigger feedback + video",5,"low",29
"SUPPRF61000",36,32,57,34,-12,36,46,27,"Pilot 10","Pilot 10: bigger feedback + video",5,"low",7
"SUPPRF61000",37,55,52,58,29,16,29,17,"Pilot 10","Pilot 10: bigger feedback + video",5,"low",41
"SUPPRF61000",38,33,55,38,-16,29,54,30,"Pilot 10","Pilot 10: bigger feedback + video",5,"low",8
"SUPPRF61000",39,26,51,81,1,20,80,36,"Pilot 10","Pilot 10: bigger feedback + video",5,"low",45
"SUPPRF61000",40,43,61,19,-1,79,20,5,"Pilot 10","Pilot 10: bigger feedback + video",5,"low",14
"SUPPRF61000",41,46,56,78,24,65,54,46,"Pilot 10","Pilot 10: bigger feedback + video",5,"low",32
"SUPPRF61000",42,52,61,63,0,54,63,46,"Pilot 10","Pilot 10: bigger feedback + video",5,"low",17
"SUPPRF61000",43,54,54,94,23,38,71,48,"Pilot 10","Pilot 10: bigger feedback + video",5,"low",46
"SUPPRF61000",44,52,54,77,14,48,63,33,"Pilot 10","Pilot 10: bigger feedback + video",5,"low",44
"SUPPRF61000",45,16,76,16,-13,74,29,32,"Pilot 10","Pilot 10: bigger feedback + video",5,"low",-16
"SUPPRF61000",46,58,60,88,25,40,63,30,"Pilot 10","Pilot 10: bigger feedback + video",5,"low",58
"SUPPRF61000",47,62,54,70,-1,63,71,61,"Pilot 10","Pilot 10: bigger feedback + video",5,"low",9
"SUPPRF61000",48,55,58,47,27,87,20,7,"Pilot 10","Pilot 10: bigger feedback + video",5,"low",40
"SUPPRF61088",1,43,40,62,-1,66,63,52,"Pilot 7","Pilot 7: bigger feedback + text",9,"high",10
"SUPPRF61088",2,32,39,24,-13,26,37,34,"Pilot 7","Pilot 7: bigger feedback + text",9,"high",-10
"SUPPRF61088",3,34,31,46,17,79,29,27,"Pilot 7","Pilot 7: bigger feedback + text",9,"high",19
"SUPPRF61088",4,29,23,68,14,62,54,39,"Pilot 7","Pilot 7: bigger feedback + text",9,"high",29
"SUPPRF61088",5,34,30,6,-14,70,20,18,"Pilot 7","Pilot 7: bigger feedback + text",9,"high",-12
"SUPPRF61088",6,30,32,29,0,63,29,27,"Pilot 7","Pilot 7: bigger feedback + text",9,"high",2
"SUPPRF61088",7,40,34,41,-13,43,54,36,"Pilot 7","Pilot 7: bigger feedback + text",9,"high",5
"SUPPRF61088",8,36,47,34,-12,29,46,39,"Pilot 7","Pilot 7: bigger feedback + text",9,"high",-5
"SUPPRF61088",9,29,28,38,-16,34,54,64,"Pilot 7","Pilot 7: bigger feedback + text",9,"high",-26
"SUPPRF61088",10,39,29,63,0,31,63,35,"Pilot 7","Pilot 7: bigger feedback + text",9,"high",28
"SUPPRF61088",11,31,21,33,-13,40,46,53,"Pilot 7","Pilot 7: bigger feedback + text",9,"high",-20
"SUPPRF61088",12,43,21,49,12,31,37,44,"Pilot 7","Pilot 7: bigger feedback + text",9,"high",5
"SUPPRF61088",13,51,12,97,17,77,80,80,"Pilot 7","Pilot 7: bigger feedback + text",9,"high",17
"SUPPRF61088",14,38,12,80,0,42,80,71,"Pilot 7","Pilot 7: bigger feedback + text",9,"high",9
"SUPPRF61088",15,37,11,56,-15,32,71,66,"Pilot 7","Pilot 7: bigger feedback + text",9,"high",-10
"SUPPRF61088",16,43,10,81,1,37,80,75,"Pilot 7","Pilot 7: bigger feedback + text",9,"high",6
"SUPPRF61088",17,39,10,71,0,68,71,77,"Pilot 7","Pilot 7: bigger feedback + text",9,"high",-6
"SUPPRF61088",18,39,13,35,15,63,20,25,"Pilot 7","Pilot 7: bigger feedback + text",9,"high",10
"SUPPRF61088",19,60,20,77,14,19,63,47,"Pilot 7","Pilot 7: bigger feedback + text",9,"high",30
"SUPPRF61088",20,39,18,78,15,42,63,64,"Pilot 7","Pilot 7: bigger feedback + text",9,"high",14
"SUPPRF61088",21,32,12,50,-13,59,63,56,"Pilot 7","Pilot 7: bigger feedback + text",9,"high",-6
"SUPPRF61088",22,31,15,55,-16,35,71,40,"Pilot 7","Pilot 7: bigger feedback + text",9,"high",15
"SUPPRF61088",23,25,18,55,1,65,54,60,"Pilot 7","Pilot 7: bigger feedback + text",9,"high",-5
"SUPPRF61088",24,34,26,45,-1,44,46,66,"Pilot 7","Pilot 7: bigger feedback + text",9,"high",-21
"SUPPRF61088",25,31,15,84,13,24,71,45,"Pilot 7","Pilot 7: bigger feedback + text",9,"high",39
"SUPPRF61088",26,22,14,58,12,29,46,53,"Pilot 7","Pilot 7: bigger feedback + text",9,"high",5
"SUPPRF61088",27,16,21,96,16,49,80,55,"Pilot 7","Pilot 7: bigger feedback + text",9,"high",41
"SUPPRF61088",28,20,14,67,-13,82,80,83,"Pilot 7","Pilot 7: bigger feedback + text",9,"high",-16
"SUPPRF61088",29,14,20,8,-12,33,20,54,"Pilot 7","Pilot 7: bigger feedback + text",9,"high",-46
"SUPPRF61088",30,26,11,28,-1,65,29,26,"Pilot 7","Pilot 7: bigger feedback + text",9,"high",2
"SUPPRF61088",31,20,18,66,12,11,54,26,"Pilot 7","Pilot 7: bigger feedback + text",9,"high",40
"SUPPRF61088",32,20,9,83,12,27,71,68,"Pilot 7","Pilot 7: bigger feedback + text",9,"high",15
"SUPPRF61088",33,27,7,20,0,63,20,19,"Pilot 7","Pilot 7: bigger feedback + text",9,"high",1
"SUPPRF61088",34,30,20,16,-13,32,29,39,"Pilot 7","Pilot 7: bigger feedback + text",9,"high",-23
"SUPPRF61088",35,24,20,15,-14,24,29,33,"Pilot 7","Pilot 7: bigger feedback + text",9,"high",-18
"SUPPRF61088",36,32,7,65,19,33,46,39,"Pilot 7","Pilot 7: bigger feedback + text",9,"high",26
"SUPPRF61088",37,19,12,22,-15,43,37,52,"Pilot 7","Pilot 7: bigger feedback + text",9,"high",-30
"SUPPRF61088",38,26,11,37,17,79,20,20,"Pilot 7","Pilot 7: bigger feedback + text",9,"high",17
"SUPPRF61088",39,34,13,46,0,61,46,55,"Pilot 7","Pilot 7: bigger feedback + text",9,"high",-9
"SUPPRF61088",40,19,8,51,14,62,37,54,"Pilot 7","Pilot 7: bigger feedback + text",9,"high",-3
"SUPPRF61088",41,24,9,68,-12,30,80,34,"Pilot 7","Pilot 7: bigger feedback + text",9,"high",34
"SUPPRF61088",42,20,9,70,-1,59,71,61,"Pilot 7","Pilot 7: bigger feedback + text",9,"high",9
"SUPPRF61088",43,13,9,48,19,84,29,21,"Pilot 7","Pilot 7: bigger feedback + text",9,"high",27
"SUPPRF61088",44,23,16,38,1,7,37,14,"Pilot 7","Pilot 7: bigger feedback + text",9,"high",24
"SUPPRF61088",45,17,7,47,-16,65,63,53,"Pilot 7","Pilot 7: bigger feedback + text",9,"high",-6
"SUPPRF61088",46,16,6,37,0,4,37,16,"Pilot 7","Pilot 7: bigger feedback + text",9,"high",21
"SUPPRF61088",47,17,7,19,-1,74,20,20,"Pilot 7","Pilot 7: bigger feedback + text",9,"high",-1
"SUPPRF61088",48,23,11,54,0,60,54,53,"Pilot 7","Pilot 7: bigger feedback + text",9,"high",1
"SUPPRF61122",1,55,46,100,20,60,80,66,"Pilot 10","Pilot 10: bigger feedback + video",4,"low",34
"SUPPRF61122",2,50,51,55,1,49,54,49,"Pilot 10","Pilot 10: bigger feedback + video",4,"low",6
"SUPPRF61122",3,41,62,33,-13,48,46,40,"Pilot 10","Pilot 10: bigger feedback + video",4,"low",-7
"SUPPRF61122",4,51,50,83,12,50,71,57,"Pilot 10","Pilot 10: bigger feedback + video",4,"low",26
"SUPPRF61122",5,53,48,81,1,49,80,49,"Pilot 10","Pilot 10: bigger feedback + video",4,"low",32
"SUPPRF61122",6,59,41,47,27,49,20,20,"Pilot 10","Pilot 10: bigger feedback + video",4,"low",27
"SUPPRF61122",7,45,56,58,12,52,46,32,"Pilot 10","Pilot 10: bigger feedback + video",4,"low",26
"SUPPRF61122",8,65,31,62,-1,52,63,51,"Pilot 10","Pilot 10: bigger feedback + video",4,"low",11
"SUPPRF61122",9,32,69,22,-15,49,37,48,"Pilot 10","Pilot 10: bigger feedback + video",4,"low",-26
"SUPPRF61122",10,50,51,38,1,64,37,31,"Pilot 10","Pilot 10: bigger feedback + video",4,"low",7
"SUPPRF61122",11,33,60,34,-12,67,46,51,"Pilot 10","Pilot 10: bigger feedback + video",4,"low",-17
"SUPPRF61122",12,87,42,20,0,72,20,18,"Pilot 10","Pilot 10: bigger feedback + video",4,"low",2
"SUPPRF61122",13,23,51,15,-14,50,29,50,"Pilot 10","Pilot 10: bigger feedback + video",4,"low",-35
"SUPPRF61122",14,71,41,58,29,66,29,30,"Pilot 10","Pilot 10: bigger feedback + video",4,"low",28
"SUPPRF61122",15,55,43,49,12,67,37,43,"Pilot 10","Pilot 10: bigger feedback + video",4,"low",6
"SUPPRF61122",16,37,53,8,-12,82,20,18,"Pilot 10","Pilot 10: bigger feedback + video",4,"low",-10
"SUPPRF61122",17,54,48,29,0,80,29,21,"Pilot 10","Pilot 10: bigger feedback + video",4,"low",8
"SUPPRF61122",18,71,39,70,-1,75,71,69,"Pilot 10","Pilot 10: bigger feedback + video",4,"low",1
"SUPPRF61122",19,94,18,94,23,54,71,76,"Pilot 10","Pilot 10: bigger feedback + video",4,"low",18
"SUPPRF61122",20,37,57,24,-13,55,37,37,"Pilot 10","Pilot 10: bigger feedback + video",4,"low",-13
"SUPPRF61122",21,88,26,66,12,69,54,49,"Pilot 10","Pilot 10: bigger feedback + video",4,"low",17
"SUPPRF61122",22,71,39,37,0,76,37,37,"Pilot 10","Pilot 10: bigger feedback + video",4,"low",0
"SUPPRF61122",23,90,16,54,0,56,54,50,"Pilot 10","Pilot 10: bigger feedback + video",4,"low",4
"SUPPRF61122",24,58,42,35,15,87,20,1,"Pilot 10","Pilot 10: bigger feedback + video",4,"low",34
"SUPPRF61122",25,41,61,41,-13,70,54,49,"Pilot 10","Pilot 10: bigger feedback + video",4,"low",-8
"SUPPRF61122",26,27,56,50,-13,63,63,58,"Pilot 10","Pilot 10: bigger feedback + video",4,"low",-8
"SUPPRF61122",27,25,76,38,-16,67,54,55,"Pilot 10","Pilot 10: bigger feedback + video",4,"low",-17
"SUPPRF61122",28,27,79,16,-13,66,29,42,"Pilot 10","Pilot 10: bigger feedback + video",4,"low",-26
"SUPPRF61122",29,43,53,68,-12,77,80,73,"Pilot 10","Pilot 10: bigger feedback + video",4,"low",-5
"SUPPRF61122",30,97,6,78,24,79,54,43,"Pilot 10","Pilot 10: bigger feedback + video",4,"low",35
"SUPPRF61122",31,55,42,61,24,66,37,41,"Pilot 10","Pilot 10: bigger feedback + video",4,"low",20
"SUPPRF61122",32,40,62,46,17,50,29,52,"Pilot 10","Pilot 10: bigger feedback + video",4,"low",-6
"SUPPRF61122",33,55,43,45,-1,59,46,39,"Pilot 10","Pilot 10: bigger feedback + video",4,"low",6
"SUPPRF61122",34,54,49,19,-1,85,20,17,"Pilot 10","Pilot 10: bigger feedback + video",4,"low",2
"SUPPRF61122",35,75,37,63,0,80,63,55,"Pilot 10","Pilot 10: bigger feedback + video",4,"low",8
"SUPPRF61122",36,53,46,55,-16,45,71,49,"Pilot 10","Pilot 10: bigger feedback + video",4,"low",6
"SUPPRF61122",37,53,41,6,-14,58,20,3,"Pilot 10","Pilot 10: bigger feedback + video",4,"low",3
"SUPPRF61122",38,98,13,96,16,87,80,82,"Pilot 10","Pilot 10: bigger feedback + video",4,"low",14
"SUPPRF61122",39,66,39,46,0,95,46,41,"Pilot 10","Pilot 10: bigger feedback + video",4,"low",5
"SUPPRF61122",40,77,30,77,14,48,63,50,"Pilot 10","Pilot 10: bigger feedback + video",4,"low",27
"SUPPRF61122",41,80,32,80,0,87,80,82,"Pilot 10","Pilot 10: bigger feedback + video",4,"low",-2
"SUPPRF61122",42,81,25,67,-13,59,80,67,"Pilot 10","Pilot 10: bigger feedback + video",4,"low",0
"SUPPRF61122",43,80,32,75,29,57,46,48,"Pilot 10","Pilot 10: bigger feedback + video",4,"low",27
"SUPPRF61122",44,52,51,47,-16,71,63,52,"Pilot 10","Pilot 10: bigger feedback + video",4,"low",-5
"SUPPRF61122",45,57,46,71,0,46,71,67,"Pilot 10","Pilot 10: bigger feedback + video",4,"low",4
"SUPPRF61122",46,53,52,56,-15,66,71,71,"Pilot 10","Pilot 10: bigger feedback + video",4,"low",-15
"SUPPRF61122",47,40,54,28,-1,50,29,50,"Pilot 10","Pilot 10: bigger feedback + video",4,"low",-22
"SUPPRF61122",48,55,43,88,25,80,63,53,"Pilot 10","Pilot 10: bigger feedback + video",4,"low",35
"SUPPRF61705",1,40,62,41,-13,53,54,70,"Pilot 11","Pilot 11: bigger feedback + video + socially anxious",8,"high",-29
"SUPPRF61705",2,45,64,55,1,39,54,35,"Pilot 11","Pilot 11: bigger feedback + video + socially anxious",8,"high",20
"SUPPRF61705",3,58,59,96,16,45,80,34,"Pilot 11","Pilot 11: bigger feedback + video + socially anxious",8,"high",62
"SUPPRF61705",4,37,62,29,0,27,29,31,"Pilot 11","Pilot 11: bigger feedback + video + socially anxious",8,"high",-2
"SUPPRF61705",5,45,64,47,-16,42,63,47,"Pilot 11","Pilot 11: bigger feedback + video + socially anxious",8,"high",0
"SUPPRF61705",6,55,62,67,-13,62,80,55,"Pilot 11","Pilot 11: bigger feedback + video + socially anxious",8,"high",12
"SUPPRF61705",7,43,59,70,-1,19,71,25,"Pilot 11","Pilot 11: bigger feedback + video + socially anxious",8,"high",45
"SUPPRF61705",8,33,53,33,-13,16,46,14,"Pilot 11","Pilot 11: bigger feedback + video + socially anxious",8,"high",19
"SUPPRF61705",9,44,57,77,14,32,63,16,"Pilot 11","Pilot 11: bigger feedback + video + socially anxious",8,"high",61
"SUPPRF61705",10,60,42,66,12,8,54,12,"Pilot 11","Pilot 11: bigger feedback + video + socially anxious",8,"high",54
"SUPPRF61705",11,45,48,20,0,54,20,11,"Pilot 11","Pilot 11: bigger feedback + video + socially anxious",8,"high",9
"SUPPRF61705",12,46,42,34,-12,46,46,28,"Pilot 11","Pilot 11: bigger feedback + video + socially anxious",8,"high",6
"SUPPRF61705",13,39,46,37,0,27,37,41,"Pilot 11","Pilot 11: bigger feedback + video + socially anxious",8,"high",-4
"SUPPRF61705",14,71,49,100,20,30,80,30,"Pilot 11","Pilot 11: bigger feedback + video + socially anxious",8,"high",70
"SUPPRF61705",15,43,44,75,29,32,46,32,"Pilot 11","Pilot 11: bigger feedback + video + socially anxious",8,"high",43
"SUPPRF61705",16,52,40,61,24,38,37,42,"Pilot 11","Pilot 11: bigger feedback + video + socially anxious",8,"high",19
"SUPPRF61705",17,59,51,62,-1,39,63,38,"Pilot 11","Pilot 11: bigger feedback + video + socially anxious",8,"high",24
"SUPPRF61705",18,32,39,45,-1,23,46,30,"Pilot 11","Pilot 11: bigger feedback + video + socially anxious",8,"high",15
"SUPPRF61705",19,49,47,16,-13,49,29,53,"Pilot 11","Pilot 11: bigger feedback + video + socially anxious",8,"high",-37
"SUPPRF61705",20,48,53,46,17,39,29,29,"Pilot 11","Pilot 11: bigger feedback + video + socially anxious",8,"high",17
"SUPPRF61705",21,51,52,78,24,39,54,16,"Pilot 11","Pilot 11: bigger feedback + video + socially anxious",8,"high",62
"SUPPRF61705",22,52,46,38,1,60,37,25,"Pilot 11","Pilot 11: bigger feedback + video + socially anxious",8,"high",13
"SUPPRF61705",23,38,38,28,-1,35,29,34,"Pilot 11","Pilot 11: bigger feedback + video + socially anxious",8,"high",-6
"SUPPRF61705",24,37,45,63,0,58,63,38,"Pilot 11","Pilot 11: bigger feedback + video + socially anxious",8,"high",25
"SUPPRF61705",25,34,40,24,-13,65,37,15,"Pilot 11","Pilot 11: bigger feedback + video + socially anxious",8,"high",9
"SUPPRF61705",26,42,33,49,12,42,37,36,"Pilot 11","Pilot 11: bigger feedback + video + socially anxious",8,"high",13
"SUPPRF61705",27,41,39,6,-14,31,20,29,"Pilot 11","Pilot 11: bigger feedback + video + socially anxious",8,"high",-23
"SUPPRF61705",28,33,41,71,0,39,71,36,"Pilot 11","Pilot 11: bigger feedback + video + socially anxious",8,"high",35
"SUPPRF61705",29,37,33,47,27,80,20,10,"Pilot 11","Pilot 11: bigger feedback + video + socially anxious",8,"high",37
"SUPPRF61705",30,36,41,94,23,73,71,12,"Pilot 11","Pilot 11: bigger feedback + video + socially anxious",8,"high",82
"SUPPRF61705",31,35,39,68,-12,41,80,59,"Pilot 11","Pilot 11: bigger feedback + video + socially anxious",8,"high",9
"SUPPRF61705",32,30,44,88,25,31,63,43,"Pilot 11","Pilot 11: bigger feedback + video + socially anxious",8,"high",45
"SUPPRF61705",33,35,40,80,0,61,80,59,"Pilot 11","Pilot 11: bigger feedback + video + socially anxious",8,"high",21
"SUPPRF61705",34,39,29,19,-1,54,20,11,"Pilot 11","Pilot 11: bigger feedback + video + socially anxious",8,"high",8
"SUPPRF61705",35,38,38,58,29,45,29,17,"Pilot 11","Pilot 11: bigger feedback + video + socially anxious",8,"high",41
"SUPPRF61705",36,33,34,56,-15,36,71,45,"Pilot 11","Pilot 11: bigger feedback + video + socially anxious",8,"high",11
"SUPPRF61705",37,40,35,55,-16,26,71,28,"Pilot 11","Pilot 11: bigger feedback + video + socially anxious",8,"high",27
"SUPPRF61705",38,55,29,81,1,22,80,20,"Pilot 11","Pilot 11: bigger feedback + video + socially anxious",8,"high",61
"SUPPRF61705",39,44,38,22,-15,55,37,47,"Pilot 11","Pilot 11: bigger feedback + video + socially anxious",8,"high",-25
"SUPPRF61705",40,31,33,35,15,35,20,28,"Pilot 11","Pilot 11: bigger feedback + video + socially anxious",8,"high",7
"SUPPRF61705",41,39,38,58,12,29,46,37,"Pilot 11","Pilot 11: bigger feedback + video + socially anxious",8,"high",21
"SUPPRF61705",42,31,34,46,0,37,46,31,"Pilot 11","Pilot 11: bigger feedback + video + socially anxious",8,"high",15
"SUPPRF61705",43,36,34,38,-16,46,54,21,"Pilot 11","Pilot 11: bigger feedback + video + socially anxious",8,"high",17
"SUPPRF61705",44,44,40,8,-12,45,20,22,"Pilot 11","Pilot 11: bigger feedback + video + socially anxious",8,"high",-14
"SUPPRF61705",45,35,42,15,-14,41,29,28,"Pilot 11","Pilot 11: bigger feedback + video + socially anxious",8,"high",-13
"SUPPRF61705",46,39,37,54,0,53,54,22,"Pilot 11","Pilot 11: bigger feedback + video + socially anxious",8,"high",32
"SUPPRF61705",47,54,33,83,12,39,71,32,"Pilot 11","Pilot 11: bigger feedback + video + socially anxious",8,"high",51
"SUPPRF61705",48,37,39,50,-13,39,63,18,"Pilot 11","Pilot 11: bigger feedback + video + socially anxious",8,"high",32
"SUPPRF61804",1,41,58,24,-13,39,37,39,"Pilot 9","Pilot 9: bigger feedback + text",3,"low",-15
"SUPPRF61804",2,21,59,20,0,51,20,47,"Pilot 9","Pilot 9: bigger feedback + text",3,"low",-27
"SUPPRF61804",3,54,39,61,24,45,37,29,"Pilot 9","Pilot 9: bigger feedback + text",3,"low",32
"SUPPRF61804",4,74,38,58,12,43,46,38,"Pilot 9","Pilot 9: bigger feedback + text",3,"low",20
"SUPPRF61804",5,80,20,70,-1,47,71,21,"Pilot 9","Pilot 9: bigger feedback + text",3,"low",49
"SUPPRF61804",6,80,35,81,1,69,80,67,"Pilot 9","Pilot 9: bigger feedback + text",3,"low",14
"SUPPRF61804",7,0,67,6,-14,60,20,27,"Pilot 9","Pilot 9: bigger feedback + text",3,"low",-21
"SUPPRF61804",8,83,32,67,-13,65,80,65,"Pilot 9","Pilot 9: bigger feedback + text",3,"low",2
"SUPPRF61804",9,76,30,96,16,73,80,67,"Pilot 9","Pilot 9: bigger feedback + text",3,"low",29
"SUPPRF61804",10,75,20,68,-12,72,80,62,"Pilot 9","Pilot 9: bigger feedback + text",3,"low",6
"SUPPRF61804",11,36,66,41,-13,34,54,69,"Pilot 9","Pilot 9: bigger feedback + text",3,"low",-28
"SUPPRF61804",12,0,49,16,-13,44,29,56,"Pilot 9","Pilot 9: bigger feedback + text",3,"low",-40
"SUPPRF61804",13,67,50,47,27,63,20,24,"Pilot 9","Pilot 9: bigger feedback + text",3,"low",23
"SUPPRF61804",14,0,64,19,-1,45,20,62,"Pilot 9","Pilot 9: bigger feedback + text",3,"low",-43
"SUPPRF61804",15,61,21,63,0,75,63,61,"Pilot 9","Pilot 9: bigger feedback + text",3,"low",2
"SUPPRF61804",16,35,38,15,-14,73,29,24,"Pilot 9","Pilot 9: bigger feedback + text",3,"low",-9
"SUPPRF61804",17,64,13,45,-1,51,46,46,"Pilot 9","Pilot 9: bigger feedback + text",3,"low",-1
"SUPPRF61804",18,79,22,47,-16,57,63,47,"Pilot 9","Pilot 9: bigger feedback + text",3,"low",0
"SUPPRF61804",19,83,18,88,25,67,63,61,"Pilot 9","Pilot 9: bigger feedback + text",3,"low",27
"SUPPRF61804",20,85,13,100,20,65,80,68,"Pilot 9","Pilot 9: bigger feedback + text",3,"low",32
"SUPPRF61804",21,55,39,29,0,68,29,23,"Pilot 9","Pilot 9: bigger feedback + text",3,"low",6
"SUPPRF61804",22,81,38,71,0,53,71,47,"Pilot 9","Pilot 9: bigger feedback + text",3,"low",24
"SUPPRF61804",23,60,10,46,17,37,29,55,"Pilot 9","Pilot 9: bigger feedback + text",3,"low",-9
"SUPPRF61804",24,66,30,66,12,55,54,50,"Pilot 9","Pilot 9: bigger feedback + text",3,"low",16
"SUPPRF61804",25,36,21,49,12,68,37,56,"Pilot 9","Pilot 9: bigger feedback + text",3,"low",-7
"SUPPRF61804",26,30,34,55,1,79,54,63,"Pilot 9","Pilot 9: bigger feedback + text",3,"low",-8
"SUPPRF61804",27,24,45,37,0,44,37,32,"Pilot 9","Pilot 9: bigger feedback + text",3,"low",5
"SUPPRF61804",28,76,29,78,24,51,54,50,"Pilot 9","Pilot 9: bigger feedback + text",3,"low",28
"SUPPRF61804",29,0,34,8,-12,61,20,16,"Pilot 9","Pilot 9: bigger feedback + text",3,"low",-8
"SUPPRF61804",30,72,18,58,29,28,29,54,"Pilot 9","Pilot 9: bigger feedback + text",3,"low",4
"SUPPRF61804",31,86,17,77,14,49,63,46,"Pilot 9","Pilot 9: bigger feedback + text",3,"low",31
"SUPPRF61804",32,47,21,35,15,78,20,9,"Pilot 9","Pilot 9: bigger feedback + text",3,"low",26
"SUPPRF61804",33,68,8,56,-15,11,71,54,"Pilot 9","Pilot 9: bigger feedback + text",3,"low",2
"SUPPRF61804",34,79,4,54,0,62,54,49,"Pilot 9","Pilot 9: bigger feedback + text",3,"low",5
"SUPPRF61804",35,75,35,94,23,49,71,61,"Pilot 9","Pilot 9: bigger feedback + text",3,"low",33
"SUPPRF61804",36,21,76,22,-15,49,37,50,"Pilot 9","Pilot 9: bigger feedback + text",3,"low",-28
"SUPPRF61804",37,61,28,50,-13,15,63,43,"Pilot 9","Pilot 9: bigger feedback + text",3,"low",7
"SUPPRF61804",38,30,46,38,-16,65,54,59,"Pilot 9","Pilot 9: bigger feedback + text",3,"low",-21
"SUPPRF61804",39,33,51,28,-1,66,29,16,"Pilot 9","Pilot 9: bigger feedback + text",3,"low",12
"SUPPRF61804",40,86,18,83,12,42,71,52,"Pilot 9","Pilot 9: bigger feedback + text",3,"low",31
"SUPPRF61804",41,49,18,62,-1,34,63,52,"Pilot 9","Pilot 9: bigger feedback + text",3,"low",10
"SUPPRF61804",42,81,29,80,0,79,80,72,"Pilot 9","Pilot 9: bigger feedback + text",3,"low",8
"SUPPRF61804",43,61,37,46,0,53,46,53,"Pilot 9","Pilot 9: bigger feedback + text",3,"low",-7
"SUPPRF61804",44,71,43,38,1,67,37,62,"Pilot 9","Pilot 9: bigger feedback + text",3,"low",-24
"SUPPRF61804",45,75,26,75,29,59,46,39,"Pilot 9","Pilot 9: bigger feedback + text",3,"low",36
"SUPPRF61804",46,23,77,33,-13,71,46,65,"Pilot 9","Pilot 9: bigger feedback + text",3,"low",-32
"SUPPRF61804",47,50,46,55,-16,62,71,60,"Pilot 9","Pilot 9: bigger feedback + text",3,"low",-5
"SUPPRF61804",48,22,56,34,-12,67,46,46,"Pilot 9","Pilot 9: bigger feedback + text",3,"low",-12
"SUPPRF62013",1,88,4,45,-1,76,46,47,"Pilot 6","Pilot 6: feedback + text",9,"high",-2
"SUPPRF62013",2,86,9,55,1,7,54,85,"Pilot 6","Pilot 6: feedback + text",9,"high",-30
"SUPPRF62013",3,82,16,20,0,89,20,22,"Pilot 6","Pilot 6: feedback + text",9,"high",-2
"SUPPRF62013",4,76,14,58,12,98,46,31,"Pilot 6","Pilot 6: feedback + text",9,"high",27
"SUPPRF62013",5,80,3,19,-1,57,20,20,"Pilot 6","Pilot 6: feedback + text",9,"high",-1
"SUPPRF62013",6,56,18,37,17,97,20,2,"Pilot 6","Pilot 6: feedback + text",9,"high",35
"SUPPRF62013",7,78,12,54,0,45,54,80,"Pilot 6","Pilot 6: feedback + text",9,"high",-26
"SUPPRF62013",8,81,22,6,-14,70,20,35,"Pilot 6","Pilot 6: feedback + text",9,"high",-29
"SUPPRF62013",9,93,10,35,15,67,20,26,"Pilot 6","Pilot 6: feedback + text",9,"high",9
"SUPPRF62013",10,79,3,38,-16,60,54,75,"Pilot 6","Pilot 6: feedback + text",9,"high",-37
"SUPPRF62013",11,85,4,55,-16,40,71,30,"Pilot 6","Pilot 6: feedback + text",9,"high",25
"SUPPRF62013",12,77,15,24,-13,30,37,19,"Pilot 6","Pilot 6: feedback + text",9,"high",5
"SUPPRF62013",13,92,24,81,1,38,80,10,"Pilot 6","Pilot 6: feedback + text",9,"high",71
"SUPPRF62013",14,81,10,46,0,57,46,36,"Pilot 6","Pilot 6: feedback + text",9,"high",10
"SUPPRF62013",15,75,0,68,14,30,54,40,"Pilot 6","Pilot 6: feedback + text",9,"high",28
"SUPPRF62013",16,77,14,97,17,70,80,13,"Pilot 6","Pilot 6: feedback + text",9,"high",84
"SUPPRF62013",17,67,26,8,-12,75,20,25,"Pilot 6","Pilot 6: feedback + text",9,"high",-17
"SUPPRF62013",18,66,17,63,0,40,63,67,"Pilot 6","Pilot 6: feedback + text",9,"high",-4
"SUPPRF62013",19,92,19,56,-15,80,71,40,"Pilot 6","Pilot 6: feedback + text",9,"high",16
"SUPPRF62013",20,78,15,16,-13,55,29,30,"Pilot 6","Pilot 6: feedback + text",9,"high",-14
"SUPPRF62013",21,76,19,28,-1,32,29,15,"Pilot 6","Pilot 6: feedback + text",9,"high",13
"SUPPRF62013",22,80,9,47,-16,63,63,35,"Pilot 6","Pilot 6: feedback + text",9,"high",12
"SUPPRF62013",23,88,1,68,-12,32,80,13,"Pilot 6","Pilot 6: feedback + text",9,"high",55
"SUPPRF62013",24,78,1,51,14,25,37,32,"Pilot 6","Pilot 6: feedback + text",9,"high",19
"SUPPRF62013",25,91,15,48,19,56,29,42,"Pilot 6","Pilot 6: feedback + text",9,"high",6
"SUPPRF62013",26,29,71,77,14,75,63,2,"Pilot 6","Pilot 6: feedback + text",9,"high",75
"SUPPRF62013",27,73,11,41,-13,38,54,70,"Pilot 6","Pilot 6: feedback + text",9,"high",-29
"SUPPRF62013",28,82,2,46,17,64,29,49,"Pilot 6","Pilot 6: feedback + text",9,"high",-3
"SUPPRF62013",29,80,14,50,-13,33,63,10,"Pilot 6","Pilot 6: feedback + text",9,"high",40
"SUPPRF62013",30,83,8,29,0,50,29,36,"Pilot 6","Pilot 6: feedback + text",9,"high",-7
"SUPPRF62013",31,86,0,84,13,21,71,51,"Pilot 6","Pilot 6: feedback + text",9,"high",33
"SUPPRF62013",32,85,10,33,-13,81,46,40,"Pilot 6","Pilot 6: feedback + text",9,"high",-7
"SUPPRF62013",33,73,10,22,-15,38,37,75,"Pilot 6","Pilot 6: feedback + text",9,"high",-53
"SUPPRF62013",34,86,0,70,-1,78,71,22,"Pilot 6","Pilot 6: feedback + text",9,"high",48
"SUPPRF62013",35,93,6,96,16,64,80,35,"Pilot 6","Pilot 6: feedback + text",9,"high",61
"SUPPRF62013",36,68,6,34,-12,78,46,22,"Pilot 6","Pilot 6: feedback + text",9,"high",12
"SUPPRF62013",37,81,5,37,0,86,37,28,"Pilot 6","Pilot 6: feedback + text",9,"high",9
"SUPPRF62013",38,69,7,15,-14,28,29,65,"Pilot 6","Pilot 6: feedback + text",9,"high",-50
"SUPPRF62013",39,70,6,83,12,56,71,74,"Pilot 6","Pilot 6: feedback + text",9,"high",9
"SUPPRF62013",40,74,6,65,19,53,46,40,"Pilot 6","Pilot 6: feedback + text",9,"high",25
"SUPPRF62013",41,73,9,67,-13,87,80,67,"Pilot 6","Pilot 6: feedback + text",9,"high",0
"SUPPRF62013",42,80,2,62,-1,34,63,42,"Pilot 6","Pilot 6: feedback + text",9,"high",20
"SUPPRF62013",43,59,17,66,12,22,54,75,"Pilot 6","Pilot 6: feedback + text",9,"high",-9
"SUPPRF62013",44,73,14,71,0,67,71,85,"Pilot 6","Pilot 6: feedback + text",9,"high",-14
"SUPPRF62013",45,83,3,80,0,24,80,90,"Pilot 6","Pilot 6: feedback + text",9,"high",-10
"SUPPRF62013",46,37,67,49,12,4,37,12,"Pilot 6","Pilot 6: feedback + text",9,"high",37
"SUPPRF62013",47,69,30,38,1,37,37,60,"Pilot 6","Pilot 6: feedback + text",9,"high",-22
"SUPPRF62013",48,76,5,78,15,64,63,44,"Pilot 6","Pilot 6: feedback + text",9,"high",34
"SUPPRF62253",1,62,31,54,0,45,54,55,"Pilot 9","Pilot 9: bigger feedback + text",0,"low",-1
"SUPPRF62253",2,57,34,61,24,60,37,59,"Pilot 9","Pilot 9: bigger feedback + text",0,"low",2
"SUPPRF62253",3,46,54,38,1,54,37,69,"Pilot 9","Pilot 9: bigger feedback + text",0,"low",-31
"SUPPRF62253",4,68,28,66,12,56,54,60,"Pilot 9","Pilot 9: bigger feedback + text",0,"low",6
"SUPPRF62253",5,57,35,19,-1,60,20,48,"Pilot 9","Pilot 9: bigger feedback + text",0,"low",-29
"SUPPRF62253",6,28,56,55,-16,56,71,69,"Pilot 9","Pilot 9: bigger feedback + text",0,"low",-14
"SUPPRF62253",7,65,31,45,-1,28,46,61,"Pilot 9","Pilot 9: bigger feedback + text",0,"low",-16
"SUPPRF62253",8,31,67,47,27,53,20,48,"Pilot 9","Pilot 9: bigger feedback + text",0,"low",-1
"SUPPRF62253",9,67,57,80,0,61,80,63,"Pilot 9","Pilot 9: bigger feedback + text",0,"low",17
"SUPPRF62253",10,55,33,49,12,49,37,60,"Pilot 9","Pilot 9: bigger feedback + text",0,"low",-11
"SUPPRF62253",11,63,64,83,12,52,71,59,"Pilot 9","Pilot 9: bigger feedback + text",0,"low",24
"SUPPRF62253",12,57,36,62,-1,45,63,71,"Pilot 9","Pilot 9: bigger feedback + text",0,"low",-9
"SUPPRF62253",13,62,40,41,-13,54,54,54,"Pilot 9","Pilot 9: bigger feedback + text",0,"low",-13
"SUPPRF62253",14,62,41,81,1,60,80,72,"Pilot 9","Pilot 9: bigger feedback + text",0,"low",9
"SUPPRF62253",15,36,49,16,-13,54,29,65,"Pilot 9","Pilot 9: bigger feedback + text",0,"low",-49
"SUPPRF62253",16,70,19,100,20,52,80,56,"Pilot 9","Pilot 9: bigger feedback + text",0,"low",44
"SUPPRF62253",17,53,55,28,-1,50,29,60,"Pilot 9","Pilot 9: bigger feedback + text",0,"low",-32
"SUPPRF62253",18,58,47,94,23,55,71,65,"Pilot 9","Pilot 9: bigger feedback + text",0,"low",29
"SUPPRF62253",19,49,49,8,-12,51,20,59,"Pilot 9","Pilot 9: bigger feedback + text",0,"low",-51
"SUPPRF62253",20,60,37,68,-12,48,80,59,"Pilot 9","Pilot 9: bigger feedback + text",0,"low",9
"SUPPRF62253",21,52,52,29,0,54,29,59,"Pilot 9","Pilot 9: bigger feedback + text",0,"low",-30
"SUPPRF62253",22,49,49,58,12,49,46,59,"Pilot 9","Pilot 9: bigger feedback + text",0,"low",-1
"SUPPRF62253",23,48,47,20,0,49,20,46,"Pilot 9","Pilot 9: bigger feedback + text",0,"low",-26
"SUPPRF62253",24,45,40,67,-13,57,80,53,"Pilot 9","Pilot 9: bigger feedback + text",0,"low",14
"SUPPRF62253",25,51,48,47,-16,57,63,58,"Pilot 9","Pilot 9: bigger feedback + text",0,"low",-11
"SUPPRF62253",26,48,48,33,-13,52,46,53,"Pilot 9","Pilot 9: bigger feedback + text",0,"low",-20
"SUPPRF62253",27,48,49,6,-14,51,20,60,"Pilot 9","Pilot 9: bigger feedback + text",0,"low",-54
"SUPPRF62253",28,53,50,15,-14,51,29,54,"Pilot 9","Pilot 9: bigger feedback + text",0,"low",-39
"SUPPRF62253",29,48,49,22,-15,49,37,48,"Pilot 9","Pilot 9: bigger feedback + text",0,"low",-26
"SUPPRF62253",30,54,49,58,29,52,29,47,"Pilot 9","Pilot 9: bigger feedback + text",0,"low",11
"SUPPRF62253",31,49,52,38,-16,65,54,64,"Pilot 9","Pilot 9: bigger feedback + text",0,"low",-26
"SUPPRF62253",32,49,48,37,0,48,37,50,"Pilot 9","Pilot 9: bigger feedback + text",0,"low",-13
"SUPPRF62253",33,47,56,63,0,48,63,50,"Pilot 9","Pilot 9: bigger feedback + text",0,"low",13
"SUPPRF62253",34,46,50,77,14,50,63,49,"Pilot 9","Pilot 9: bigger feedback + text",0,"low",28
"SUPPRF62253",35,58,57,78,24,49,54,50,"Pilot 9","Pilot 9: bigger feedback + text",0,"low",28
"SUPPRF62253",36,52,53,75,29,51,46,50,"Pilot 9","Pilot 9: bigger feedback + text",0,"low",25
"SUPPRF62253",37,79,30,96,16,51,80,52,"Pilot 9","Pilot 9: bigger feedback + text",0,"low",44
"SUPPRF62253",38,51,50,24,-13,44,37,47,"Pilot 9","Pilot 9: bigger feedback + text",0,"low",-23
"SUPPRF62253",39,51,48,56,-15,49,71,50,"Pilot 9","Pilot 9: bigger feedback + text",0,"low",6
"SUPPRF62253",40,49,50,34,-12,51,46,51,"Pilot 9","Pilot 9: bigger feedback + text",0,"low",-17
"SUPPRF62253",41,59,58,71,0,52,71,50,"Pilot 9","Pilot 9: bigger feedback + text",0,"low",21
"SUPPRF62253",42,50,55,50,-13,50,63,53,"Pilot 9","Pilot 9: bigger feedback + text",0,"low",-3
"SUPPRF62253",43,50,52,35,15,51,20,51,"Pilot 9","Pilot 9: bigger feedback + text",0,"low",-16
"SUPPRF62253",44,57,53,46,17,57,29,55,"Pilot 9","Pilot 9: bigger feedback + text",0,"low",-9
"SUPPRF62253",45,56,60,55,1,55,54,68,"Pilot 9","Pilot 9: bigger feedback + text",0,"low",-13
"SUPPRF62253",46,53,50,46,0,53,46,52,"Pilot 9","Pilot 9: bigger feedback + text",0,"low",-6
"SUPPRF62253",47,51,60,70,-1,49,71,51,"Pilot 9","Pilot 9: bigger feedback + text",0,"low",19
"SUPPRF62253",48,56,56,88,25,49,63,49,"Pilot 9","Pilot 9: bigger feedback + text",0,"low",39
"SUPPRF62860",1,48,36,66,12,65,54,43,"Pilot 10","Pilot 10: bigger feedback + video",5,"low",23
"SUPPRF62860",2,72,22,100,20,70,80,61,"Pilot 10","Pilot 10: bigger feedback + video",5,"low",39
"SUPPRF62860",3,72,8,96,16,86,80,84,"Pilot 10","Pilot 10: bigger feedback + video",5,"low",12
"SUPPRF62860",4,52,19,63,0,52,63,77,"Pilot 10","Pilot 10: bigger feedback + video",5,"low",-14
"SUPPRF62860",5,77,21,81,1,82,80,81,"Pilot 10","Pilot 10: bigger feedback + video",5,"low",0
"SUPPRF62860",6,74,25,70,-1,55,71,61,"Pilot 10","Pilot 10: bigger feedback + video",5,"low",9
"SUPPRF62860",7,49,20,35,15,49,20,50,"Pilot 10","Pilot 10: bigger feedback + video",5,"low",-15
"SUPPRF62860",8,71,11,78,24,55,54,73,"Pilot 10","Pilot 10: bigger feedback + video",5,"low",5
"SUPPRF62860",9,57,15,8,-12,25,20,67,"Pilot 10","Pilot 10: bigger feedback + video",5,"low",-59
"SUPPRF62860",10,54,40,56,-15,73,71,80,"Pilot 10","Pilot 10: bigger feedback + video",5,"low",-24
"SUPPRF62860",11,55,43,58,29,51,29,53,"Pilot 10","Pilot 10: bigger feedback + video",5,"low",5
"SUPPRF62860",12,52,50,24,-13,51,37,53,"Pilot 10","Pilot 10: bigger feedback + video",5,"low",-29
"SUPPRF62860",13,51,47,46,0,48,46,48,"Pilot 10","Pilot 10: bigger feedback + video",5,"low",-2
"SUPPRF62860",14,50,52,29,0,50,29,50,"Pilot 10","Pilot 10: bigger feedback + video",5,"low",-21
"SUPPRF62860",15,63,52,54,0,54,54,52,"Pilot 10","Pilot 10: bigger feedback + video",5,"low",2
"SUPPRF62860",16,49,50,16,-13,50,29,47,"Pilot 10","Pilot 10: bigger feedback + video",5,"low",-31
"SUPPRF62860",17,50,50,20,0,47,20,49,"Pilot 10","Pilot 10: bigger feedback + video",5,"low",-29
"SUPPRF62860",18,48,49,38,1,50,37,55,"Pilot 10","Pilot 10: bigger feedback + video",5,"low",-17
"SUPPRF62860",19,59,43,61,24,38,37,47,"Pilot 10","Pilot 10: bigger feedback + video",5,"low",14
"SUPPRF62860",20,63,37,47,-16,55,63,51,"Pilot 10","Pilot 10: bigger feedback + video",5,"low",-4
"SUPPRF62860",21,61,38,55,1,59,54,54,"Pilot 10","Pilot 10: bigger feedback + video",5,"low",1
"SUPPRF62860",22,40,57,45,-1,66,46,41,"Pilot 10","Pilot 10: bigger feedback + video",5,"low",4
"SUPPRF62860",23,57,42,49,12,61,37,61,"Pilot 10","Pilot 10: bigger feedback + video",5,"low",-12
"SUPPRF62860",24,61,45,46,17,57,29,54,"Pilot 10","Pilot 10: bigger feedback + video",5,"low",-8
"SUPPRF62860",25,46,39,77,14,43,63,53,"Pilot 10","Pilot 10: bigger feedback + video",5,"low",24
"SUPPRF62860",26,41,56,6,-14,53,20,59,"Pilot 10","Pilot 10: bigger feedback + video",5,"low",-53
"SUPPRF62860",27,37,50,55,-16,42,71,55,"Pilot 10","Pilot 10: bigger feedback + video",5,"low",0
"SUPPRF62860",28,53,44,71,0,54,71,55,"Pilot 10","Pilot 10: bigger feedback + video",5,"low",16
"SUPPRF62860",29,55,40,83,12,42,71,55,"Pilot 10","Pilot 10: bigger feedback + video",5,"low",28
"SUPPRF62860",30,38,35,37,0,54,37,52,"Pilot 10","Pilot 10: bigger feedback + video",5,"low",-15
"SUPPRF62860",31,55,48,28,-1,46,29,54,"Pilot 10","Pilot 10: bigger feedback + video",5,"low",-26
"SUPPRF62860",32,45,44,19,-1,74,20,27,"Pilot 10","Pilot 10: bigger feedback + video",5,"low",-8
"SUPPRF62860",33,61,34,94,23,57,71,66,"Pilot 10","Pilot 10: bigger feedback + video",5,"low",28
"SUPPRF62860",34,55,42,38,-16,56,54,56,"Pilot 10","Pilot 10: bigger feedback + video",5,"low",-18
"SUPPRF62860",35,56,41,75,29,35,46,54,"Pilot 10","Pilot 10: bigger feedback + video",5,"low",21
"SUPPRF62860",36,56,47,68,-12,45,80,45,"Pilot 10","Pilot 10: bigger feedback + video",5,"low",23
"SUPPRF62860",37,34,43,47,27,84,20,19,"Pilot 10","Pilot 10: bigger feedback + video",5,"low",28
"SUPPRF62860",38,48,44,22,-15,49,37,51,"Pilot 10","Pilot 10: bigger feedback + video",5,"low",-29
"SUPPRF62860",39,53,52,50,-13,60,63,58,"Pilot 10","Pilot 10: bigger feedback + video",5,"low",-8
"SUPPRF62860",40,47,55,58,12,44,46,57,"Pilot 10","Pilot 10: bigger feedback + video",5,"low",1
"SUPPRF62860",41,50,43,62,-1,55,63,61,"Pilot 10","Pilot 10: bigger feedback + video",5,"low",1
"SUPPRF62860",42,41,37,34,-12,45,46,56,"Pilot 10","Pilot 10: bigger feedback + video",5,"low",-22
"SUPPRF62860",43,42,59,67,-13,64,80,56,"Pilot 10","Pilot 10: bigger feedback + video",5,"low",11
"SUPPRF62860",44,30,41,15,-14,62,29,33,"Pilot 10","Pilot 10: bigger feedback + video",5,"low",-18
"SUPPRF62860",45,52,42,80,0,53,80,56,"Pilot 10","Pilot 10: bigger feedback + video",5,"low",24
"SUPPRF62860",46,36,33,33,-13,58,46,45,"Pilot 10","Pilot 10: bigger feedback + video",5,"low",-12
"SUPPRF62860",47,38,35,88,25,42,63,52,"Pilot 10","Pilot 10: bigger feedback + video",5,"low",36
"SUPPRF62860",48,55,38,41,-13,40,54,37,"Pilot 10","Pilot 10: bigger feedback + video",5,"low",4
"SUPPRF63935",1,88,3,29,0,74,29,30,"Pilot 7","Pilot 7: bigger feedback + text",4,"low",-1
"SUPPRF63935",2,92,2,46,17,91,29,23,"Pilot 7","Pilot 7: bigger feedback + text",4,"low",23
"SUPPRF63935",3,87,1,48,19,70,29,27,"Pilot 7","Pilot 7: bigger feedback + text",4,"low",21
"SUPPRF63935",4,90,2,66,12,85,54,55,"Pilot 7","Pilot 7: bigger feedback + text",4,"low",11
"SUPPRF63935",5,90,2,77,14,89,63,72,"Pilot 7","Pilot 7: bigger feedback + text",4,"low",5
"SUPPRF63935",6,87,1,38,-16,83,54,56,"Pilot 7","Pilot 7: bigger feedback + text",4,"low",-18
"SUPPRF63935",7,91,1,37,0,64,37,24,"Pilot 7","Pilot 7: bigger feedback + text",4,"low",13
"SUPPRF63935",8,79,1,16,-13,78,29,25,"Pilot 7","Pilot 7: bigger feedback + text",4,"low",-9
"SUPPRF63935",9,83,2,37,17,63,20,19,"Pilot 7","Pilot 7: bigger feedback + text",4,"low",18
"SUPPRF63935",10,88,1,55,1,76,54,55,"Pilot 7","Pilot 7: bigger feedback + text",4,"low",0
"SUPPRF63935",11,89,15,71,0,87,71,70,"Pilot 7","Pilot 7: bigger feedback + text",4,"low",1
"SUPPRF63935",12,89,1,38,1,43,37,31,"Pilot 7","Pilot 7: bigger feedback + text",4,"low",7
"SUPPRF63935",13,84,1,46,0,31,46,48,"Pilot 7","Pilot 7: bigger feedback + text",4,"low",-2
"SUPPRF63935",14,91,1,58,12,80,46,44,"Pilot 7","Pilot 7: bigger feedback + text",4,"low",14
"SUPPRF63935",15,82,5,15,-14,73,29,33,"Pilot 7","Pilot 7: bigger feedback + text",4,"low",-18
"SUPPRF63935",16,77,3,50,-13,90,63,65,"Pilot 7","Pilot 7: bigger feedback + text",4,"low",-15
"SUPPRF63935",17,92,2,70,-1,90,71,72,"Pilot 7","Pilot 7: bigger feedback + text",4,"low",-2
"SUPPRF63935",18,96,11,65,19,22,46,50,"Pilot 7","Pilot 7: bigger feedback + text",4,"low",15
"SUPPRF63935",19,76,7,55,-16,86,71,70,"Pilot 7","Pilot 7: bigger feedback + text",4,"low",-15
"SUPPRF63935",20,93,3,34,-12,83,46,45,"Pilot 7","Pilot 7: bigger feedback + text",4,"low",-11
"SUPPRF63935",21,93,1,84,13,58,71,79,"Pilot 7","Pilot 7: bigger feedback + text",4,"low",5
"SUPPRF63935",22,96,2,97,17,27,80,58,"Pilot 7","Pilot 7: bigger feedback + text",4,"low",39
"SUPPRF63935",23,95,1,51,14,89,37,37,"Pilot 7","Pilot 7: bigger feedback + text",4,"low",14
"SUPPRF63935",24,94,4,83,12,81,71,74,"Pilot 7","Pilot 7: bigger feedback + text",4,"low",9
"SUPPRF63935",25,94,3,47,-16,85,63,60,"Pilot 7","Pilot 7: bigger feedback + text",4,"low",-13
"SUPPRF63935",26,96,2,68,14,83,54,59,"Pilot 7","Pilot 7: bigger feedback + text",4,"low",9
"SUPPRF63935",27,95,2,81,1,90,80,88,"Pilot 7","Pilot 7: bigger feedback + text",4,"low",-7
"SUPPRF63935",28,96,3,80,0,88,80,90,"Pilot 7","Pilot 7: bigger feedback + text",4,"low",-10
"SUPPRF63935",29,91,1,22,-15,92,37,39,"Pilot 7","Pilot 7: bigger feedback + text",4,"low",-17
"SUPPRF63935",30,92,3,28,-1,53,29,36,"Pilot 7","Pilot 7: bigger feedback + text",4,"low",-8
"SUPPRF63935",31,91,2,78,15,77,63,47,"Pilot 7","Pilot 7: bigger feedback + text",4,"low",31
"SUPPRF63935",32,70,1,6,-14,86,20,28,"Pilot 7","Pilot 7: bigger feedback + text",4,"low",-22
"SUPPRF63935",33,92,2,62,-1,91,63,57,"Pilot 7","Pilot 7: bigger feedback + text",4,"low",5
"SUPPRF63935",34,69,1,8,-12,71,20,22,"Pilot 7","Pilot 7: bigger feedback + text",4,"low",-14
"SUPPRF63935",35,94,3,96,16,94,80,86,"Pilot 7","Pilot 7: bigger feedback + text",4,"low",10
"SUPPRF63935",36,93,2,33,-13,90,46,45,"Pilot 7","Pilot 7: bigger feedback + text",4,"low",-12
"SUPPRF63935",37,65,11,56,-15,14,71,38,"Pilot 7","Pilot 7: bigger feedback + text",4,"low",18
"SUPPRF63935",38,94,5,41,-13,90,54,57,"Pilot 7","Pilot 7: bigger feedback + text",4,"low",-16
"SUPPRF63935",39,90,1,63,0,30,63,63,"Pilot 7","Pilot 7: bigger feedback + text",4,"low",0
"SUPPRF63935",40,97,2,19,-1,92,20,15,"Pilot 7","Pilot 7: bigger feedback + text",4,"low",4
"SUPPRF63935",41,70,2,68,-12,85,80,87,"Pilot 7","Pilot 7: bigger feedback + text",4,"low",-19
"SUPPRF63935",42,59,3,49,12,85,37,38,"Pilot 7","Pilot 7: bigger feedback + text",4,"low",11
"SUPPRF63935",43,63,18,54,0,87,54,65,"Pilot 7","Pilot 7: bigger feedback + text",4,"low",-11
"SUPPRF63935",44,70,30,35,15,87,20,13,"Pilot 7","Pilot 7: bigger feedback + text",4,"low",22
"SUPPRF63935",45,87,7,24,-13,87,37,36,"Pilot 7","Pilot 7: bigger feedback + text",4,"low",-12
"SUPPRF63935",46,64,19,67,-13,97,80,82,"Pilot 7","Pilot 7: bigger feedback + text",4,"low",-15
"SUPPRF63935",47,64,29,20,0,62,20,23,"Pilot 7","Pilot 7: bigger feedback + text",4,"low",-3
"SUPPRF63935",48,67,27,45,-1,83,46,45,"Pilot 7","Pilot 7: bigger feedback + text",4,"low",0
"SUPPRF65333",1,44,55,16,-13,59,29,25,"Pilot 10","Pilot 10: bigger feedback + video",9,"high",-9
"SUPPRF65333",2,50,52,75,29,49,46,27,"Pilot 10","Pilot 10: bigger feedback + video",9,"high",48
"SUPPRF65333",3,50,49,15,-14,55,29,22,"Pilot 10","Pilot 10: bigger feedback + video",9,"high",-7
"SUPPRF65333",4,50,53,80,0,55,80,73,"Pilot 10","Pilot 10: bigger feedback + video",9,"high",7
"SUPPRF65333",5,51,52,37,0,54,37,28,"Pilot 10","Pilot 10: bigger feedback + video",9,"high",9
"SUPPRF65333",6,52,39,81,1,28,80,51,"Pilot 10","Pilot 10: bigger feedback + video",9,"high",30
"SUPPRF65333",7,50,47,33,-13,58,46,29,"Pilot 10","Pilot 10: bigger feedback + video",9,"high",4
"SUPPRF65333",8,47,48,46,0,56,46,45,"Pilot 10","Pilot 10: bigger feedback + video",9,"high",1
"SUPPRF65333",9,50,52,6,-14,56,20,17,"Pilot 10","Pilot 10: bigger feedback + video",9,"high",-11
"SUPPRF65333",10,51,43,54,0,19,54,34,"Pilot 10","Pilot 10: bigger feedback + video",9,"high",20
"SUPPRF65333",11,60,40,96,16,56,80,74,"Pilot 10","Pilot 10: bigger feedback + video",9,"high",22
"SUPPRF65333",12,64,40,20,0,64,20,11,"Pilot 10","Pilot 10: bigger feedback + video",9,"high",9
"SUPPRF65333",13,64,34,50,-13,58,63,56,"Pilot 10","Pilot 10: bigger feedback + video",9,"high",-6
"SUPPRF65333",14,60,36,34,-12,58,46,38,"Pilot 10","Pilot 10: bigger feedback + video",9,"high",-4
"SUPPRF65333",15,58,36,55,1,40,54,41,"Pilot 10","Pilot 10: bigger feedback + video",9,"high",14
"SUPPRF65333",16,56,42,24,-13,57,37,31,"Pilot 10","Pilot 10: bigger feedback + video",9,"high",-7
"SUPPRF65333",17,54,40,49,12,60,37,31,"Pilot 10","Pilot 10: bigger feedback + video",9,"high",18
"SUPPRF65333",18,51,24,47,27,64,20,12,"Pilot 10","Pilot 10: bigger feedback + video",9,"high",35
"SUPPRF65333",19,60,28,28,-1,21,29,39,"Pilot 10","Pilot 10: bigger feedback + video",9,"high",-11
"SUPPRF65333",20,57,29,61,24,36,37,39,"Pilot 10","Pilot 10: bigger feedback + video",9,"high",22
"SUPPRF65333",21,56,34,45,-1,55,46,30,"Pilot 10","Pilot 10: bigger feedback + video",9,"high",15
"SUPPRF65333",22,57,34,66,12,62,54,45,"Pilot 10","Pilot 10: bigger feedback + video",9,"high",21
"SUPPRF65333",23,51,27,67,-13,68,80,76,"Pilot 10","Pilot 10: bigger feedback + video",9,"high",-9
"SUPPRF65333",24,51,33,47,-16,37,63,45,"Pilot 10","Pilot 10: bigger feedback + video",9,"high",2
"SUPPRF65333",25,56,32,55,-16,71,71,61,"Pilot 10","Pilot 10: bigger feedback + video",9,"high",-6
"SUPPRF65333",26,58,37,71,0,69,71,56,"Pilot 10","Pilot 10: bigger feedback + video",9,"high",15
"SUPPRF65333",27,52,41,77,14,55,63,56,"Pilot 10","Pilot 10: bigger feedback + video",9,"high",21
"SUPPRF65333",28,62,28,100,20,75,80,75,"Pilot 10","Pilot 10: bigger feedback + video",9,"high",25
"SUPPRF65333",29,61,40,94,23,71,71,65,"Pilot 10","Pilot 10: bigger feedback + video",9,"high",29
"SUPPRF65333",30,36,35,38,1,56,37,62,"Pilot 10","Pilot 10: bigger feedback + video",9,"high",-24
"SUPPRF65333",31,55,31,62,-1,55,63,52,"Pilot 10","Pilot 10: bigger feedback + video",9,"high",10
"SUPPRF65333",32,37,31,22,-15,65,37,33,"Pilot 10","Pilot 10: bigger feedback + video",9,"high",-11
"SUPPRF65333",33,38,40,56,-15,62,71,59,"Pilot 10","Pilot 10: bigger feedback + video",9,"high",-3
"SUPPRF65333",34,50,27,58,12,48,46,46,"Pilot 10","Pilot 10: bigger feedback + video",9,"high",12
"SUPPRF65333",35,52,43,63,0,64,63,52,"Pilot 10","Pilot 10: bigger feedback + video",9,"high",11
"SUPPRF65333",36,62,30,68,-12,70,80,63,"Pilot 10","Pilot 10: bigger feedback + video",9,"high",5
"SUPPRF65333",37,33,44,41,-13,57,54,52,"Pilot 10","Pilot 10: bigger feedback + video",9,"high",-11
"SUPPRF65333",38,52,28,88,25,65,63,52,"Pilot 10","Pilot 10: bigger feedback + video",9,"high",36
"SUPPRF65333",39,55,35,8,-12,52,20,18,"Pilot 10","Pilot 10: bigger feedback + video",9,"high",-10
"SUPPRF65333",40,55,32,78,24,49,54,53,"Pilot 10","Pilot 10: bigger feedback + video",9,"high",25
"SUPPRF65333",41,52,36,19,-1,73,20,11,"Pilot 10","Pilot 10: bigger feedback + video",9,"high",8
"SUPPRF65333",42,59,26,46,17,58,29,19,"Pilot 10","Pilot 10: bigger feedback + video",9,"high",27
"SUPPRF65333",43,54,34,35,15,64,20,15,"Pilot 10","Pilot 10: bigger feedback + video",9,"high",20
"SUPPRF65333",44,64,38,70,-1,66,71,64,"Pilot 10","Pilot 10: bigger feedback + video",9,"high",6
"SUPPRF65333",45,60,42,58,29,69,29,24,"Pilot 10","Pilot 10: bigger feedback + video",9,"high",34
"SUPPRF65333",46,57,26,38,-16,27,54,44,"Pilot 10","Pilot 10: bigger feedback + video",9,"high",-6
"SUPPRF65333",47,56,25,29,0,58,29,18,"Pilot 10","Pilot 10: bigger feedback + video",9,"high",11
"SUPPRF65333",48,63,39,83,12,36,71,48,"Pilot 10","Pilot 10: bigger feedback + video",9,"high",35
"SUPPRF66080",1,49,20,29,0,100,29,34,"Pilot 9","Pilot 9: bigger feedback + text",6,"high",-5
"SUPPRF66080",2,51,0,80,0,81,80,76,"Pilot 9","Pilot 9: bigger feedback + text",6,"high",4
"SUPPRF66080",3,51,0,68,-12,99,80,86,"Pilot 9","Pilot 9: bigger feedback + text",6,"high",-18
"SUPPRF66080",4,51,0,62,-1,67,63,42,"Pilot 9","Pilot 9: bigger feedback + text",6,"high",20
"SUPPRF66080",5,50,0,63,0,98,63,64,"Pilot 9","Pilot 9: bigger feedback + text",6,"high",-1
"SUPPRF66080",6,50,0,38,1,100,37,34,"Pilot 9","Pilot 9: bigger feedback + text",6,"high",4
"SUPPRF66080",7,51,0,55,1,73,54,33,"Pilot 9","Pilot 9: bigger feedback + text",6,"high",22
"SUPPRF66080",8,51,0,46,17,72,29,21,"Pilot 9","Pilot 9: bigger feedback + text",6,"high",25
"SUPPRF66080",9,50,2,61,24,52,37,0,"Pilot 9","Pilot 9: bigger feedback + text",6,"high",61
"SUPPRF66080",10,51,0,6,-14,86,20,23,"Pilot 9","Pilot 9: bigger feedback + text",6,"high",-17
"SUPPRF66080",11,48,1,54,0,68,54,19,"Pilot 9","Pilot 9: bigger feedback + text",6,"high",35
"SUPPRF66080",12,50,0,78,24,60,54,39,"Pilot 9","Pilot 9: bigger feedback + text",6,"high",39
"SUPPRF66080",13,52,0,33,-13,74,46,32,"Pilot 9","Pilot 9: bigger feedback + text",6,"high",1
"SUPPRF66080",14,51,1,46,0,76,46,30,"Pilot 9","Pilot 9: bigger feedback + text",6,"high",16
"SUPPRF66080",15,51,2,58,12,72,46,43,"Pilot 9","Pilot 9: bigger feedback + text",6,"high",15
"SUPPRF66080",16,51,1,8,-12,64,20,46,"Pilot 9","Pilot 9: bigger feedback + text",6,"high",-38
"SUPPRF66080",17,50,2,24,-13,64,37,33,"Pilot 9","Pilot 9: bigger feedback + text",6,"high",-9
"SUPPRF66080",18,51,0,47,27,70,20,29,"Pilot 9","Pilot 9: bigger feedback + text",6,"high",18
"SUPPRF66344",1,47,0,38,-16,48,54,45,"Pilot 9","Pilot 9: bigger feedback + text",1,"low",-7
"SUPPRF66344",2,48,0,58,12,0,46,23,"Pilot 9","Pilot 9: bigger feedback + text",1,"low",35
"SUPPRF66344",3,47,0,96,16,45,80,59,"Pilot 9","Pilot 9: bigger feedback + text",1,"low",37
"SUPPRF66344",4,48,0,35,15,74,20,17,"Pilot 9","Pilot 9: bigger feedback + text",1,"low",18
"SUPPRF66344",5,49,0,24,-13,0,37,45,"Pilot 9","Pilot 9: bigger feedback + text",1,"low",-21
"SUPPRF66344",6,47,0,15,-14,46,29,34,"Pilot 9","Pilot 9: bigger feedback + text",1,"low",-19
"SUPPRF66344",7,47,0,8,-12,0,20,21,"Pilot 9","Pilot 9: bigger feedback + text",1,"low",-13
"SUPPRF66344",8,47,0,94,23,0,71,55,"Pilot 9","Pilot 9: bigger feedback + text",1,"low",39
"SUPPRF66344",9,48,0,63,0,0,63,56,"Pilot 9","Pilot 9: bigger feedback + text",1,"low",7
"SUPPRF66344",10,48,0,47,-16,2,63,56,"Pilot 9","Pilot 9: bigger feedback + text",1,"low",-9
"SUPPRF66344",11,46,0,62,-1,0,63,52,"Pilot 9","Pilot 9: bigger feedback + text",1,"low",10
"SUPPRF66344",12,47,0,47,27,0,20,19,"Pilot 9","Pilot 9: bigger feedback + text",1,"low",28
"SUPPRF66344",13,48,0,34,-12,0,46,26,"Pilot 9","Pilot 9: bigger feedback + text",1,"low",8
"SUPPRF66344",14,49,0,22,-15,0,37,36,"Pilot 9","Pilot 9: bigger feedback + text",1,"low",-14
"SUPPRF66344",15,49,0,54,0,0,54,42,"Pilot 9","Pilot 9: bigger feedback + text",1,"low",12
"SUPPRF66344",16,47,0,77,14,0,63,38,"Pilot 9","Pilot 9: bigger feedback + text",1,"low",39
"SUPPRF66344",17,48,0,41,-13,50,54,64,"Pilot 9","Pilot 9: bigger feedback + text",1,"low",-23
"SUPPRF66344",18,48,0,68,-12,0,80,65,"Pilot 9","Pilot 9: bigger feedback + text",1,"low",3
"SUPPRF66344",19,49,0,19,-1,0,20,48,"Pilot 9","Pilot 9: bigger feedback + text",1,"low",-29
"SUPPRF66344",20,47,0,28,-1,0,29,26,"Pilot 9","Pilot 9: bigger feedback + text",1,"low",2
"SUPPRF66344",21,47,0,6,-14,0,20,24,"Pilot 9","Pilot 9: bigger feedback + text",1,"low",-18
"SUPPRF66344",22,49,0,45,-1,0,46,32,"Pilot 9","Pilot 9: bigger feedback + text",1,"low",13
"SUPPRF66344",23,46,0,78,24,0,54,37,"Pilot 9","Pilot 9: bigger feedback + text",1,"low",41
"SUPPRF66344",24,46,0,38,1,0,37,29,"Pilot 9","Pilot 9: bigger feedback + text",1,"low",9
"SUPPRF66344",25,47,0,81,1,45,80,54,"Pilot 9","Pilot 9: bigger feedback + text",1,"low",27
"SUPPRF66344",26,47,0,58,29,34,29,49,"Pilot 9","Pilot 9: bigger feedback + text",1,"low",9
"SUPPRF66344",27,50,0,50,-13,47,63,52,"Pilot 9","Pilot 9: bigger feedback + text",1,"low",-2
"SUPPRF66344",28,49,0,33,-13,48,46,49,"Pilot 9","Pilot 9: bigger feedback + text",1,"low",-16
"SUPPRF66344",29,47,0,55,1,0,54,48,"Pilot 9","Pilot 9: bigger feedback + text",1,"low",7
"SUPPRF66344",30,48,0,61,24,5,37,49,"Pilot 9","Pilot 9: bigger feedback + text",1,"low",12
"SUPPRF66344",31,48,0,66,12,6,54,41,"Pilot 9","Pilot 9: bigger feedback + text",1,"low",25
"SUPPRF66344",32,46,0,75,29,49,46,21,"Pilot 9","Pilot 9: bigger feedback + text",1,"low",54
"SUPPRF66344",33,48,0,55,-16,39,71,61,"Pilot 9","Pilot 9: bigger feedback + text",1,"low",-6
"SUPPRF66344",34,49,0,83,12,45,71,52,"Pilot 9","Pilot 9: bigger feedback + text",1,"low",31
"SUPPRF66344",35,50,0,20,0,43,20,27,"Pilot 9","Pilot 9: bigger feedback + text",1,"low",-7
"SUPPRF66344",36,47,0,70,-1,45,71,50,"Pilot 9","Pilot 9: bigger feedback + text",1,"low",20
"SUPPRF66344",37,45,0,29,0,47,29,25,"Pilot 9","Pilot 9: bigger feedback + text",1,"low",4
"SUPPRF66344",38,66,0,100,20,47,80,63,"Pilot 9","Pilot 9: bigger feedback + text",1,"low",37
"SUPPRF66344",39,50,0,67,-13,50,80,56,"Pilot 9","Pilot 9: bigger feedback + text",1,"low",11
"SUPPRF66344",40,49,0,37,0,4,37,46,"Pilot 9","Pilot 9: bigger feedback + text",1,"low",-9
"SUPPRF66344",41,48,0,80,0,48,80,68,"Pilot 9","Pilot 9: bigger feedback + text",1,"low",12
"SUPPRF66344",42,48,0,46,0,49,46,39,"Pilot 9","Pilot 9: bigger feedback + text",1,"low",7
"SUPPRF66344",43,49,0,88,25,7,63,47,"Pilot 9","Pilot 9: bigger feedback + text",1,"low",41
"SUPPRF66344",44,47,0,56,-15,46,71,57,"Pilot 9","Pilot 9: bigger feedback + text",1,"low",-1
"SUPPRF66344",45,50,0,46,17,46,29,23,"Pilot 9","Pilot 9: bigger feedback + text",1,"low",23
"SUPPRF66344",46,49,0,16,-13,46,29,19,"Pilot 9","Pilot 9: bigger feedback + text",1,"low",-3
"SUPPRF66344",47,48,0,49,12,45,37,24,"Pilot 9","Pilot 9: bigger feedback + text",1,"low",25
"SUPPRF66344",48,47,0,71,0,2,71,56,"Pilot 9","Pilot 9: bigger feedback + text",1,"low",15
"SUPPRF67412",1,100,0,55,-16,100,71,75,"Pilot 7","Pilot 7: bigger feedback + text",7,"high",-20
"SUPPRF67412",2,100,0,34,-12,81,46,50,"Pilot 7","Pilot 7: bigger feedback + text",7,"high",-16
"SUPPRF67412",3,100,0,28,-1,100,29,25,"Pilot 7","Pilot 7: bigger feedback + text",7,"high",3
"SUPPRF67412",4,100,0,38,1,86,37,30,"Pilot 7","Pilot 7: bigger feedback + text",7,"high",8
"SUPPRF67412",5,100,0,63,0,75,63,60,"Pilot 7","Pilot 7: bigger feedback + text",7,"high",3
"SUPPRF67412",6,100,0,16,-13,100,29,21,"Pilot 7","Pilot 7: bigger feedback + text",7,"high",-5
"SUPPRF67412",7,100,0,58,12,100,46,35,"Pilot 7","Pilot 7: bigger feedback + text",7,"high",23
"SUPPRF67412",8,100,0,41,-13,100,54,55,"Pilot 7","Pilot 7: bigger feedback + text",7,"high",-14
"SUPPRF67412",9,100,0,22,-15,59,37,44,"Pilot 7","Pilot 7: bigger feedback + text",7,"high",-22
"SUPPRF67412",10,100,0,46,0,66,46,48,"Pilot 7","Pilot 7: bigger feedback + text",7,"high",-2
"SUPPRF67412",11,100,0,70,-1,100,71,70,"Pilot 7","Pilot 7: bigger feedback + text",7,"high",0
"SUPPRF67412",12,98,0,33,-13,55,46,42,"Pilot 7","Pilot 7: bigger feedback + text",7,"high",-9
"SUPPRF67412",13,100,0,6,-14,100,20,10,"Pilot 7","Pilot 7: bigger feedback + text",7,"high",-4
"SUPPRF67412",14,100,0,83,12,100,71,67,"Pilot 7","Pilot 7: bigger feedback + text",7,"high",16
"SUPPRF67412",15,100,0,35,15,100,20,10,"Pilot 7","Pilot 7: bigger feedback + text",7,"high",25
"SUPPRF67412",16,100,0,84,13,100,71,69,"Pilot 7","Pilot 7: bigger feedback + text",7,"high",15
"SUPPRF67412",17,100,0,55,1,100,54,45,"Pilot 7","Pilot 7: bigger feedback + text",7,"high",10
"SUPPRF67412",18,100,0,37,0,100,37,31,"Pilot 7","Pilot 7: bigger feedback + text",7,"high",6
"SUPPRF67412",19,100,0,38,-16,100,54,44,"Pilot 7","Pilot 7: bigger feedback + text",7,"high",-6
"SUPPRF67412",20,100,0,97,17,100,80,80,"Pilot 7","Pilot 7: bigger feedback + text",7,"high",17
"SUPPRF67412",21,100,0,48,19,100,29,21,"Pilot 7","Pilot 7: bigger feedback + text",7,"high",27
"SUPPRF67412",22,100,0,62,-1,95,63,47,"Pilot 7","Pilot 7: bigger feedback + text",7,"high",15
"SUPPRF67412",23,100,1,29,0,59,29,45,"Pilot 7","Pilot 7: bigger feedback + text",7,"high",-16
"SUPPRF67412",24,100,0,37,17,100,20,8,"Pilot 7","Pilot 7: bigger feedback + text",7,"high",29
"SUPPRF67412",25,100,0,45,-1,0,46,100,"Pilot 7","Pilot 7: bigger feedback + text",7,"high",-55
"SUPPRF67412",26,100,0,49,12,100,37,36,"Pilot 7","Pilot 7: bigger feedback + text",7,"high",13
"SUPPRF67412",27,100,0,68,14,100,54,48,"Pilot 7","Pilot 7: bigger feedback + text",7,"high",20
"SUPPRF67412",28,100,0,80,0,100,80,90,"Pilot 7","Pilot 7: bigger feedback + text",7,"high",-10
"SUPPRF67412",29,100,0,20,0,48,20,14,"Pilot 7","Pilot 7: bigger feedback + text",7,"high",6
"SUPPRF67412",30,100,0,50,-13,87,63,42,"Pilot 7","Pilot 7: bigger feedback + text",7,"high",8
"SUPPRF67412",31,100,0,67,-13,100,80,85,"Pilot 7","Pilot 7: bigger feedback + text",7,"high",-18
"SUPPRF67412",32,100,0,68,-12,100,80,63,"Pilot 7","Pilot 7: bigger feedback + text",7,"high",5
"SUPPRF67412",33,100,0,51,14,71,37,43,"Pilot 7","Pilot 7: bigger feedback + text",7,"high",8
"SUPPRF67412",34,100,0,71,0,84,71,58,"Pilot 7","Pilot 7: bigger feedback + text",7,"high",13
"SUPPRF67412",35,100,0,24,-13,100,37,33,"Pilot 7","Pilot 7: bigger feedback + text",7,"high",-9
"SUPPRF67412",36,99,1,78,15,63,63,57,"Pilot 7","Pilot 7: bigger feedback + text",7,"high",21
"SUPPRF67412",37,100,0,77,14,51,63,45,"Pilot 7","Pilot 7: bigger feedback + text",7,"high",32
"SUPPRF67412",38,100,0,81,1,100,80,76,"Pilot 7","Pilot 7: bigger feedback + text",7,"high",5
"SUPPRF67412",39,99,1,66,12,53,54,50,"Pilot 7","Pilot 7: bigger feedback + text",7,"high",16
"SUPPRF67412",40,100,0,56,-15,50,71,54,"Pilot 7","Pilot 7: bigger feedback + text",7,"high",2
"SUPPRF67412",41,98,0,8,-12,54,20,17,"Pilot 7","Pilot 7: bigger feedback + text",7,"high",-9
"SUPPRF67412",42,100,0,65,19,72,46,35,"Pilot 7","Pilot 7: bigger feedback + text",7,"high",30
"SUPPRF67412",43,100,0,54,0,53,54,50,"Pilot 7","Pilot 7: bigger feedback + text",7,"high",4
"SUPPRF67412",44,31,0,15,-14,100,29,49,"Pilot 7","Pilot 7: bigger feedback + text",7,"high",-34
"SUPPRF67412",45,100,0,19,-1,100,20,14,"Pilot 7","Pilot 7: bigger feedback + text",7,"high",5
"SUPPRF67412",46,100,0,47,-16,48,63,100,"Pilot 7","Pilot 7: bigger feedback + text",7,"high",-53
"SUPPRF67412",47,99,0,46,17,51,29,12,"Pilot 7","Pilot 7: bigger feedback + text",7,"high",34
"SUPPRF67412",48,100,0,96,16,100,80,75,"Pilot 7","Pilot 7: bigger feedback + text",7,"high",21
"SUPPRF67813",1,99,0,24,-13,86,37,33,"Pilot 9","Pilot 9: bigger feedback + text",0,"low",-9
"SUPPRF67813",2,99,0,80,0,97,80,83,"Pilot 9","Pilot 9: bigger feedback + text",0,"low",-3
"SUPPRF67813",3,100,0,46,17,100,29,30,"Pilot 9","Pilot 9: bigger feedback + text",0,"low",16
"SUPPRF67813",4,100,0,70,-1,100,71,75,"Pilot 9","Pilot 9: bigger feedback + text",0,"low",-5
"SUPPRF67813",5,100,0,38,-16,100,54,58,"Pilot 9","Pilot 9: bigger feedback + text",0,"low",-20
"SUPPRF67813",6,100,0,29,0,100,29,29,"Pilot 9","Pilot 9: bigger feedback + text",0,"low",0
"SUPPRF67813",7,100,0,61,24,100,37,35,"Pilot 9","Pilot 9: bigger feedback + text",0,"low",26
"SUPPRF67813",8,49,49,19,-1,68,20,23,"Pilot 9","Pilot 9: bigger feedback + text",0,"low",-4
"SUPPRF67813",9,50,49,55,-16,50,71,73,"Pilot 9","Pilot 9: bigger feedback + text",0,"low",-18
"SUPPRF67813",10,48,50,94,23,50,71,71,"Pilot 9","Pilot 9: bigger feedback + text",0,"low",23
"SUPPRF67813",11,50,49,81,1,48,80,81,"Pilot 9","Pilot 9: bigger feedback + text",0,"low",0
"SUPPRF67813",12,50,50,83,12,48,71,73,"Pilot 9","Pilot 9: bigger feedback + text",0,"low",10
"SUPPRF67813",13,49,49,47,27,49,20,27,"Pilot 9","Pilot 9: bigger feedback + text",0,"low",20
"SUPPRF67813",14,49,50,63,0,49,63,52,"Pilot 9","Pilot 9: bigger feedback + text",0,"low",11
"SUPPRF67813",15,50,50,88,25,49,63,50,"Pilot 9","Pilot 9: bigger feedback + text",0,"low",38
"SUPPRF67813",16,50,49,20,0,48,20,50,"Pilot 9","Pilot 9: bigger feedback + text",0,"low",-30
"SUPPRF67813",17,49,48,75,29,50,46,53,"Pilot 9","Pilot 9: bigger feedback + text",0,"low",22
"SUPPRF67813",18,49,49,66,12,48,54,51,"Pilot 9","Pilot 9: bigger feedback + text",0,"low",15
"SUPPRF67813",19,50,50,62,-1,50,63,50,"Pilot 9","Pilot 9: bigger feedback + text",0,"low",12
"SUPPRF67813",20,49,47,45,-1,51,46,50,"Pilot 9","Pilot 9: bigger feedback + text",0,"low",-5
"SUPPRF67813",21,51,50,37,0,50,37,52,"Pilot 9","Pilot 9: bigger feedback + text",0,"low",-15
"SUPPRF67813",22,52,52,68,-12,47,80,50,"Pilot 9","Pilot 9: bigger feedback + text",0,"low",18
"SUPPRF67813",23,49,50,6,-14,51,20,50,"Pilot 9","Pilot 9: bigger feedback + text",0,"low",-44
"SUPPRF67813",24,49,50,38,1,50,37,50,"Pilot 9","Pilot 9: bigger feedback + text",0,"low",-12
"SUPPRF67813",25,49,51,54,0,49,54,50,"Pilot 9","Pilot 9: bigger feedback + text",0,"low",4
"SUPPRF67813",26,52,50,58,12,48,46,49,"Pilot 9","Pilot 9: bigger feedback + text",0,"low",9
"SUPPRF67813",27,48,48,46,0,50,46,50,"Pilot 9","Pilot 9: bigger feedback + text",0,"low",-4
"SUPPRF67813",28,49,51,56,-15,51,71,52,"Pilot 9","Pilot 9: bigger feedback + text",0,"low",4
"SUPPRF67813",29,47,49,22,-15,50,37,50,"Pilot 9","Pilot 9: bigger feedback + text",0,"low",-28
"SUPPRF67813",30,49,49,35,15,49,20,48,"Pilot 9","Pilot 9: bigger feedback + text",0,"low",-13
"SUPPRF67813",31,51,49,96,16,50,80,50,"Pilot 9","Pilot 9: bigger feedback + text",0,"low",46
"SUPPRF67813",32,48,51,34,-12,50,46,45,"Pilot 9","Pilot 9: bigger feedback + text",0,"low",-11
"SUPPRF67813",33,51,50,50,-13,52,63,50,"Pilot 9","Pilot 9: bigger feedback + text",0,"low",0
"SUPPRF67813",34,48,49,8,-12,50,20,49,"Pilot 9","Pilot 9: bigger feedback + text",0,"low",-41
"SUPPRF67813",35,50,49,58,29,49,29,49,"Pilot 9","Pilot 9: bigger feedback + text",0,"low",9
"SUPPRF67813",36,50,49,78,24,51,54,49,"Pilot 9","Pilot 9: bigger feedback + text",0,"low",29
"SUPPRF67813",37,53,54,67,-13,55,80,47,"Pilot 9","Pilot 9: bigger feedback + text",0,"low",20
"SUPPRF67813",38,51,50,47,-16,50,63,53,"Pilot 9","Pilot 9: bigger feedback + text",0,"low",-6
"SUPPRF67813",39,49,50,15,-14,50,29,55,"Pilot 9","Pilot 9: bigger feedback + text",0,"low",-40
"SUPPRF67813",40,51,47,55,1,50,54,51,"Pilot 9","Pilot 9: bigger feedback + text",0,"low",4
"SUPPRF67813",41,49,51,33,-13,51,46,50,"Pilot 9","Pilot 9: bigger feedback + text",0,"low",-17
"SUPPRF67813",42,49,49,100,20,50,80,49,"Pilot 9","Pilot 9: bigger feedback + text",0,"low",51
"SUPPRF67813",43,51,50,16,-13,50,29,51,"Pilot 9","Pilot 9: bigger feedback + text",0,"low",-35
"SUPPRF67813",44,51,50,71,0,50,71,51,"Pilot 9","Pilot 9: bigger feedback + text",0,"low",20
"SUPPRF67813",45,49,48,49,12,49,37,50,"Pilot 9","Pilot 9: bigger feedback + text",0,"low",-1
"SUPPRF67813",46,48,49,28,-1,49,29,50,"Pilot 9","Pilot 9: bigger feedback + text",0,"low",-22
"SUPPRF67813",47,50,50,77,14,50,63,51,"Pilot 9","Pilot 9: bigger feedback + text",0,"low",26
"SUPPRF67813",48,49,50,41,-13,51,54,51,"Pilot 9","Pilot 9: bigger feedback + text",0,"low",-10
"SUPPRF68142",1,50,37,15,-14,39,29,26,"Pilot 9","Pilot 9: bigger feedback + text",0,"low",-11
"SUPPRF68142",2,49,52,75,29,48,46,32,"Pilot 9","Pilot 9: bigger feedback + text",0,"low",43
"SUPPRF68142",3,48,27,56,-15,50,71,57,"Pilot 9","Pilot 9: bigger feedback + text",0,"low",-1
"SUPPRF68142",4,52,50,22,-15,50,37,53,"Pilot 9","Pilot 9: bigger feedback + text",0,"low",-31
"SUPPRF68142",5,48,51,100,20,48,80,42,"Pilot 9","Pilot 9: bigger feedback + text",0,"low",58
"SUPPRF68142",6,47,46,77,14,50,63,52,"Pilot 9","Pilot 9: bigger feedback + text",0,"low",25
"SUPPRF68142",7,50,51,61,24,33,37,28,"Pilot 9","Pilot 9: bigger feedback + text",0,"low",33
"SUPPRF68142",8,42,45,94,23,52,71,63,"Pilot 9","Pilot 9: bigger feedback + text",0,"low",31
"SUPPRF68142",9,51,45,33,-13,45,46,45,"Pilot 9","Pilot 9: bigger feedback + text",0,"low",-12
"SUPPRF68142",10,49,49,83,12,48,71,54,"Pilot 9","Pilot 9: bigger feedback + text",0,"low",29
"SUPPRF68142",11,52,42,62,-1,46,63,58,"Pilot 9","Pilot 9: bigger feedback + text",0,"low",4
"SUPPRF68142",12,44,50,71,0,50,71,47,"Pilot 9","Pilot 9: bigger feedback + text",0,"low",24
"SUPPRF68142",13,50,48,66,12,38,54,55,"Pilot 9","Pilot 9: bigger feedback + text",0,"low",11
"SUPPRF68142",14,46,47,47,27,44,20,23,"Pilot 9","Pilot 9: bigger feedback + text",0,"low",24
"SUPPRF68142",15,49,45,46,17,55,29,23,"Pilot 9","Pilot 9: bigger feedback + text",0,"low",23
"SUPPRF68142",16,48,49,28,-1,43,29,48,"Pilot 9","Pilot 9: bigger feedback + text",0,"low",-20
"SUPPRF68142",17,52,50,38,1,30,37,42,"Pilot 9","Pilot 9: bigger feedback + text",0,"low",-4
"SUPPRF68142",18,49,48,20,0,68,20,27,"Pilot 9","Pilot 9: bigger feedback + text",0,"low",-7
"SUPPRF68142",19,47,50,47,-16,40,63,58,"Pilot 9","Pilot 9: bigger feedback + text",0,"low",-11
"SUPPRF68142",20,49,54,38,-16,50,54,67,"Pilot 9","Pilot 9: bigger feedback + text",0,"low",-29
"SUPPRF68142",21,51,45,78,24,66,54,55,"Pilot 9","Pilot 9: bigger feedback + text",0,"low",23
"SUPPRF68142",22,48,46,67,-13,41,80,65,"Pilot 9","Pilot 9: bigger feedback + text",0,"low",2
"SUPPRF68142",23,48,46,41,-13,48,54,52,"Pilot 9","Pilot 9: bigger feedback + text",0,"low",-11
"SUPPRF68142",24,49,48,58,12,45,46,49,"Pilot 9","Pilot 9: bigger feedback + text",0,"low",9
"SUPPRF68142",25,51,47,70,-1,46,71,52,"Pilot 9","Pilot 9: bigger feedback + text",0,"low",18
"SUPPRF68142",26,53,49,45,-1,48,46,51,"Pilot 9","Pilot 9: bigger feedback + text",0,"low",-6
"SUPPRF68142",27,48,46,16,-13,51,29,46,"Pilot 9","Pilot 9: bigger feedback + text",0,"low",-30
"SUPPRF68142",28,46,51,58,29,71,29,30,"Pilot 9","Pilot 9: bigger feedback + text",0,"low",28
"SUPPRF68142",29,25,22,46,0,50,46,50,"Pilot 9","Pilot 9: bigger feedback + text",0,"low",-4
"SUPPRF68142",30,38,48,68,-12,49,80,53,"Pilot 9","Pilot 9: bigger feedback + text",0,"low",15
"SUPPRF68142",31,50,31,50,-13,0,63,49,"Pilot 9","Pilot 9: bigger feedback + text",0,"low",1
"SUPPRF68142",32,50,48,88,25,49,63,51,"Pilot 9","Pilot 9: bigger feedback + text",0,"low",37
"SUPPRF68142",33,49,50,29,0,47,29,54,"Pilot 9","Pilot 9: bigger feedback + text",0,"low",-25
"SUPPRF68142",34,48,47,55,-16,69,71,72,"Pilot 9","Pilot 9: bigger feedback + text",0,"low",-17
"SUPPRF68142",35,48,43,63,0,45,63,48,"Pilot 9","Pilot 9: bigger feedback + text",0,"low",15
"SUPPRF68142",36,46,47,19,-1,2,20,47,"Pilot 9","Pilot 9: bigger feedback + text",0,"low",-28
"SUPPRF68142",37,42,42,24,-13,4,37,33,"Pilot 9","Pilot 9: bigger feedback + text",0,"low",-9
"SUPPRF68142",38,42,46,54,0,63,54,3,"Pilot 9","Pilot 9: bigger feedback + text",0,"low",51
"SUPPRF68142",39,49,46,81,1,41,80,45,"Pilot 9","Pilot 9: bigger feedback + text",0,"low",36
"SUPPRF68142",40,46,45,49,12,46,37,47,"Pilot 9","Pilot 9: bigger feedback + text",0,"low",2
"SUPPRF68142",41,47,47,34,-12,43,46,43,"Pilot 9","Pilot 9: bigger feedback + text",0,"low",-9
"SUPPRF68142",42,46,48,80,0,24,80,47,"Pilot 9","Pilot 9: bigger feedback + text",0,"low",33
"SUPPRF68142",43,44,46,35,15,14,20,38,"Pilot 9","Pilot 9: bigger feedback + text",0,"low",-3
"SUPPRF68142",44,38,42,6,-14,45,20,43,"Pilot 9","Pilot 9: bigger feedback + text",0,"low",-37
"SUPPRF68142",45,39,48,55,1,59,54,41,"Pilot 9","Pilot 9: bigger feedback + text",0,"low",14
"SUPPRF68142",46,50,45,96,16,54,80,51,"Pilot 9","Pilot 9: bigger feedback + text",0,"low",45
"SUPPRF68142",47,27,45,8,-12,46,20,43,"Pilot 9","Pilot 9: bigger feedback + text",0,"low",-35
"SUPPRF68142",48,46,48,37,0,45,37,43,"Pilot 9","Pilot 9: bigger feedback + text",0,"low",-6
"SUPPRF69479",1,53,35,97,17,73,80,83,"Pilot 6","Pilot 6: feedback + text",10,"high",14
"SUPPRF69479",2,41,41,62,-1,58,63,59,"Pilot 6","Pilot 6: feedback + text",10,"high",3
"SUPPRF69479",3,38,26,48,19,79,29,29,"Pilot 6","Pilot 6: feedback + text",10,"high",19
"SUPPRF69479",4,31,44,70,-1,68,71,62,"Pilot 6","Pilot 6: feedback + text",10,"high",8
"SUPPRF69479",5,27,47,34,-12,31,46,50,"Pilot 6","Pilot 6: feedback + text",10,"high",-16
"SUPPRF69479",6,44,32,81,1,62,80,70,"Pilot 6","Pilot 6: feedback + text",10,"high",11
"SUPPRF69479",7,45,43,38,-16,47,54,45,"Pilot 6","Pilot 6: feedback + text",10,"high",-7
"SUPPRF69479",8,46,49,38,1,18,37,47,"Pilot 6","Pilot 6: feedback + text",10,"high",-9
"SUPPRF69479",9,36,36,56,-15,83,71,82,"Pilot 6","Pilot 6: feedback + text",10,"high",-26
"SUPPRF69479",10,21,26,16,-13,90,29,18,"Pilot 6","Pilot 6: feedback + text",10,"high",-2
"SUPPRF69479",11,44,39,78,15,31,63,23,"Pilot 6","Pilot 6: feedback + text",10,"high",55
"SUPPRF69479",12,41,40,66,12,23,54,33,"Pilot 6","Pilot 6: feedback + text",10,"high",33
"SUPPRF69479",13,44,46,96,16,48,80,66,"Pilot 6","Pilot 6: feedback + text",10,"high",30
"SUPPRF69479",14,43,44,41,-13,35,54,59,"Pilot 6","Pilot 6: feedback + text",10,"high",-18
"SUPPRF69479",15,23,46,51,14,76,37,19,"Pilot 6","Pilot 6: feedback + text",10,"high",32
"SUPPRF69479",16,34,35,55,1,79,54,82,"Pilot 6","Pilot 6: feedback + text",10,"high",-27
"SUPPRF69479",17,41,49,15,-14,37,29,42,"Pilot 6","Pilot 6: feedback + text",10,"high",-27
"SUPPRF69479",18,42,43,80,0,81,80,82,"Pilot 6","Pilot 6: feedback + text",10,"high",-2
"SUPPRF69479",19,36,35,20,0,29,20,51,"Pilot 6","Pilot 6: feedback + text",10,"high",-31
"SUPPRF69479",20,34,37,54,0,61,54,38,"Pilot 6","Pilot 6: feedback + text",10,"high",16
"SUPPRF69479",21,40,37,37,0,11,37,74,"Pilot 6","Pilot 6: feedback + text",10,"high",-37
"SUPPRF69479",22,36,44,58,12,78,46,26,"Pilot 6","Pilot 6: feedback + text",10,"high",32
"SUPPRF69479",23,36,56,6,-14,49,20,50,"Pilot 6","Pilot 6: feedback + text",10,"high",-44
"SUPPRF69479",24,27,53,83,12,0,71,38,"Pilot 6","Pilot 6: feedback + text",10,"high",45
"SUPPRF69479",25,32,64,37,17,20,20,65,"Pilot 6","Pilot 6: feedback + text",10,"high",-28
"SUPPRF69479",26,36,63,22,-15,33,37,35,"Pilot 6","Pilot 6: feedback + text",10,"high",-13
"SUPPRF69479",27,29,60,63,0,62,63,33,"Pilot 6","Pilot 6: feedback + text",10,"high",30
"SUPPRF69479",28,30,54,8,-12,35,20,35,"Pilot 6","Pilot 6: feedback + text",10,"high",-27
"SUPPRF69479",29,28,50,77,14,74,63,68,"Pilot 6","Pilot 6: feedback + text",10,"high",9
"SUPPRF69479",30,49,38,71,0,41,71,74,"Pilot 6","Pilot 6: feedback + text",10,"high",-3
"SUPPRF69479",31,47,30,29,0,6,29,24,"Pilot 6","Pilot 6: feedback + text",10,"high",5
"SUPPRF69479",32,36,55,19,-1,22,20,61,"Pilot 6","Pilot 6: feedback + text",10,"high",-42
"SUPPRF69479",33,30,62,50,-13,64,63,62,"Pilot 6","Pilot 6: feedback + text",10,"high",-12
"SUPPRF69479",34,35,58,46,17,77,29,28,"Pilot 6","Pilot 6: feedback + text",10,"high",18
"SUPPRF69479",35,36,62,33,-13,76,46,76,"Pilot 6","Pilot 6: feedback + text",10,"high",-43
"SUPPRF69479",36,37,52,47,-16,66,63,68,"Pilot 6","Pilot 6: feedback + text",10,"high",-21
"SUPPRF69479",37,34,59,67,-13,19,80,54,"Pilot 6","Pilot 6: feedback + text",10,"high",13
"SUPPRF69479",38,27,58,68,14,0,54,0,"Pilot 6","Pilot 6: feedback + text",10,"high",68
"SUPPRF69479",39,6,28,46,0,55,46,59,"Pilot 6","Pilot 6: feedback + text",10,"high",-13
"SUPPRF69479",40,32,56,49,12,73,37,24,"Pilot 6","Pilot 6: feedback + text",10,"high",25
"SUPPRF69479",41,31,62,84,13,76,71,67,"Pilot 6","Pilot 6: feedback + text",10,"high",17
"SUPPRF69479",42,27,63,28,-1,32,29,43,"Pilot 6","Pilot 6: feedback + text",10,"high",-15
"SUPPRF69479",43,27,58,55,-16,56,71,34,"Pilot 6","Pilot 6: feedback + text",10,"high",21
"SUPPRF69479",44,33,63,24,-13,30,37,33,"Pilot 6","Pilot 6: feedback + text",10,"high",-9
"SUPPRF69479",45,36,58,45,-1,5,46,30,"Pilot 6","Pilot 6: feedback + text",10,"high",15
"SUPPRF69479",46,34,58,65,19,39,46,41,"Pilot 6","Pilot 6: feedback + text",10,"high",24
"SUPPRF69479",47,36,60,68,-12,33,80,73,"Pilot 6","Pilot 6: feedback + text",10,"high",-5
"SUPPRF69479",48,27,64,35,15,58,20,20,"Pilot 6","Pilot 6: feedback + text",10,"high",15
"SUPPRF69688",1,66,22,29,0,54,29,26,"Pilot 8","Pilot 8: max feedback + text",10,"high",3
"SUPPRF69688",2,63,30,47,-16,57,63,63,"Pilot 8","Pilot 8: max feedback + text",10,"high",-16
"SUPPRF69688",3,65,27,46,0,60,46,33,"Pilot 8","Pilot 8: max feedback + text",10,"high",13
"SUPPRF69688",4,56,35,24,-13,59,37,32,"Pilot 8","Pilot 8: max feedback + text",10,"high",-8
"SUPPRF69688",5,55,36,55,-16,61,71,62,"Pilot 8","Pilot 8: max feedback + text",10,"high",-7
"SUPPRF69688",6,56,33,56,-15,42,71,59,"Pilot 8","Pilot 8: max feedback + text",10,"high",-3
"SUPPRF69688",7,53,40,15,-14,46,29,23,"Pilot 8","Pilot 8: max feedback + text",10,"high",-8
"SUPPRF69688",8,67,30,80,0,50,80,68,"Pilot 8","Pilot 8: max feedback + text",10,"high",12
"SUPPRF69688",9,56,40,28,-1,45,29,23,"Pilot 8","Pilot 8: max feedback + text",10,"high",5
"SUPPRF69688",10,63,36,55,1,45,54,40,"Pilot 8","Pilot 8: max feedback + text",10,"high",15
"SUPPRF69688",11,73,26,35,15,49,20,14,"Pilot 8","Pilot 8: max feedback + text",10,"high",21
"SUPPRF69688",12,72,23,100,20,47,80,72,"Pilot 8","Pilot 8: max feedback + text",10,"high",28
"SUPPRF69688",13,52,46,63,0,24,63,58,"Pilot 8","Pilot 8: max feedback + text",10,"high",5
"SUPPRF69688",14,61,28,50,-13,44,63,57,"Pilot 8","Pilot 8: max feedback + text",10,"high",-7
"SUPPRF69688",15,63,23,61,24,51,37,33,"Pilot 8","Pilot 8: max feedback + text",10,"high",28
"SUPPRF69688",16,61,32,38,-16,50,54,45,"Pilot 8","Pilot 8: max feedback + text",10,"high",-7
"SUPPRF69688",17,68,25,70,-1,50,71,64,"Pilot 8","Pilot 8: max feedback + text",10,"high",6
"SUPPRF69688",18,29,65,41,-13,33,54,39,"Pilot 8","Pilot 8: max feedback + text",10,"high",2
"SUPPRF69688",19,60,29,67,-13,37,80,52,"Pilot 8","Pilot 8: max feedback + text",10,"high",15
"SUPPRF69688",20,64,34,71,0,56,71,61,"Pilot 8","Pilot 8: max feedback + text",10,"high",10
"SUPPRF69688",21,60,33,75,29,51,46,47,"Pilot 8","Pilot 8: max feedback + text",10,"high",28
"SUPPRF69688",22,69,27,83,12,40,71,66,"Pilot 8","Pilot 8: max feedback + text",10,"high",17
"SUPPRF69688",23,58,51,58,29,47,29,20,"Pilot 8","Pilot 8: max feedback + text",10,"high",38
"SUPPRF69688",24,50,56,20,0,48,20,16,"Pilot 8","Pilot 8: max feedback + text",10,"high",4
"SUPPRF69688",25,49,53,47,27,52,20,23,"Pilot 8","Pilot 8: max feedback + text",10,"high",24
"SUPPRF69688",26,62,52,49,12,46,37,20,"Pilot 8","Pilot 8: max feedback + text",10,"high",29
"SUPPRF69688",27,45,51,78,24,37,54,39,"Pilot 8","Pilot 8: max feedback + text",10,"high",39
"SUPPRF69688",28,48,45,96,16,51,80,70,"Pilot 8","Pilot 8: max feedback + text",10,"high",26
"SUPPRF69688",29,48,49,54,0,47,54,36,"Pilot 8","Pilot 8: max feedback + text",10,"high",18
"SUPPRF69688",30,45,55,16,-13,38,29,16,"Pilot 8","Pilot 8: max feedback + text",10,"high",0
"SUPPRF69688",31,43,54,6,-14,50,20,20,"Pilot 8","Pilot 8: max feedback + text",10,"high",-14
"SUPPRF69688",32,48,49,81,1,50,80,75,"Pilot 8","Pilot 8: max feedback + text",10,"high",6
"SUPPRF69688",33,49,47,19,-1,44,20,17,"Pilot 8","Pilot 8: max feedback + text",10,"high",2
"SUPPRF69688",34,46,47,33,-13,49,46,42,"Pilot 8","Pilot 8: max feedback + text",10,"high",-9
"SUPPRF69688",35,50,48,58,12,50,46,45,"Pilot 8","Pilot 8: max feedback + text",10,"high",13
"SUPPRF69688",36,49,47,94,23,49,71,64,"Pilot 8","Pilot 8: max feedback + text",10,"high",30
"SUPPRF69688",37,49,48,62,-1,49,63,51,"Pilot 8","Pilot 8: max feedback + text",10,"high",11
"SUPPRF69688",38,48,49,68,-12,46,80,66,"Pilot 8","Pilot 8: max feedback + text",10,"high",2
"SUPPRF69688",39,50,48,66,12,49,54,48,"Pilot 8","Pilot 8: max feedback + text",10,"high",18
"SUPPRF69688",40,48,48,88,25,49,63,63,"Pilot 8","Pilot 8: max feedback + text",10,"high",25
"SUPPRF69688",41,48,48,45,-1,47,46,41,"Pilot 8","Pilot 8: max feedback + text",10,"high",4
"SUPPRF69688",42,50,49,37,0,48,37,31,"Pilot 8","Pilot 8: max feedback + text",10,"high",6
"SUPPRF69688",43,50,49,38,1,29,37,44,"Pilot 8","Pilot 8: max feedback + text",10,"high",-6
"SUPPRF69688",44,48,48,8,-12,47,20,18,"Pilot 8","Pilot 8: max feedback + text",10,"high",-10
"SUPPRF69688",45,48,47,77,14,48,63,43,"Pilot 8","Pilot 8: max feedback + text",10,"high",34
"SUPPRF69688",46,47,49,46,17,48,29,19,"Pilot 8","Pilot 8: max feedback + text",10,"high",27
"SUPPRF69688",47,49,49,34,-12,48,46,45,"Pilot 8","Pilot 8: max feedback + text",10,"high",-11
"SUPPRF69688",48,48,48,22,-15,50,37,37,"Pilot 8","Pilot 8: max feedback + text",10,"high",-15
"SUPPRF69892",1,91,13,38,1,61,37,34,"Pilot 7","Pilot 7: bigger feedback + text",7,"high",4
"SUPPRF69892",2,89,18,15,-14,23,29,24,"Pilot 7","Pilot 7: bigger feedback + text",7,"high",-9
"SUPPRF69892",3,81,10,6,-14,61,20,16,"Pilot 7","Pilot 7: bigger feedback + text",7,"high",-10
"SUPPRF69892",4,85,13,49,12,37,37,30,"Pilot 7","Pilot 7: bigger feedback + text",7,"high",19
"SUPPRF69892",5,78,25,33,-13,28,46,42,"Pilot 7","Pilot 7: bigger feedback + text",7,"high",-9
"SUPPRF69892",6,91,7,97,17,30,80,65,"Pilot 7","Pilot 7: bigger feedback + text",7,"high",32
"SUPPRF69892",7,90,11,65,19,60,46,42,"Pilot 7","Pilot 7: bigger feedback + text",7,"high",23
"SUPPRF69892",8,92,13,37,0,34,37,35,"Pilot 7","Pilot 7: bigger feedback + text",7,"high",2
"SUPPRF69892",9,74,13,68,-12,26,80,83,"Pilot 7","Pilot 7: bigger feedback + text",7,"high",-15
"SUPPRF69892",10,83,23,55,-16,38,71,48,"Pilot 7","Pilot 7: bigger feedback + text",7,"high",7
"SUPPRF69892",11,83,16,56,-15,66,71,78,"Pilot 7","Pilot 7: bigger feedback + text",7,"high",-22
"SUPPRF69892",12,92,24,96,16,30,80,71,"Pilot 7","Pilot 7: bigger feedback + text",7,"high",25
"SUPPRF69892",13,92,5,68,14,33,54,40,"Pilot 7","Pilot 7: bigger feedback + text",7,"high",28
"SUPPRF69892",14,90,13,45,-1,15,46,45,"Pilot 7","Pilot 7: bigger feedback + text",7,"high",0
"SUPPRF69892",15,88,9,55,1,44,54,52,"Pilot 7","Pilot 7: bigger feedback + text",7,"high",3
"SUPPRF69892",16,90,9,77,14,9,63,47,"Pilot 7","Pilot 7: bigger feedback + text",7,"high",30
"SUPPRF69892",17,58,6,80,0,57,80,100,"Pilot 7","Pilot 7: bigger feedback + text",7,"high",-20
"SUPPRF69892",18,92,14,34,-12,31,46,45,"Pilot 7","Pilot 7: bigger feedback + text",7,"high",-11
"SUPPRF69892",19,95,9,83,12,13,71,66,"Pilot 7","Pilot 7: bigger feedback + text",7,"high",17
"SUPPRF69892",20,91,10,84,13,19,71,54,"Pilot 7","Pilot 7: bigger feedback + text",7,"high",30
"SUPPRF69892",21,92,7,48,19,19,29,12,"Pilot 7","Pilot 7: bigger feedback + text",7,"high",36
"SUPPRF69892",22,91,8,16,-13,36,29,20,"Pilot 7","Pilot 7: bigger feedback + text",7,"high",-4
"SUPPRF69892",23,93,6,66,12,43,54,40,"Pilot 7","Pilot 7: bigger feedback + text",7,"high",26
"SUPPRF69892",24,94,5,63,0,23,63,39,"Pilot 7","Pilot 7: bigger feedback + text",7,"high",24
"SUPPRF69892",25,92,9,35,15,23,20,21,"Pilot 7","Pilot 7: bigger feedback + text",7,"high",14
"SUPPRF69892",26,90,12,78,15,10,63,54,"Pilot 7","Pilot 7: bigger feedback + text",7,"high",24
"SUPPRF69892",27,89,8,46,17,36,29,20,"Pilot 7","Pilot 7: bigger feedback + text",7,"high",26
"SUPPRF69892",28,90,11,24,-13,27,37,37,"Pilot 7","Pilot 7: bigger feedback + text",7,"high",-13
"SUPPRF69892",29,96,7,58,12,23,46,33,"Pilot 7","Pilot 7: bigger feedback + text",7,"high",25
"SUPPRF69892",30,92,7,51,14,6,37,37,"Pilot 7","Pilot 7: bigger feedback + text",7,"high",14
"SUPPRF69892",31,93,6,71,0,10,71,74,"Pilot 7","Pilot 7: bigger feedback + text",7,"high",-3
"SUPPRF69892",32,92,6,38,-16,7,54,50,"Pilot 7","Pilot 7: bigger feedback + text",7,"high",-12
"SUPPRF69892",33,93,5,37,17,6,20,16,"Pilot 7","Pilot 7: bigger feedback + text",7,"high",21
"SUPPRF69892",34,75,11,8,-12,23,20,21,"Pilot 7","Pilot 7: bigger feedback + text",7,"high",-13
"SUPPRF69892",35,92,6,41,-13,13,54,57,"Pilot 7","Pilot 7: bigger feedback + text",7,"high",-16
"SUPPRF69892",36,92,8,70,-1,6,71,62,"Pilot 7","Pilot 7: bigger feedback + text",7,"high",8
"SUPPRF69892",37,78,12,22,-15,7,37,29,"Pilot 7","Pilot 7: bigger feedback + text",7,"high",-7
"SUPPRF69892",38,88,12,19,-1,16,20,12,"Pilot 7","Pilot 7: bigger feedback + text",7,"high",7
"SUPPRF69892",39,87,11,81,1,63,80,85,"Pilot 7","Pilot 7: bigger feedback + text",7,"high",-4
"SUPPRF69892",40,68,14,67,-13,73,80,79,"Pilot 7","Pilot 7: bigger feedback + text",7,"high",-12
"SUPPRF69892",41,90,9,29,0,10,29,21,"Pilot 7","Pilot 7: bigger feedback + text",7,"high",8
"SUPPRF69892",42,88,9,20,0,66,20,4,"Pilot 7","Pilot 7: bigger feedback + text",7,"high",16
"SUPPRF69892",43,87,12,46,0,12,46,50,"Pilot 7","Pilot 7: bigger feedback + text",7,"high",-4
"SUPPRF69892",44,87,10,62,-1,54,63,68,"Pilot 7","Pilot 7: bigger feedback + text",7,"high",-6
"SUPPRF69892",45,84,11,50,-13,24,63,63,"Pilot 7","Pilot 7: bigger feedback + text",7,"high",-13
"SUPPRF69892",46,91,6,28,-1,7,29,20,"Pilot 7","Pilot 7: bigger feedback + text",7,"high",8
"SUPPRF69892",47,93,8,47,-16,18,63,54,"Pilot 7","Pilot 7: bigger feedback + text",7,"high",-7
"SUPPRF69892",48,94,6,54,0,40,54,51,"Pilot 7","Pilot 7: bigger feedback + text",7,"high",3
"SUPPRF70595",1,39,45,16,-13,57,29,29,"Pilot 10","Pilot 10: bigger feedback + video",4,"low",-13
"SUPPRF70595",2,51,36,78,24,57,54,60,"Pilot 10","Pilot 10: bigger feedback + video",4,"low",18
"SUPPRF70595",3,52,34,70,-1,65,71,69,"Pilot 10","Pilot 10: bigger feedback + video",4,"low",1
"SUPPRF70595",4,49,46,20,0,81,20,17,"Pilot 10","Pilot 10: bigger feedback + video",4,"low",3
"SUPPRF70595",5,54,48,83,12,66,71,67,"Pilot 10","Pilot 10: bigger feedback + video",4,"low",16
"SUPPRF70595",6,59,35,80,0,41,80,77,"Pilot 10","Pilot 10: bigger feedback + video",4,"low",3
"SUPPRF70595",7,51,40,58,29,68,29,14,"Pilot 10","Pilot 10: bigger feedback + video",4,"low",44
"SUPPRF70595",8,56,36,62,-1,49,63,59,"Pilot 10","Pilot 10: bigger feedback + video",4,"low",3
"SUPPRF70595",9,53,40,67,-13,37,80,58,"Pilot 10","Pilot 10: bigger feedback + video",4,"low",9
"SUPPRF70595",10,39,54,8,-12,75,20,19,"Pilot 10","Pilot 10: bigger feedback + video",4,"low",-11
"SUPPRF70595",11,46,44,33,-13,42,46,62,"Pilot 10","Pilot 10: bigger feedback + video",4,"low",-29
"SUPPRF70595",12,43,51,35,15,69,20,7,"Pilot 10","Pilot 10: bigger feedback + video",4,"low",28
"SUPPRF70595",13,43,57,46,0,45,46,42,"Pilot 10","Pilot 10: bigger feedback + video",4,"low",4
"SUPPRF70595",14,52,54,56,-15,53,71,60,"Pilot 10","Pilot 10: bigger feedback + video",4,"low",-4
"SUPPRF70595",15,47,62,50,-13,36,63,50,"Pilot 10","Pilot 10: bigger feedback + video",4,"low",0
"SUPPRF70595",16,49,53,61,24,65,37,19,"Pilot 10","Pilot 10: bigger feedback + video",4,"low",42
"SUPPRF70595",17,49,64,63,0,50,63,54,"Pilot 10","Pilot 10: bigger feedback + video",4,"low",9
"SUPPRF70595",18,56,38,71,0,76,71,73,"Pilot 10","Pilot 10: bigger feedback + video",4,"low",-2
"SUPPRF70595",19,47,67,54,0,64,54,53,"Pilot 10","Pilot 10: bigger feedback + video",4,"low",1
"SUPPRF70595",20,52,65,68,-12,35,80,69,"Pilot 10","Pilot 10: bigger feedback + video",4,"low",-1
"SUPPRF70595",21,37,71,38,-16,46,54,54,"Pilot 10","Pilot 10: bigger feedback + video",4,"low",-16
"SUPPRF70595",22,45,64,19,-1,76,20,13,"Pilot 10","Pilot 10: bigger feedback + video",4,"low",6
"SUPPRF70595",23,31,56,37,0,31,37,46,"Pilot 10","Pilot 10: bigger feedback + video",4,"low",-9
"SUPPRF70595",24,33,67,66,12,28,54,47,"Pilot 10","Pilot 10: bigger feedback + video",4,"low",19
"SUPPRF70595",25,56,49,77,14,45,63,41,"Pilot 10","Pilot 10: bigger feedback + video",4,"low",36
"SUPPRF70595",26,42,57,15,-14,51,29,24,"Pilot 10","Pilot 10: bigger feedback + video",4,"low",-9
"SUPPRF70595",27,42,64,22,-15,40,37,54,"Pilot 10","Pilot 10: bigger feedback + video",4,"low",-32
"SUPPRF70595",28,49,53,58,12,54,46,42,"Pilot 10","Pilot 10: bigger feedback + video",4,"low",16
"SUPPRF70595",29,58,52,81,1,41,80,39,"Pilot 10","Pilot 10: bigger feedback + video",4,"low",42
"SUPPRF70595",30,57,48,100,20,84,80,71,"Pilot 10","Pilot 10: bigger feedback + video",4,"low",29
"SUPPRF70595",31,51,54,75,29,59,46,51,"Pilot 10","Pilot 10: bigger feedback + video",4,"low",24
"SUPPRF70595",32,51,56,49,12,41,37,56,"Pilot 10","Pilot 10: bigger feedback + video",4,"low",-7
"SUPPRF70595",33,52,54,38,1,45,37,49,"Pilot 10","Pilot 10: bigger feedback + video",4,"low",-11
"SUPPRF70595",34,43,56,46,17,73,29,6,"Pilot 10","Pilot 10: bigger feedback + video",4,"low",40
"SUPPRF70595",35,43,53,41,-13,54,54,51,"Pilot 10","Pilot 10: bigger feedback + video",4,"low",-10
"SUPPRF70595",36,38,60,45,-1,60,46,45,"Pilot 10","Pilot 10: bigger feedback + video",4,"low",0
"SUPPRF70595",37,34,64,88,25,41,63,42,"Pilot 10","Pilot 10: bigger feedback + video",4,"low",46
"SUPPRF70595",38,34,62,6,-14,28,20,44,"Pilot 10","Pilot 10: bigger feedback + video",4,"low",-38
"SUPPRF70595",39,34,57,47,27,81,20,6,"Pilot 10","Pilot 10: bigger feedback + video",4,"low",41
"SUPPRF70595",40,30,56,29,0,34,29,20,"Pilot 10","Pilot 10: bigger feedback + video",4,"low",9
"SUPPRF70595",41,52,55,94,23,34,71,65,"Pilot 10","Pilot 10: bigger feedback + video",4,"low",29
"SUPPRF70595",42,39,71,47,-16,14,63,38,"Pilot 10","Pilot 10: bigger feedback + video",4,"low",9
"SUPPRF70595",43,42,67,34,-12,58,46,46,"Pilot 10","Pilot 10: bigger feedback + video",4,"low",-12
"SUPPRF70595",44,46,63,96,16,55,80,67,"Pilot 10","Pilot 10: bigger feedback + video",4,"low",29
"SUPPRF70595",45,35,64,55,-16,62,71,74,"Pilot 10","Pilot 10: bigger feedback + video",4,"low",-19
"SUPPRF70595",46,42,58,55,1,43,54,54,"Pilot 10","Pilot 10: bigger feedback + video",4,"low",1
"SUPPRF70595",47,29,72,28,-1,43,29,55,"Pilot 10","Pilot 10: bigger feedback + video",4,"low",-27
"SUPPRF70595",48,27,71,24,-13,62,37,43,"Pilot 10","Pilot 10: bigger feedback + video",4,"low",-19
"SUPPRF70813",1,75,27,77,14,50,63,61,"Pilot 9","Pilot 9: bigger feedback + text",11,"high",16
"SUPPRF70813",2,71,31,19,-1,67,20,38,"Pilot 9","Pilot 9: bigger feedback + text",11,"high",-19
"SUPPRF70813",3,61,24,37,0,62,37,37,"Pilot 9","Pilot 9: bigger feedback + text",11,"high",0
"SUPPRF70813",4,70,32,34,-12,58,46,68,"Pilot 9","Pilot 9: bigger feedback + text",11,"high",-34
"SUPPRF70813",5,74,21,71,0,47,71,65,"Pilot 9","Pilot 9: bigger feedback + text",11,"high",6
"SUPPRF70813",6,74,28,20,0,71,20,63,"Pilot 9","Pilot 9: bigger feedback + text",11,"high",-43
"SUPPRF70813",7,81,29,45,-1,69,46,39,"Pilot 9","Pilot 9: bigger feedback + text",11,"high",6
"SUPPRF70813",8,75,19,96,16,65,80,40,"Pilot 9","Pilot 9: bigger feedback + text",11,"high",56
"SUPPRF70813",9,83,22,61,24,31,37,61,"Pilot 9","Pilot 9: bigger feedback + text",11,"high",0
"SUPPRF70813",10,73,29,38,1,83,37,67,"Pilot 9","Pilot 9: bigger feedback + text",11,"high",-29
"SUPPRF70813",11,65,27,15,-14,65,29,28,"Pilot 9","Pilot 9: bigger feedback + text",11,"high",-13
"SUPPRF70813",12,75,27,49,12,69,37,32,"Pilot 9","Pilot 9: bigger feedback + text",11,"high",17
"SUPPRF70813",13,72,26,94,23,69,71,22,"Pilot 9","Pilot 9: bigger feedback + text",11,"high",72
"SUPPRF70813",14,74,21,66,12,74,54,23,"Pilot 9","Pilot 9: bigger feedback + text",11,"high",43
"SUPPRF70813",15,69,27,75,29,72,46,47,"Pilot 9","Pilot 9: bigger feedback + text",11,"high",28
"SUPPRF70813",16,68,26,78,24,52,54,69,"Pilot 9","Pilot 9: bigger feedback + text",11,"high",9
"SUPPRF70813",17,69,27,47,-16,76,63,52,"Pilot 9","Pilot 9: bigger feedback + text",11,"high",-5
"SUPPRF70813",18,69,26,55,1,79,54,66,"Pilot 9","Pilot 9: bigger feedback + text",11,"high",-11
"SUPPRF70813",19,65,33,58,29,65,29,37,"Pilot 9","Pilot 9: bigger feedback + text",11,"high",21
"SUPPRF70813",20,75,22,80,0,63,80,73,"Pilot 9","Pilot 9: bigger feedback + text",11,"high",7
"SUPPRF70813",21,62,25,56,-15,85,71,66,"Pilot 9","Pilot 9: bigger feedback + text",11,"high",-10
"SUPPRF70813",22,77,32,55,-16,26,71,20,"Pilot 9","Pilot 9: bigger feedback + text",11,"high",35
"SUPPRF70813",23,58,25,88,25,75,63,63,"Pilot 9","Pilot 9: bigger feedback + text",11,"high",25
"SUPPRF70813",24,65,31,28,-1,67,29,40,"Pilot 9","Pilot 9: bigger feedback + text",11,"high",-12
"SUPPRF70813",25,68,32,22,-15,33,37,62,"Pilot 9","Pilot 9: bigger feedback + text",11,"high",-40
"SUPPRF70813",26,73,32,38,-16,29,54,49,"Pilot 9","Pilot 9: bigger feedback + text",11,"high",-11
"SUPPRF70813",27,64,33,50,-13,69,63,30,"Pilot 9","Pilot 9: bigger feedback + text",11,"high",20
"SUPPRF70813",28,69,28,83,12,49,71,68,"Pilot 9","Pilot 9: bigger feedback + text",11,"high",15
"SUPPRF70813",29,65,31,16,-13,47,29,65,"Pilot 9","Pilot 9: bigger feedback + text",11,"high",-49
"SUPPRF70813",30,67,25,81,1,30,80,67,"Pilot 9","Pilot 9: bigger feedback + text",11,"high",14
"SUPPRF70813",31,57,33,35,15,68,20,44,"Pilot 9","Pilot 9: bigger feedback + text",11,"high",-9
"SUPPRF70813",32,70,25,100,20,63,80,52,"Pilot 9","Pilot 9: bigger feedback + text",11,"high",48
"SUPPRF70813",33,66,34,29,0,30,29,65,"Pilot 9","Pilot 9: bigger feedback + text",11,"high",-36
"SUPPRF70813",34,65,29,70,-1,61,71,56,"Pilot 9","Pilot 9: bigger feedback + text",11,"high",14
"SUPPRF70813",35,61,26,67,-13,65,80,42,"Pilot 9","Pilot 9: bigger feedback + text",11,"high",25
"SUPPRF70813",36,73,23,58,12,72,46,30,"Pilot 9","Pilot 9: bigger feedback + text",11,"high",28
"SUPPRF70813",37,67,33,8,-12,68,20,19,"Pilot 9","Pilot 9: bigger feedback + text",11,"high",-11
"SUPPRF70813",38,67,26,46,17,69,29,65,"Pilot 9","Pilot 9: bigger feedback + text",11,"high",-19
"SUPPRF70813",39,60,23,68,-12,63,80,31,"Pilot 9","Pilot 9: bigger feedback + text",11,"high",37
"SUPPRF70813",40,67,34,47,27,76,20,65,"Pilot 9","Pilot 9: bigger feedback + text",11,"high",-18
"SUPPRF70813",41,65,27,33,-13,68,46,46,"Pilot 9","Pilot 9: bigger feedback + text",11,"high",-13
"SUPPRF70813",42,72,32,63,0,72,63,39,"Pilot 9","Pilot 9: bigger feedback + text",11,"high",24
"SUPPRF70813",43,72,31,6,-14,65,20,57,"Pilot 9","Pilot 9: bigger feedback + text",11,"high",-51
"SUPPRF70813",44,72,29,41,-13,76,54,58,"Pilot 9","Pilot 9: bigger feedback + text",11,"high",-17
"SUPPRF70813",45,66,25,54,0,72,54,64,"Pilot 9","Pilot 9: bigger feedback + text",11,"high",-10
"SUPPRF70813",46,59,32,24,-13,65,37,60,"Pilot 9","Pilot 9: bigger feedback + text",11,"high",-36
"SUPPRF70813",47,61,34,46,0,67,46,54,"Pilot 9","Pilot 9: bigger feedback + text",11,"high",-8
"SUPPRF70813",48,70,35,62,-1,68,63,57,"Pilot 9","Pilot 9: bigger feedback + text",11,"high",5
"SUPPRF70880",1,45,47,68,-12,2,80,23,"Pilot 10","Pilot 10: bigger feedback + video",12,"high",45
"SUPPRF70880",2,37,43,63,0,38,63,58,"Pilot 10","Pilot 10: bigger feedback + video",12,"high",5
"SUPPRF70880",3,26,71,15,-14,0,29,40,"Pilot 10","Pilot 10: bigger feedback + video",12,"high",-25
"SUPPRF70880",4,46,61,77,14,28,63,46,"Pilot 10","Pilot 10: bigger feedback + video",12,"high",31
"SUPPRF70880",5,65,60,46,17,52,29,41,"Pilot 10","Pilot 10: bigger feedback + video",12,"high",5
"SUPPRF70880",6,53,39,83,12,11,71,36,"Pilot 10","Pilot 10: bigger feedback + video",12,"high",47
"SUPPRF70880",7,59,54,58,29,50,29,43,"Pilot 10","Pilot 10: bigger feedback + video",12,"high",15
"SUPPRF70880",8,63,21,75,29,62,46,33,"Pilot 10","Pilot 10: bigger feedback + video",12,"high",42
"SUPPRF70880",9,62,15,33,-13,59,46,34,"Pilot 10","Pilot 10: bigger feedback + video",12,"high",-1
"SUPPRF70880",10,17,58,16,-13,64,29,40,"Pilot 10","Pilot 10: bigger feedback + video",12,"high",-24
"SUPPRF70880",11,17,64,61,24,70,37,42,"Pilot 10","Pilot 10: bigger feedback + video",12,"high",19
"SUPPRF70880",12,34,44,54,0,51,54,40,"Pilot 10","Pilot 10: bigger feedback + video",12,"high",14
"SUPPRF70880",13,50,47,46,0,67,46,54,"Pilot 10","Pilot 10: bigger feedback + video",12,"high",-8
"SUPPRF70880",14,39,63,88,25,24,63,47,"Pilot 10","Pilot 10: bigger feedback + video",12,"high",41
"SUPPRF70880",15,57,57,81,1,22,80,20,"Pilot 10","Pilot 10: bigger feedback + video",12,"high",61
"SUPPRF70880",16,67,35,37,0,29,37,48,"Pilot 10","Pilot 10: bigger feedback + video",12,"high",-11
"SUPPRF70880",17,45,51,24,-13,0,37,46,"Pilot 10","Pilot 10: bigger feedback + video",12,"high",-22
"SUPPRF70880",18,37,47,29,0,29,29,55,"Pilot 10","Pilot 10: bigger feedback + video",12,"high",-26
"SUPPRF70880",19,50,1,96,16,18,80,47,"Pilot 10","Pilot 10: bigger feedback + video",12,"high",49
"SUPPRF70880",20,74,64,71,0,25,71,42,"Pilot 10","Pilot 10: bigger feedback + video",12,"high",29
"SUPPRF70880",21,35,75,62,-1,66,63,47,"Pilot 10","Pilot 10: bigger feedback + video",12,"high",15
"SUPPRF70880",22,64,50,34,-12,52,46,46,"Pilot 10","Pilot 10: bigger feedback + video",12,"high",-12
"SUPPRF70880",23,98,53,94,23,33,71,60,"Pilot 10","Pilot 10: bigger feedback + video",12,"high",34
"SUPPRF70880",24,44,39,66,12,34,54,58,"Pilot 10","Pilot 10: bigger feedback + video",12,"high",8
"SUPPRF70880",25,46,82,67,-13,0,80,44,"Pilot 10","Pilot 10: bigger feedback + video",12,"high",23
"SUPPRF70880",26,13,84,8,-12,33,20,62,"Pilot 10","Pilot 10: bigger feedback + video",12,"high",-54
"SUPPRF70880",27,68,43,70,-1,60,71,43,"Pilot 10","Pilot 10: bigger feedback + video",12,"high",27
"SUPPRF70880",28,71,27,38,-16,44,54,40,"Pilot 10","Pilot 10: bigger feedback + video",12,"high",-2
"SUPPRF70880",29,30,66,78,24,63,54,52,"Pilot 10","Pilot 10: bigger feedback + video",12,"high",26
"SUPPRF70880",30,49,41,80,0,58,80,61,"Pilot 10","Pilot 10: bigger feedback + video",12,"high",19
"SUPPRF70880",31,40,66,45,-1,65,46,45,"Pilot 10","Pilot 10: bigger feedback + video",12,"high",0
"SUPPRF70880",32,27,56,49,12,75,37,40,"Pilot 10","Pilot 10: bigger feedback + video",12,"high",9
"SUPPRF70880",33,55,37,35,15,26,20,44,"Pilot 10","Pilot 10: bigger feedback + video",12,"high",-9
"SUPPRF70880",34,52,75,50,-13,25,63,41,"Pilot 10","Pilot 10: bigger feedback + video",12,"high",9
"SUPPRF70880",35,82,32,55,1,0,54,42,"Pilot 10","Pilot 10: bigger feedback + video",12,"high",13
"SUPPRF70880",36,24,67,55,-16,27,71,56,"Pilot 10","Pilot 10: bigger feedback + video",12,"high",-1
"SUPPRF70880",37,47,52,22,-15,0,37,43,"Pilot 10","Pilot 10: bigger feedback + video",12,"high",-21
"SUPPRF70880",38,1,49,6,-14,17,20,53,"Pilot 10","Pilot 10: bigger feedback + video",12,"high",-47
"SUPPRF70880",39,64,63,38,1,31,37,47,"Pilot 10","Pilot 10: bigger feedback + video",12,"high",-9
"SUPPRF70880",40,41,57,20,0,90,20,6,"Pilot 10","Pilot 10: bigger feedback + video",12,"high",14
"SUPPRF70880",41,100,7,100,20,67,80,47,"Pilot 10","Pilot 10: bigger feedback + video",12,"high",53
"SUPPRF70880",42,78,43,56,-15,76,71,45,"Pilot 10","Pilot 10: bigger feedback + video",12,"high",11
"SUPPRF70880",43,60,79,47,27,67,20,10,"Pilot 10","Pilot 10: bigger feedback + video",12,"high",37
"SUPPRF70880",44,64,66,41,-13,70,54,36,"Pilot 10","Pilot 10: bigger feedback + video",12,"high",5
"SUPPRF70880",45,79,40,47,-16,65,63,43,"Pilot 10","Pilot 10: bigger feedback + video",12,"high",4
"SUPPRF70880",46,34,88,19,-1,65,20,37,"Pilot 10","Pilot 10: bigger feedback + video",12,"high",-18
"SUPPRF70880",47,69,77,28,-1,15,29,46,"Pilot 10","Pilot 10: bigger feedback + video",12,"high",-18
"SUPPRF70880",48,79,34,58,12,25,46,45,"Pilot 10","Pilot 10: bigger feedback + video",12,"high",13
"SUPPRF71005",1,50,65,55,1,80,54,40,"Pilot 10","Pilot 10: bigger feedback + video",2,"low",15
"SUPPRF71005",2,52,50,38,1,80,37,20,"Pilot 10","Pilot 10: bigger feedback + video",2,"low",18
"SUPPRF71005",3,50,50,35,15,81,20,15,"Pilot 10","Pilot 10: bigger feedback + video",2,"low",20
"SUPPRF71005",4,60,42,29,0,68,29,31,"Pilot 10","Pilot 10: bigger feedback + video",2,"low",-2
"SUPPRF71005",5,53,45,62,-1,70,63,55,"Pilot 10","Pilot 10: bigger feedback + video",2,"low",7
"SUPPRF71005",6,55,42,80,0,73,80,70,"Pilot 10","Pilot 10: bigger feedback + video",2,"low",10
"SUPPRF71005",7,63,37,88,25,75,63,70,"Pilot 10","Pilot 10: bigger feedback + video",2,"low",18
"SUPPRF71005",8,39,48,28,-1,63,29,54,"Pilot 10","Pilot 10: bigger feedback + video",2,"low",-26
"SUPPRF71005",9,57,50,56,-15,54,71,65,"Pilot 10","Pilot 10: bigger feedback + video",2,"low",-9
"SUPPRF71005",10,59,48,77,14,64,63,69,"Pilot 10","Pilot 10: bigger feedback + video",2,"low",8
"SUPPRF71005",11,58,50,46,0,70,46,68,"Pilot 10","Pilot 10: bigger feedback + video",2,"low",-22
"SUPPRF71005",12,56,50,55,-16,44,71,44,"Pilot 10","Pilot 10: bigger feedback + video",2,"low",11
"SUPPRF71005",13,54,44,70,-1,60,71,52,"Pilot 10","Pilot 10: bigger feedback + video",2,"low",18
"SUPPRF71005",14,56,41,47,27,74,20,22,"Pilot 10","Pilot 10: bigger feedback + video",2,"low",25
"SUPPRF71005",15,61,45,34,-12,40,46,50,"Pilot 10","Pilot 10: bigger feedback + video",2,"low",-16
"SUPPRF71005",16,51,50,33,-13,40,46,35,"Pilot 10","Pilot 10: bigger feedback + video",2,"low",-2
"SUPPRF71005",17,50,50,46,17,43,29,36,"Pilot 10","Pilot 10: bigger feedback + video",2,"low",10
"SUPPRF71005",18,34,56,15,-14,35,29,61,"Pilot 10","Pilot 10: bigger feedback + video",2,"low",-46
"SUPPRF71005",19,31,62,6,-14,69,20,20,"Pilot 10","Pilot 10: bigger feedback + video",2,"low",-14
"SUPPRF71005",20,51,49,20,0,58,20,8,"Pilot 10","Pilot 10: bigger feedback + video",2,"low",12
"SUPPRF71005",21,53,51,66,12,33,54,38,"Pilot 10","Pilot 10: bigger feedback + video",2,"low",28
"SUPPRF71005",22,57,58,58,12,61,46,31,"Pilot 10","Pilot 10: bigger feedback + video",2,"low",27
"SUPPRF71005",23,50,51,19,-1,41,20,20,"Pilot 10","Pilot 10: bigger feedback + video",2,"low",-1
"SUPPRF71005",24,53,49,37,0,51,37,30,"Pilot 10","Pilot 10: bigger feedback + video",2,"low",7
"SUPPRF71005",25,25,42,8,-12,67,20,14,"Pilot 10","Pilot 10: bigger feedback + video",2,"low",-6
"SUPPRF71005",26,56,45,58,29,55,29,28,"Pilot 10","Pilot 10: bigger feedback + video",2,"low",30
"SUPPRF71005",27,60,44,96,16,54,80,30,"Pilot 10","Pilot 10: bigger feedback + video",2,"low",66
"SUPPRF71005",28,56,48,16,-13,31,29,5,"Pilot 10","Pilot 10: bigger feedback + video",2,"low",11
"SUPPRF71005",29,39,58,47,-16,55,63,25,"Pilot 10","Pilot 10: bigger feedback + video",2,"low",22
"SUPPRF71005",30,50,40,68,-12,38,80,15,"Pilot 10","Pilot 10: bigger feedback + video",2,"low",53
"SUPPRF71005",31,44,44,38,-16,52,54,33,"Pilot 10","Pilot 10: bigger feedback + video",2,"low",5
"SUPPRF71005",32,78,42,100,20,72,80,76,"Pilot 10","Pilot 10: bigger feedback + video",2,"low",24
"SUPPRF71005",33,56,43,75,29,45,46,33,"Pilot 10","Pilot 10: bigger feedback + video",2,"low",42
"SUPPRF71005",34,61,44,67,-13,76,80,82,"Pilot 10","Pilot 10: bigger feedback + video",2,"low",-15
"SUPPRF71005",35,60,50,50,-13,71,63,64,"Pilot 10","Pilot 10: bigger feedback + video",2,"low",-14
"SUPPRF71005",36,59,45,71,0,46,71,36,"Pilot 10","Pilot 10: bigger feedback + video",2,"low",35
"SUPPRF71005",37,46,55,24,-13,45,37,47,"Pilot 10","Pilot 10: bigger feedback + video",2,"low",-23
"SUPPRF71005",38,52,41,22,-15,34,37,6,"Pilot 10","Pilot 10: bigger feedback + video",2,"low",16
"SUPPRF71005",39,51,52,49,12,65,37,74,"Pilot 10","Pilot 10: bigger feedback + video",2,"low",-25
"SUPPRF71005",40,49,57,54,0,53,54,39,"Pilot 10","Pilot 10: bigger feedback + video",2,"low",15
"SUPPRF71005",41,52,50,45,-1,31,46,16,"Pilot 10","Pilot 10: bigger feedback + video",2,"low",29
"SUPPRF71005",42,50,50,61,24,42,37,41,"Pilot 10","Pilot 10: bigger feedback + video",2,"low",20
"SUPPRF71005",43,51,51,78,24,52,54,53,"Pilot 10","Pilot 10: bigger feedback + video",2,"low",25
"SUPPRF71005",44,49,48,94,23,51,71,18,"Pilot 10","Pilot 10: bigger feedback + video",2,"low",76
"SUPPRF71005",45,52,39,83,12,72,71,72,"Pilot 10","Pilot 10: bigger feedback + video",2,"low",11
"SUPPRF71005",46,48,42,63,0,52,63,49,"Pilot 10","Pilot 10: bigger feedback + video",2,"low",14
"SUPPRF71005",47,53,50,41,-13,55,54,71,"Pilot 10","Pilot 10: bigger feedback + video",2,"low",-30
"SUPPRF71005",48,47,33,81,1,67,80,68,"Pilot 10","Pilot 10: bigger feedback + video",2,"low",13
"SUPPRF71413",1,94,5,70,-1,13,71,30,"Pilot 11","Pilot 11: bigger feedback + video + socially anxious",10,"high",40
"SUPPRF71413",2,88,5,80,0,21,80,50,"Pilot 11","Pilot 11: bigger feedback + video + socially anxious",10,"high",30
"SUPPRF71413",3,100,4,75,29,4,46,30,"Pilot 11","Pilot 11: bigger feedback + video + socially anxious",10,"high",45
"SUPPRF71413",4,97,2,77,14,37,63,60,"Pilot 11","Pilot 11: bigger feedback + video + socially anxious",10,"high",17
"SUPPRF71413",5,41,4,45,-1,79,46,26,"Pilot 11","Pilot 11: bigger feedback + video + socially anxious",10,"high",19
"SUPPRF71413",6,83,87,88,25,33,63,50,"Pilot 11","Pilot 11: bigger feedback + video + socially anxious",10,"high",38
"SUPPRF71413",7,18,38,41,-13,54,54,50,"Pilot 11","Pilot 11: bigger feedback + video + socially anxious",10,"high",-9
"SUPPRF71413",8,58,10,66,12,36,54,30,"Pilot 11","Pilot 11: bigger feedback + video + socially anxious",10,"high",36
"SUPPRF71413",9,43,11,68,-12,38,80,30,"Pilot 11","Pilot 11: bigger feedback + video + socially anxious",10,"high",38
"SUPPRF71413",10,87,2,81,1,45,80,52,"Pilot 11","Pilot 11: bigger feedback + video + socially anxious",10,"high",29
"SUPPRF71413",11,1,41,19,-1,39,20,58,"Pilot 11","Pilot 11: bigger feedback + video + socially anxious",10,"high",-39
"SUPPRF71413",12,11,52,34,-12,88,46,27,"Pilot 11","Pilot 11: bigger feedback + video + socially anxious",10,"high",7
"SUPPRF71413",13,3,69,16,-13,70,29,14,"Pilot 11","Pilot 11: bigger feedback + video + socially anxious",10,"high",2
"SUPPRF71413",14,97,0,96,16,27,80,57,"Pilot 11","Pilot 11: bigger feedback + video + socially anxious",10,"high",39
"SUPPRF71413",15,49,3,67,-13,3,80,82,"Pilot 11","Pilot 11: bigger feedback + video + socially anxious",10,"high",-15
"SUPPRF71413",16,46,17,54,0,5,54,49,"Pilot 11","Pilot 11: bigger feedback + video + socially anxious",10,"high",5
"SUPPRF71413",17,38,7,56,-15,37,71,43,"Pilot 11","Pilot 11: bigger feedback + video + socially anxious",10,"high",13
"SUPPRF71413",18,52,20,58,12,31,46,5,"Pilot 11","Pilot 11: bigger feedback + video + socially anxious",10,"high",53
"SUPPRF71413",19,6,56,24,-13,26,37,6,"Pilot 11","Pilot 11: bigger feedback + video + socially anxious",10,"high",18
"SUPPRF71413",20,99,1,100,20,30,80,27,"Pilot 11","Pilot 11: bigger feedback + video + socially anxious",10,"high",73
"SUPPRF71413",21,54,6,61,24,21,37,20,"Pilot 11","Pilot 11: bigger feedback + video + socially anxious",10,"high",41
"SUPPRF71413",22,32,30,28,-1,76,29,10,"Pilot 11","Pilot 11: bigger feedback + video + socially anxious",10,"high",18
"SUPPRF71413",23,98,2,94,23,27,71,25,"Pilot 11","Pilot 11: bigger feedback + video + socially anxious",10,"high",69
"SUPPRF71413",24,0,1,8,-12,74,20,30,"Pilot 11","Pilot 11: bigger feedback + video + socially anxious",10,"high",-22
"SUPPRF71413",25,2,54,38,-16,33,54,45,"Pilot 11","Pilot 11: bigger feedback + video + socially anxious",10,"high",-7
"SUPPRF71413",26,37,60,22,-15,37,37,25,"Pilot 11","Pilot 11: bigger feedback + video + socially anxious",10,"high",-3
"SUPPRF71413",27,32,30,47,-16,43,63,42,"Pilot 11","Pilot 11: bigger feedback + video + socially anxious",10,"high",5
"SUPPRF71413",28,23,37,58,29,34,29,33,"Pilot 11","Pilot 11: bigger feedback + video + socially anxious",10,"high",25
"SUPPRF71413",29,79,16,71,0,54,71,43,"Pilot 11","Pilot 11: bigger feedback + video + socially anxious",10,"high",28
"SUPPRF71413",30,86,10,83,12,67,71,74,"Pilot 11","Pilot 11: bigger feedback + video + socially anxious",10,"high",9
"SUPPRF71413",31,37,25,55,1,52,54,55,"Pilot 11","Pilot 11: bigger feedback + video + socially anxious",10,"high",0
"SUPPRF71413",32,37,26,49,12,43,37,49,"Pilot 11","Pilot 11: bigger feedback + video + socially anxious",10,"high",0
"SUPPRF71413",33,3,60,6,-14,41,20,8,"Pilot 11","Pilot 11: bigger feedback + video + socially anxious",10,"high",-2
"SUPPRF71413",34,99,12,78,24,53,54,28,"Pilot 11","Pilot 11: bigger feedback + video + socially anxious",10,"high",50
"SUPPRF71413",35,40,15,55,-16,38,71,36,"Pilot 11","Pilot 11: bigger feedback + video + socially anxious",10,"high",19
"SUPPRF71413",36,25,48,37,0,78,37,4,"Pilot 11","Pilot 11: bigger feedback + video + socially anxious",10,"high",33
"SUPPRF71413",37,26,31,46,17,35,29,22,"Pilot 11","Pilot 11: bigger feedback + video + socially anxious",10,"high",24
"SUPPRF71413",38,53,22,38,1,46,37,27,"Pilot 11","Pilot 11: bigger feedback + video + socially anxious",10,"high",11
"SUPPRF71413",39,40,20,46,0,44,46,42,"Pilot 11","Pilot 11: bigger feedback + video + socially anxious",10,"high",4
"SUPPRF71413",40,2,4,50,-13,50,63,50,"Pilot 11","Pilot 11: bigger feedback + video + socially anxious",10,"high",0
"SUPPRF71413",41,55,43,47,27,87,20,9,"Pilot 11","Pilot 11: bigger feedback + video + socially anxious",10,"high",38
"SUPPRF71413",42,34,35,20,0,67,20,15,"Pilot 11","Pilot 11: bigger feedback + video + socially anxious",10,"high",5
"SUPPRF71413",43,6,94,29,0,44,29,40,"Pilot 11","Pilot 11: bigger feedback + video + socially anxious",10,"high",-11
"SUPPRF71413",44,4,32,15,-14,44,29,11,"Pilot 11","Pilot 11: bigger feedback + video + socially anxious",10,"high",4
"SUPPRF71413",45,33,27,62,-1,74,63,66,"Pilot 11","Pilot 11: bigger feedback + video + socially anxious",10,"high",-4
"SUPPRF71413",46,19,35,35,15,68,20,13,"Pilot 11","Pilot 11: bigger feedback + video + socially anxious",10,"high",22
"SUPPRF71413",47,25,40,33,-13,57,46,35,"Pilot 11","Pilot 11: bigger feedback + video + socially anxious",10,"high",-2
"SUPPRF71413",48,44,46,63,0,56,63,44,"Pilot 11","Pilot 11: bigger feedback + video + socially anxious",10,"high",19
"SUPPRF71510",1,50,0,62,-1,50,63,65,"Pilot 6","Pilot 6: feedback + text",0,"low",-3
"SUPPRF71510",2,49,0,6,-14,70,20,30,"Pilot 6","Pilot 6: feedback + text",0,"low",-24
"SUPPRF71510",3,51,0,66,12,30,54,55,"Pilot 6","Pilot 6: feedback + text",0,"low",11
"SUPPRF71510",4,49,0,45,-1,84,46,45,"Pilot 6","Pilot 6: feedback + text",0,"low",0
"SUPPRF71510",5,50,0,80,0,83,80,70,"Pilot 6","Pilot 6: feedback + text",0,"low",10
"SUPPRF71510",6,50,0,51,14,81,37,55,"Pilot 6","Pilot 6: feedback + text",0,"low",-4
"SUPPRF71510",7,50,0,84,13,96,71,70,"Pilot 6","Pilot 6: feedback + text",0,"low",14
"SUPPRF71510",8,52,0,37,17,92,20,7,"Pilot 6","Pilot 6: feedback + text",0,"low",30
"SUPPRF71510",9,50,0,83,12,96,71,80,"Pilot 6","Pilot 6: feedback + text",0,"low",3
"SUPPRF71510",10,51,0,54,0,91,54,70,"Pilot 6","Pilot 6: feedback + text",0,"low",-16
"SUPPRF71510",11,51,0,68,14,77,54,65,"Pilot 6","Pilot 6: feedback + text",0,"low",3
"SUPPRF71510",12,50,0,46,17,67,29,34,"Pilot 6","Pilot 6: feedback + text",0,"low",12
"SUPPRF71510",13,49,0,8,-12,92,20,16,"Pilot 6","Pilot 6: feedback + text",0,"low",-8
"SUPPRF71510",14,51,0,47,-16,87,63,70,"Pilot 6","Pilot 6: feedback + text",0,"low",-23
"SUPPRF71510",15,49,0,67,-13,14,80,50,"Pilot 6","Pilot 6: feedback + text",0,"low",17
"SUPPRF71510",16,50,0,50,-13,97,63,68,"Pilot 6","Pilot 6: feedback + text",0,"low",-18
"SUPPRF71510",17,50,0,58,12,96,46,43,"Pilot 6","Pilot 6: feedback + text",0,"low",15
"SUPPRF71510",18,51,0,70,-1,94,71,72,"Pilot 6","Pilot 6: feedback + text",0,"low",-2
"SUPPRF71510",19,50,0,97,17,79,80,35,"Pilot 6","Pilot 6: feedback + text",0,"low",62
"SUPPRF71510",20,51,0,34,-12,94,46,43,"Pilot 6","Pilot 6: feedback + text",0,"low",-9
"SUPPRF71510",21,50,0,78,15,92,63,34,"Pilot 6","Pilot 6: feedback + text",0,"low",44
"SUPPRF71510",22,50,0,46,0,85,46,50,"Pilot 6","Pilot 6: feedback + text",0,"low",-4
"SUPPRF71510",23,51,0,65,19,85,46,45,"Pilot 6","Pilot 6: feedback + text",0,"low",20
"SUPPRF71510",24,51,0,63,0,71,63,59,"Pilot 6","Pilot 6: feedback + text",0,"low",4
"SUPPRF71510",25,51,0,22,-15,90,37,40,"Pilot 6","Pilot 6: feedback + text",0,"low",-18
"SUPPRF71510",26,51,0,38,-16,83,54,27,"Pilot 6","Pilot 6: feedback + text",0,"low",11
"SUPPRF71510",27,50,0,38,1,86,37,67,"Pilot 6","Pilot 6: feedback + text",0,"low",-29
"SUPPRF71510",28,51,0,48,19,82,29,39,"Pilot 6","Pilot 6: feedback + text",0,"low",9
"SUPPRF71510",29,50,0,41,-13,75,54,36,"Pilot 6","Pilot 6: feedback + text",0,"low",5
"SUPPRF71510",30,50,0,16,-13,89,29,64,"Pilot 6","Pilot 6: feedback + text",0,"low",-48
"SUPPRF71510",31,52,0,55,-16,93,71,73,"Pilot 6","Pilot 6: feedback + text",0,"low",-18
"SUPPRF71510",32,49,0,37,0,96,37,74,"Pilot 6","Pilot 6: feedback + text",0,"low",-37
"SUPPRF71510",33,51,0,96,16,83,80,33,"Pilot 6","Pilot 6: feedback + text",0,"low",63
"SUPPRF71510",34,51,0,49,12,89,37,38,"Pilot 6","Pilot 6: feedback + text",0,"low",11
"SUPPRF71510",35,51,0,56,-15,81,71,39,"Pilot 6","Pilot 6: feedback + text",0,"low",17
"SUPPRF71510",36,52,0,28,-1,91,29,65,"Pilot 6","Pilot 6: feedback + text",0,"low",-37
"SUPPRF71510",37,51,0,55,1,87,54,38,"Pilot 6","Pilot 6: feedback + text",0,"low",17
"SUPPRF71510",38,50,0,81,1,95,80,67,"Pilot 6","Pilot 6: feedback + text",0,"low",14
"SUPPRF71510",39,51,0,19,-1,88,20,59,"Pilot 6","Pilot 6: feedback + text",0,"low",-40
"SUPPRF71510",40,50,0,29,0,72,29,34,"Pilot 6","Pilot 6: feedback + text",0,"low",-5
"SUPPRF71510",41,49,0,24,-13,90,37,40,"Pilot 6","Pilot 6: feedback + text",0,"low",-16
"SUPPRF71510",42,51,0,33,-13,94,46,71,"Pilot 6","Pilot 6: feedback + text",0,"low",-38
"SUPPRF71510",43,50,0,15,-14,79,29,40,"Pilot 6","Pilot 6: feedback + text",0,"low",-25
"SUPPRF71510",44,50,0,71,0,94,71,68,"Pilot 6","Pilot 6: feedback + text",0,"low",3
"SUPPRF71510",45,51,0,77,14,83,63,42,"Pilot 6","Pilot 6: feedback + text",0,"low",35
"SUPPRF71510",46,50,0,35,15,85,20,53,"Pilot 6","Pilot 6: feedback + text",0,"low",-18
"SUPPRF71510",47,50,0,68,-12,85,80,42,"Pilot 6","Pilot 6: feedback + text",0,"low",26
"SUPPRF71510",48,52,0,20,0,86,20,42,"Pilot 6","Pilot 6: feedback + text",0,"low",-22
"SUPPRF71639",1,49,76,49,12,58,37,56,"Pilot 10","Pilot 10: bigger feedback + video",11,"high",-7
"SUPPRF71639",2,61,70,77,14,65,63,77,"Pilot 10","Pilot 10: bigger feedback + video",11,"high",0
"SUPPRF71639",3,52,78,56,-15,69,71,36,"Pilot 10","Pilot 10: bigger feedback + video",11,"high",20
"SUPPRF71639",4,38,63,58,29,74,29,86,"Pilot 10","Pilot 10: bigger feedback + video",11,"high",-28
"SUPPRF71639",5,79,51,81,1,64,80,89,"Pilot 10","Pilot 10: bigger feedback + video",11,"high",-8
"SUPPRF71639",6,84,46,96,16,74,80,87,"Pilot 10","Pilot 10: bigger feedback + video",11,"high",9
"SUPPRF71639",7,87,43,80,0,77,80,92,"Pilot 10","Pilot 10: bigger feedback + video",11,"high",-12
"SUPPRF71639",8,69,50,24,-13,62,37,67,"Pilot 10","Pilot 10: bigger feedback + video",11,"high",-43
"SUPPRF71639",9,95,22,94,23,91,71,95,"Pilot 10","Pilot 10: bigger feedback + video",11,"high",-1
"SUPPRF71639",10,69,27,50,-13,90,63,85,"Pilot 10","Pilot 10: bigger feedback + video",11,"high",-35
"SUPPRF71639",11,58,22,58,12,79,46,71,"Pilot 10","Pilot 10: bigger feedback + video",11,"high",-13
"SUPPRF71639",12,62,14,62,-1,49,63,94,"Pilot 10","Pilot 10: bigger feedback + video",11,"high",-32
"SUPPRF71639",13,51,24,68,-12,39,80,52,"Pilot 10","Pilot 10: bigger feedback + video",11,"high",16
"SUPPRF71639",14,51,10,35,15,64,20,74,"Pilot 10","Pilot 10: bigger feedback + video",11,"high",-39
"SUPPRF71639",15,73,7,71,0,39,71,74,"Pilot 10","Pilot 10: bigger feedback + video",11,"high",-3
"SUPPRF71639",16,74,15,88,25,54,63,74,"Pilot 10","Pilot 10: bigger feedback + video",11,"high",14
"SUPPRF71639",17,58,21,63,0,80,63,92,"Pilot 10","Pilot 10: bigger feedback + video",11,"high",-29
"SUPPRF71639",18,72,3,78,24,27,54,44,"Pilot 10","Pilot 10: bigger feedback + video",11,"high",34
"SUPPRF71639",19,86,2,16,-13,53,29,70,"Pilot 10","Pilot 10: bigger feedback + video",11,"high",-54
"SUPPRF71639",20,94,7,75,29,50,46,81,"Pilot 10","Pilot 10: bigger feedback + video",11,"high",-6
"SUPPRF71639",21,77,5,29,0,41,29,31,"Pilot 10","Pilot 10: bigger feedback + video",11,"high",-2
"SUPPRF71639",22,60,10,41,-13,51,54,83,"Pilot 10","Pilot 10: bigger feedback + video",11,"high",-42
"SUPPRF71639",23,86,5,100,20,48,80,73,"Pilot 10","Pilot 10: bigger feedback + video",11,"high",27
"SUPPRF71639",24,99,8,6,-14,55,20,95,"Pilot 10","Pilot 10: bigger feedback + video",11,"high",-89
"SUPPRF71639",25,89,13,61,24,13,37,36,"Pilot 10","Pilot 10: bigger feedback + video",11,"high",25
"SUPPRF71639",26,74,6,33,-13,5,46,12,"Pilot 10","Pilot 10: bigger feedback + video",11,"high",21
"SUPPRF71639",27,88,1,8,-12,28,20,75,"Pilot 10","Pilot 10: bigger feedback + video",11,"high",-67
"SUPPRF71639",28,59,8,15,-14,59,29,78,"Pilot 10","Pilot 10: bigger feedback + video",11,"high",-63
"SUPPRF71639",29,52,10,38,-16,17,54,59,"Pilot 10","Pilot 10: bigger feedback + video",11,"high",-21
"SUPPRF71639",30,53,14,67,-13,47,80,79,"Pilot 10","Pilot 10: bigger feedback + video",11,"high",-12
"SUPPRF71639",31,54,9,45,-1,14,46,61,"Pilot 10","Pilot 10: bigger feedback + video",11,"high",-16
"SUPPRF71639",32,50,12,19,-1,40,20,68,"Pilot 10","Pilot 10: bigger feedback + video",11,"high",-49
"SUPPRF71639",33,50,10,34,-12,65,46,76,"Pilot 10","Pilot 10: bigger feedback + video",11,"high",-42
"SUPPRF71639",34,60,11,55,1,69,54,57,"Pilot 10","Pilot 10: bigger feedback + video",11,"high",-2
"SUPPRF71639",35,69,9,38,1,57,37,45,"Pilot 10","Pilot 10: bigger feedback + video",11,"high",-7
"SUPPRF71639",36,50,4,46,0,38,46,54,"Pilot 10","Pilot 10: bigger feedback + video",11,"high",-8
"SUPPRF71639",37,58,7,70,-1,60,71,39,"Pilot 10","Pilot 10: bigger feedback + video",11,"high",31
"SUPPRF71639",38,58,9,22,-15,81,37,37,"Pilot 10","Pilot 10: bigger feedback + video",11,"high",-15
"SUPPRF71639",39,54,6,28,-1,53,29,35,"Pilot 10","Pilot 10: bigger feedback + video",11,"high",-7
"SUPPRF71639",40,56,6,55,-16,63,71,40,"Pilot 10","Pilot 10: bigger feedback + video",11,"high",15
"SUPPRF71639",41,78,7,46,17,54,29,41,"Pilot 10","Pilot 10: bigger feedback + video",11,"high",5
"SUPPRF71639",42,59,4,37,0,67,37,45,"Pilot 10","Pilot 10: bigger feedback + video",11,"high",-8
"SUPPRF71639",43,82,5,54,0,56,54,55,"Pilot 10","Pilot 10: bigger feedback + video",11,"high",-1
"SUPPRF71639",44,55,24,20,0,66,20,48,"Pilot 10","Pilot 10: bigger feedback + video",11,"high",-28
"SUPPRF71639",45,56,14,47,-16,19,63,50,"Pilot 10","Pilot 10: bigger feedback + video",11,"high",-3
"SUPPRF71639",46,53,29,47,27,31,20,57,"Pilot 10","Pilot 10: bigger feedback + video",11,"high",-10
"SUPPRF71639",47,48,15,66,12,40,54,53,"Pilot 10","Pilot 10: bigger feedback + video",11,"high",13
"SUPPRF71639",48,50,22,83,12,39,71,56,"Pilot 10","Pilot 10: bigger feedback + video",11,"high",27
"SUPPRF72685",1,63,14,58,29,54,29,47,"Pilot 8","Pilot 8: max feedback + text",10,"high",11
"SUPPRF72685",2,65,12,47,27,84,20,52,"Pilot 8","Pilot 8: max feedback + text",10,"high",-5
"SUPPRF72685",3,84,7,96,16,26,80,46,"Pilot 8","Pilot 8: max feedback + text",10,"high",50
"SUPPRF72685",4,83,2,46,0,59,46,58,"Pilot 8","Pilot 8: max feedback + text",10,"high",-12
"SUPPRF72685",5,85,5,78,24,11,54,61,"Pilot 8","Pilot 8: max feedback + text",10,"high",17
"SUPPRF72685",6,89,9,54,0,48,54,59,"Pilot 8","Pilot 8: max feedback + text",10,"high",-5
"SUPPRF72685",7,76,1,70,-1,7,71,39,"Pilot 8","Pilot 8: max feedback + text",10,"high",31
"SUPPRF72685",8,57,1,41,-13,28,54,49,"Pilot 8","Pilot 8: max feedback + text",10,"high",-8
"SUPPRF72685",9,51,58,38,1,29,37,53,"Pilot 8","Pilot 8: max feedback + text",10,"high",-15
"SUPPRF72685",10,90,4,16,-13,0,29,50,"Pilot 8","Pilot 8: max feedback + text",10,"high",-34
"SUPPRF72685",11,90,3,38,-16,58,54,21,"Pilot 8","Pilot 8: max feedback + text",10,"high",17
"SUPPRF72685",12,91,1,19,-1,7,20,9,"Pilot 8","Pilot 8: max feedback + text",10,"high",10
"SUPPRF72685",13,93,3,77,14,41,63,59,"Pilot 8","Pilot 8: max feedback + text",10,"high",18
"SUPPRF72685",14,95,3,81,1,51,80,79,"Pilot 8","Pilot 8: max feedback + text",10,"high",2
"SUPPRF72685",15,93,1,49,12,25,37,18,"Pilot 8","Pilot 8: max feedback + text",10,"high",31
"SUPPRF72685",16,83,1,100,20,50,80,58,"Pilot 8","Pilot 8: max feedback + text",10,"high",42
"SUPPRF72685",17,94,3,15,-14,51,29,40,"Pilot 8","Pilot 8: max feedback + text",10,"high",-25
"SUPPRF72685",18,85,2,61,24,28,37,49,"Pilot 8","Pilot 8: max feedback + text",10,"high",12
"SUPPRF72685",19,94,5,66,12,47,54,53,"Pilot 8","Pilot 8: max feedback + text",10,"high",13
"SUPPRF72685",20,92,2,29,0,22,29,24,"Pilot 8","Pilot 8: max feedback + text",10,"high",5
"SUPPRF72685",21,1,2,24,-13,86,37,90,"Pilot 8","Pilot 8: max feedback + text",10,"high",-66
"SUPPRF72685",22,52,3,28,-1,3,29,53,"Pilot 8","Pilot 8: max feedback + text",10,"high",-25
"SUPPRF72685",23,94,1,22,-15,58,37,55,"Pilot 8","Pilot 8: max feedback + text",10,"high",-33
"SUPPRF72685",24,95,2,8,-12,85,20,24,"Pilot 8","Pilot 8: max feedback + text",10,"high",-16
"SUPPRF72685",25,94,1,35,15,9,20,50,"Pilot 8","Pilot 8: max feedback + text",10,"high",-15
"SUPPRF72685",26,77,2,56,-15,29,71,43,"Pilot 8","Pilot 8: max feedback + text",10,"high",13
"SUPPRF72685",27,88,4,45,-1,25,46,38,"Pilot 8","Pilot 8: max feedback + text",10,"high",7
"SUPPRF72685",28,91,3,6,-14,78,20,15,"Pilot 8","Pilot 8: max feedback + text",10,"high",-9
"SUPPRF72685",29,49,3,62,-1,54,63,58,"Pilot 8","Pilot 8: max feedback + text",10,"high",4
"SUPPRF72685",30,93,4,47,-16,37,63,49,"Pilot 8","Pilot 8: max feedback + text",10,"high",-2
"SUPPRF72685",31,82,7,50,-13,51,63,60,"Pilot 8","Pilot 8: max feedback + text",10,"high",-10
"SUPPRF72685",32,86,6,71,0,27,71,50,"Pilot 8","Pilot 8: max feedback + text",10,"high",21
"SUPPRF72685",33,45,13,55,-16,69,71,74,"Pilot 8","Pilot 8: max feedback + text",10,"high",-19
"SUPPRF72685",34,10,9,88,25,62,63,42,"Pilot 8","Pilot 8: max feedback + text",10,"high",46
"SUPPRF72685",35,55,20,34,-12,35,46,62,"Pilot 8","Pilot 8: max feedback + text",10,"high",-28
"SUPPRF72685",36,62,20,33,-13,37,46,54,"Pilot 8","Pilot 8: max feedback + text",10,"high",-21
"SUPPRF72685",37,53,52,67,-13,48,80,72,"Pilot 8","Pilot 8: max feedback + text",10,"high",-5
"SUPPRF72685",38,60,42,37,0,44,37,74,"Pilot 8","Pilot 8: max feedback + text",10,"high",-37
"SUPPRF72685",39,47,52,20,0,23,20,71,"Pilot 8","Pilot 8: max feedback + text",10,"high",-51
"SUPPRF72685",40,49,49,94,23,41,71,63,"Pilot 8","Pilot 8: max feedback + text",10,"high",31
"SUPPRF72685",41,45,57,63,0,44,63,70,"Pilot 8","Pilot 8: max feedback + text",10,"high",-7
"SUPPRF72685",42,50,57,46,17,59,29,20,"Pilot 8","Pilot 8: max feedback + text",10,"high",26
"SUPPRF72685",43,55,51,58,12,36,46,65,"Pilot 8","Pilot 8: max feedback + text",10,"high",-7
"SUPPRF72685",44,56,49,68,-12,40,80,49,"Pilot 8","Pilot 8: max feedback + text",10,"high",19
"SUPPRF72685",45,55,36,75,29,41,46,55,"Pilot 8","Pilot 8: max feedback + text",10,"high",20
"SUPPRF72685",46,26,36,83,12,47,71,65,"Pilot 8","Pilot 8: max feedback + text",10,"high",18
"SUPPRF72685",47,51,51,55,1,56,54,59,"Pilot 8","Pilot 8: max feedback + text",10,"high",-4
"SUPPRF72685",48,49,45,80,0,54,80,50,"Pilot 8","Pilot 8: max feedback + text",10,"high",30
"SUPPRF73117",1,49,11,62,-1,65,63,35,"Pilot 9","Pilot 9: bigger feedback + text",9,"high",27
"SUPPRF73117",2,55,11,83,12,49,71,70,"Pilot 9","Pilot 9: bigger feedback + text",9,"high",13
"SUPPRF73117",3,60,7,50,-13,56,63,65,"Pilot 9","Pilot 9: bigger feedback + text",9,"high",-15
"SUPPRF73117",4,60,12,61,24,66,37,45,"Pilot 9","Pilot 9: bigger feedback + text",9,"high",16
"SUPPRF73117",5,66,20,46,0,57,46,60,"Pilot 9","Pilot 9: bigger feedback + text",9,"high",-14
"SUPPRF73117",6,74,9,20,0,56,20,20,"Pilot 9","Pilot 9: bigger feedback + text",9,"high",0
"SUPPRF73117",7,70,11,47,-16,51,63,60,"Pilot 9","Pilot 9: bigger feedback + text",9,"high",-13
"SUPPRF73117",8,44,6,47,27,55,20,30,"Pilot 9","Pilot 9: bigger feedback + text",9,"high",17
"SUPPRF73117",9,57,11,96,16,58,80,81,"Pilot 9","Pilot 9: bigger feedback + text",9,"high",15
"SUPPRF73117",10,73,14,81,1,64,80,95,"Pilot 9","Pilot 9: bigger feedback + text",9,"high",-14
"SUPPRF73117",11,48,9,71,0,70,71,80,"Pilot 9","Pilot 9: bigger feedback + text",9,"high",-9
"SUPPRF73117",12,62,15,22,-15,61,37,33,"Pilot 9","Pilot 9: bigger feedback + text",9,"high",-11
"SUPPRF73117",13,43,15,88,25,58,63,38,"Pilot 9","Pilot 9: bigger feedback + text",9,"high",50
"SUPPRF73117",14,50,11,56,-15,69,71,70,"Pilot 9","Pilot 9: bigger feedback + text",9,"high",-14
"SUPPRF73117",15,52,17,45,-1,68,46,75,"Pilot 9","Pilot 9: bigger feedback + text",9,"high",-30
"SUPPRF73117",16,39,14,58,29,64,29,30,"Pilot 9","Pilot 9: bigger feedback + text",9,"high",28
"SUPPRF73117",17,53,13,16,-13,33,29,46,"Pilot 9","Pilot 9: bigger feedback + text",9,"high",-30
"SUPPRF73117",18,54,8,8,-12,37,20,12,"Pilot 9","Pilot 9: bigger feedback + text",9,"high",-4
"SUPPRF73117",19,41,11,55,1,35,54,49,"Pilot 9","Pilot 9: bigger feedback + text",9,"high",6
"SUPPRF73117",20,34,17,78,24,31,54,56,"Pilot 9","Pilot 9: bigger feedback + text",9,"high",22
"SUPPRF73117",21,10,14,100,20,27,80,89,"Pilot 9","Pilot 9: bigger feedback + text",9,"high",11
"SUPPRF73117",22,100,11,80,0,17,80,80,"Pilot 9","Pilot 9: bigger feedback + text",9,"high",0
"SUPPRF73117",23,55,9,75,29,16,46,31,"Pilot 9","Pilot 9: bigger feedback + text",9,"high",44
"SUPPRF73117",24,49,12,37,0,21,37,31,"Pilot 9","Pilot 9: bigger feedback + text",9,"high",6
"SUPPRF73117",25,46,6,15,-14,7,29,46,"Pilot 9","Pilot 9: bigger feedback + text",9,"high",-31
"SUPPRF73117",26,51,9,77,14,8,63,32,"Pilot 9","Pilot 9: bigger feedback + text",9,"high",45
"SUPPRF73117",27,35,9,94,23,9,71,75,"Pilot 9","Pilot 9: bigger feedback + text",9,"high",19
"SUPPRF73117",28,13,8,29,0,8,29,84,"Pilot 9","Pilot 9: bigger feedback + text",9,"high",-55
"SUPPRF73117",29,10,12,33,-13,54,46,23,"Pilot 9","Pilot 9: bigger feedback + text",9,"high",10
"SUPPRF73117",30,11,9,55,-16,33,71,95,"Pilot 9","Pilot 9: bigger feedback + text",9,"high",-40
"SUPPRF73117",31,0,11,54,0,8,54,32,"Pilot 9","Pilot 9: bigger feedback + text",9,"high",22
"SUPPRF73117",32,0,20,19,-1,0,20,44,"Pilot 9","Pilot 9: bigger feedback + text",9,"high",-25
"SUPPRF73117",33,0,27,24,-13,0,37,38,"Pilot 9","Pilot 9: bigger feedback + text",9,"high",-14
"SUPPRF73117",34,0,10,41,-13,0,54,68,"Pilot 9","Pilot 9: bigger feedback + text",9,"high",-27
"SUPPRF73117",35,30,23,68,-12,28,80,63,"Pilot 9","Pilot 9: bigger feedback + text",9,"high",5
"SUPPRF73117",36,0,30,6,-14,0,20,100,"Pilot 9","Pilot 9: bigger feedback + text",9,"high",-94
"SUPPRF73117",37,0,40,38,-16,4,54,36,"Pilot 9","Pilot 9: bigger feedback + text",9,"high",2
"SUPPRF73117",38,0,44,46,17,0,29,14,"Pilot 9","Pilot 9: bigger feedback + text",9,"high",32
"SUPPRF73117",39,0,46,67,-13,0,80,0,"Pilot 9","Pilot 9: bigger feedback + text",9,"high",67
"SUPPRF73117",40,0,53,38,1,0,37,0,"Pilot 9","Pilot 9: bigger feedback + text",9,"high",38
"SUPPRF73117",41,0,49,35,15,0,20,11,"Pilot 9","Pilot 9: bigger feedback + text",9,"high",24
"SUPPRF73117",42,0,82,63,0,0,63,0,"Pilot 9","Pilot 9: bigger feedback + text",9,"high",63
"SUPPRF73117",43,0,100,28,-1,0,29,50,"Pilot 9","Pilot 9: bigger feedback + text",9,"high",-22
"SUPPRF73117",44,0,100,34,-12,14,46,45,"Pilot 9","Pilot 9: bigger feedback + text",9,"high",-11
"SUPPRF73117",45,0,100,70,-1,0,71,70,"Pilot 9","Pilot 9: bigger feedback + text",9,"high",0
"SUPPRF73117",46,0,100,66,12,0,54,2,"Pilot 9","Pilot 9: bigger feedback + text",9,"high",64
"SUPPRF73117",47,0,100,49,12,0,37,51,"Pilot 9","Pilot 9: bigger feedback + text",9,"high",-2
"SUPPRF73117",48,0,100,58,12,0,46,79,"Pilot 9","Pilot 9: bigger feedback + text",9,"high",-21
"SUPPRF73219",1,10,76,78,15,79,63,70,"Pilot 7","Pilot 7: bigger feedback + text",11,"high",8
"SUPPRF73219",2,16,76,97,17,79,80,86,"Pilot 7","Pilot 7: bigger feedback + text",11,"high",11
"SUPPRF73219",3,17,79,37,17,82,20,13,"Pilot 7","Pilot 7: bigger feedback + text",11,"high",24
"SUPPRF73219",4,11,88,37,0,84,37,48,"Pilot 7","Pilot 7: bigger feedback + text",11,"high",-11
"SUPPRF73219",5,14,90,81,1,84,80,79,"Pilot 7","Pilot 7: bigger feedback + text",11,"high",2
"SUPPRF73219",6,15,90,34,-12,78,46,72,"Pilot 7","Pilot 7: bigger feedback + text",11,"high",-38
"SUPPRF73219",7,18,82,29,0,92,29,27,"Pilot 7","Pilot 7: bigger feedback + text",11,"high",2
"SUPPRF73219",8,24,76,54,0,95,54,54,"Pilot 7","Pilot 7: bigger feedback + text",11,"high",0
"SUPPRF73219",9,27,80,51,14,77,37,35,"Pilot 7","Pilot 7: bigger feedback + text",11,"high",16
"SUPPRF73219",10,15,90,38,1,78,37,49,"Pilot 7","Pilot 7: bigger feedback + text",11,"high",-11
"SUPPRF73219",11,23,82,50,-13,62,63,53,"Pilot 7","Pilot 7: bigger feedback + text",11,"high",-3
"SUPPRF73219",12,26,79,55,1,75,54,55,"Pilot 7","Pilot 7: bigger feedback + text",11,"high",0
"SUPPRF73219",13,21,74,65,19,69,46,54,"Pilot 7","Pilot 7: bigger feedback + text",11,"high",11
"SUPPRF73219",14,31,82,84,13,91,71,76,"Pilot 7","Pilot 7: bigger feedback + text",11,"high",8
"SUPPRF73219",15,24,81,46,17,87,29,30,"Pilot 7","Pilot 7: bigger feedback + text",11,"high",16
"SUPPRF73219",16,19,84,35,15,93,20,30,"Pilot 7","Pilot 7: bigger feedback + text",11,"high",5
"SUPPRF73219",17,20,93,8,-12,100,20,8,"Pilot 7","Pilot 7: bigger feedback + text",11,"high",0
"SUPPRF73219",18,17,88,56,-15,100,71,82,"Pilot 7","Pilot 7: bigger feedback + text",11,"high",-26
"SUPPRF73219",19,9,95,24,-13,83,37,46,"Pilot 7","Pilot 7: bigger feedback + text",11,"high",-22
"SUPPRF73219",20,14,86,63,0,59,63,67,"Pilot 7","Pilot 7: bigger feedback + text",11,"high",-4
"SUPPRF73219",21,16,86,20,0,81,20,20,"Pilot 7","Pilot 7: bigger feedback + text",11,"high",0
"SUPPRF73219",22,15,90,16,-13,84,29,15,"Pilot 7","Pilot 7: bigger feedback + text",11,"high",1
"SUPPRF73219",23,20,87,6,-14,41,20,16,"Pilot 7","Pilot 7: bigger feedback + text",11,"high",-10
"SUPPRF73219",24,23,87,83,12,79,71,82,"Pilot 7","Pilot 7: bigger feedback + text",11,"high",1
"SUPPRF73219",25,21,88,46,0,83,46,65,"Pilot 7","Pilot 7: bigger feedback + text",11,"high",-19
"SUPPRF73219",26,21,80,48,19,84,29,30,"Pilot 7","Pilot 7: bigger feedback + text",11,"high",18
"SUPPRF73219",27,14,91,19,-1,78,20,28,"Pilot 7","Pilot 7: bigger feedback + text",11,"high",-9
"SUPPRF73219",28,22,82,68,-12,49,80,67,"Pilot 7","Pilot 7: bigger feedback + text",11,"high",1
"SUPPRF73219",29,18,84,49,12,83,37,38,"Pilot 7","Pilot 7: bigger feedback + text",11,"high",11
"SUPPRF73219",30,29,77,62,-1,74,63,63,"Pilot 7","Pilot 7: bigger feedback + text",11,"high",-1
"SUPPRF73219",31,19,86,66,12,74,54,56,"Pilot 7","Pilot 7: bigger feedback + text",11,"high",10
"SUPPRF73219",32,11,93,33,-13,89,46,52,"Pilot 7","Pilot 7: bigger feedback + text",11,"high",-19
"SUPPRF73219",33,14,88,15,-14,32,29,20,"Pilot 7","Pilot 7: bigger feedback + text",11,"high",-5
"SUPPRF73219",34,20,87,77,14,96,63,72,"Pilot 7","Pilot 7: bigger feedback + text",11,"high",5
"SUPPRF73219",35,13,80,80,0,4,80,52,"Pilot 7","Pilot 7: bigger feedback + text",11,"high",28
"SUPPRF73219",36,6,93,22,-15,30,37,55,"Pilot 7","Pilot 7: bigger feedback + text",11,"high",-33
"SUPPRF73219",37,21,86,45,-1,70,46,51,"Pilot 7","Pilot 7: bigger feedback + text",11,"high",-6
"SUPPRF73219",38,10,84,47,-16,68,63,56,"Pilot 7","Pilot 7: bigger feedback + text",11,"high",-9
"SUPPRF73219",39,11,86,41,-13,69,54,41,"Pilot 7","Pilot 7: bigger feedback + text",11,"high",0
"SUPPRF73219",40,16,79,68,14,82,54,50,"Pilot 7","Pilot 7: bigger feedback + text",11,"high",18
"SUPPRF73219",41,13,79,71,0,86,71,72,"Pilot 7","Pilot 7: bigger feedback + text",11,"high",-1
"SUPPRF73219",42,8,91,38,-16,0,54,52,"Pilot 7","Pilot 7: bigger feedback + text",11,"high",-14
"SUPPRF73219",43,18,83,58,12,77,46,51,"Pilot 7","Pilot 7: bigger feedback + text",11,"high",7
"SUPPRF73219",44,26,74,96,16,83,80,74,"Pilot 7","Pilot 7: bigger feedback + text",11,"high",22
"SUPPRF73219",45,16,89,55,-16,80,71,75,"Pilot 7","Pilot 7: bigger feedback + text",11,"high",-20
"SUPPRF73219",46,22,79,70,-1,61,71,72,"Pilot 7","Pilot 7: bigger feedback + text",11,"high",-2
"SUPPRF73219",47,12,87,67,-13,88,80,87,"Pilot 7","Pilot 7: bigger feedback + text",11,"high",-20
"SUPPRF73219",48,13,85,28,-1,71,29,70,"Pilot 7","Pilot 7: bigger feedback + text",11,"high",-42
"SUPPRF73458",1,54,89,58,12,34,46,41,"Pilot 11","Pilot 11: bigger feedback + video + socially anxious",5,"low",17
"SUPPRF73458",2,40,84,15,-14,29,29,67,"Pilot 11","Pilot 11: bigger feedback + video + socially anxious",5,"low",-52
"SUPPRF73458",3,44,90,45,-1,22,46,45,"Pilot 11","Pilot 11: bigger feedback + video + socially anxious",5,"low",0
"SUPPRF73458",4,47,79,47,27,10,20,10,"Pilot 11","Pilot 11: bigger feedback + video + socially anxious",5,"low",37
"SUPPRF73458",5,52,68,96,16,47,80,78,"Pilot 11","Pilot 11: bigger feedback + video + socially anxious",5,"low",18
"SUPPRF73458",6,46,73,58,29,48,29,17,"Pilot 11","Pilot 11: bigger feedback + video + socially anxious",5,"low",41
"SUPPRF73458",7,48,46,55,1,23,54,44,"Pilot 11","Pilot 11: bigger feedback + video + socially anxious",5,"low",11
"SUPPRF73458",8,37,69,63,0,34,63,48,"Pilot 11","Pilot 11: bigger feedback + video + socially anxious",5,"low",15
"SUPPRF73458",9,45,34,6,-14,30,20,55,"Pilot 11","Pilot 11: bigger feedback + video + socially anxious",5,"low",-49
"SUPPRF73458",10,56,49,71,0,41,71,41,"Pilot 11","Pilot 11: bigger feedback + video + socially anxious",5,"low",30
"SUPPRF73458",11,49,59,37,0,20,37,42,"Pilot 11","Pilot 11: bigger feedback + video + socially anxious",5,"low",-5
"SUPPRF73458",12,48,62,78,24,30,54,46,"Pilot 11","Pilot 11: bigger feedback + video + socially anxious",5,"low",32
"SUPPRF73458",13,46,58,88,25,31,63,27,"Pilot 11","Pilot 11: bigger feedback + video + socially anxious",5,"low",61
"SUPPRF73458",14,52,50,83,12,27,71,39,"Pilot 11","Pilot 11: bigger feedback + video + socially anxious",5,"low",44
"SUPPRF73458",15,58,23,75,29,13,46,7,"Pilot 11","Pilot 11: bigger feedback + video + socially anxious",5,"low",68
"SUPPRF73458",16,47,47,46,0,16,46,27,"Pilot 11","Pilot 11: bigger feedback + video + socially anxious",5,"low",19
"SUPPRF73458",17,27,55,24,-13,34,37,47,"Pilot 11","Pilot 11: bigger feedback + video + socially anxious",5,"low",-23
"SUPPRF73458",18,45,49,19,-1,9,20,5,"Pilot 11","Pilot 11: bigger feedback + video + socially anxious",5,"low",14
"SUPPRF73458",19,48,30,80,0,5,80,8,"Pilot 11","Pilot 11: bigger feedback + video + socially anxious",5,"low",72
"SUPPRF73458",20,37,51,68,-12,23,80,35,"Pilot 11","Pilot 11: bigger feedback + video + socially anxious",5,"low",33
"SUPPRF73458",21,32,33,38,-16,19,54,30,"Pilot 11","Pilot 11: bigger feedback + video + socially anxious",5,"low",8
"SUPPRF73458",22,51,42,20,0,11,20,2,"Pilot 11","Pilot 11: bigger feedback + video + socially anxious",5,"low",18
"SUPPRF73458",23,48,54,41,-13,24,54,30,"Pilot 11","Pilot 11: bigger feedback + video + socially anxious",5,"low",11
"SUPPRF73458",24,53,47,61,24,28,37,34,"Pilot 11","Pilot 11: bigger feedback + video + socially anxious",5,"low",27
"SUPPRF73458",25,42,54,56,-15,40,71,67,"Pilot 11","Pilot 11: bigger feedback + video + socially anxious",5,"low",-11
"SUPPRF73458",26,55,44,34,-12,15,46,11,"Pilot 11","Pilot 11: bigger feedback + video + socially anxious",5,"low",23
"SUPPRF73458",27,30,49,81,1,35,80,30,"Pilot 11","Pilot 11: bigger feedback + video + socially anxious",5,"low",51
"SUPPRF73458",28,41,63,55,-16,39,71,39,"Pilot 11","Pilot 11: bigger feedback + video + socially anxious",5,"low",16
"SUPPRF73458",29,42,46,47,-16,24,63,47,"Pilot 11","Pilot 11: bigger feedback + video + socially anxious",5,"low",0
"SUPPRF73458",30,52,37,49,12,30,37,45,"Pilot 11","Pilot 11: bigger feedback + video + socially anxious",5,"low",4
"SUPPRF73458",31,39,56,38,1,36,37,32,"Pilot 11","Pilot 11: bigger feedback + video + socially anxious",5,"low",6
"SUPPRF73458",32,30,62,16,-13,24,29,31,"Pilot 11","Pilot 11: bigger feedback + video + socially anxious",5,"low",-15
"SUPPRF73458",33,47,65,46,17,24,29,32,"Pilot 11","Pilot 11: bigger feedback + video + socially anxious",5,"low",14
"SUPPRF73458",34,41,53,29,0,62,29,32,"Pilot 11","Pilot 11: bigger feedback + video + socially anxious",5,"low",-3
"SUPPRF73458",35,49,36,35,15,19,20,31,"Pilot 11","Pilot 11: bigger feedback + video + socially anxious",5,"low",4
"SUPPRF73458",36,38,66,54,0,27,54,30,"Pilot 11","Pilot 11: bigger feedback + video + socially anxious",5,"low",24
"SUPPRF73458",37,52,47,50,-13,18,63,29,"Pilot 11","Pilot 11: bigger feedback + video + socially anxious",5,"low",21
"SUPPRF73458",38,45,51,70,-1,32,71,31,"Pilot 11","Pilot 11: bigger feedback + video + socially anxious",5,"low",39
"SUPPRF73458",39,52,43,77,14,25,63,41,"Pilot 11","Pilot 11: bigger feedback + video + socially anxious",5,"low",36
"SUPPRF73458",40,49,59,28,-1,27,29,48,"Pilot 11","Pilot 11: bigger feedback + video + socially anxious",5,"low",-20
"SUPPRF73458",41,43,45,66,12,44,54,22,"Pilot 11","Pilot 11: bigger feedback + video + socially anxious",5,"low",44
"SUPPRF73458",42,47,49,67,-13,34,80,29,"Pilot 11","Pilot 11: bigger feedback + video + socially anxious",5,"low",38
"SUPPRF73458",43,37,58,8,-12,31,20,37,"Pilot 11","Pilot 11: bigger feedback + video + socially anxious",5,"low",-29
"SUPPRF73458",44,49,51,62,-1,26,63,40,"Pilot 11","Pilot 11: bigger feedback + video + socially anxious",5,"low",22
"SUPPRF73458",45,39,42,22,-15,39,37,45,"Pilot 11","Pilot 11: bigger feedback + video + socially anxious",5,"low",-23
"SUPPRF73458",46,50,46,33,-13,37,46,38,"Pilot 11","Pilot 11: bigger feedback + video + socially anxious",5,"low",-5
"SUPPRF73458",47,64,33,94,23,34,71,16,"Pilot 11","Pilot 11: bigger feedback + video + socially anxious",5,"low",78
"SUPPRF73458",48,90,3,100,20,44,80,44,"Pilot 11","Pilot 11: bigger feedback + video + socially anxious",5,"low",56
"SUPPRF74387",1,31,76,58,29,82,29,29,"Pilot 11","Pilot 11: bigger feedback + video + socially anxious",4,"low",29
"SUPPRF74387",2,43,52,75,29,76,46,40,"Pilot 11","Pilot 11: bigger feedback + video + socially anxious",4,"low",35
"SUPPRF74387",3,58,42,55,1,81,54,51,"Pilot 11","Pilot 11: bigger feedback + video + socially anxious",4,"low",4
"SUPPRF74387",4,63,39,88,25,92,63,69,"Pilot 11","Pilot 11: bigger feedback + video + socially anxious",4,"low",19
"SUPPRF74387",5,77,36,83,12,79,71,82,"Pilot 11","Pilot 11: bigger feedback + video + socially anxious",4,"low",1
"SUPPRF74387",6,9,77,15,-14,59,29,68,"Pilot 11","Pilot 11: bigger feedback + video + socially anxious",4,"low",-53
"SUPPRF74387",7,75,44,50,-13,74,63,74,"Pilot 11","Pilot 11: bigger feedback + video + socially anxious",4,"low",-24
"SUPPRF74387",8,95,9,100,20,30,80,48,"Pilot 11","Pilot 11: bigger feedback + video + socially anxious",4,"low",52
"SUPPRF74387",9,53,33,54,0,82,54,75,"Pilot 11","Pilot 11: bigger feedback + video + socially anxious",4,"low",-21
"SUPPRF74387",10,27,64,22,-15,36,37,65,"Pilot 11","Pilot 11: bigger feedback + video + socially anxious",4,"low",-43
"SUPPRF74387",11,57,36,37,0,64,37,31,"Pilot 11","Pilot 11: bigger feedback + video + socially anxious",4,"low",6
"SUPPRF74387",12,84,23,49,12,75,37,33,"Pilot 11","Pilot 11: bigger feedback + video + socially anxious",4,"low",16
"SUPPRF74387",13,92,18,78,24,58,54,71,"Pilot 11","Pilot 11: bigger feedback + video + socially anxious",4,"low",7
"SUPPRF74387",14,94,2,63,0,69,63,63,"Pilot 11","Pilot 11: bigger feedback + video + socially anxious",4,"low",0
"SUPPRF74387",15,14,75,6,-14,86,20,21,"Pilot 11","Pilot 11: bigger feedback + video + socially anxious",4,"low",-15
"SUPPRF74387",16,82,8,81,1,76,80,30,"Pilot 11","Pilot 11: bigger feedback + video + socially anxious",4,"low",51
"SUPPRF74387",17,85,29,46,17,32,29,49,"Pilot 11","Pilot 11: bigger feedback + video + socially anxious",4,"low",-3
"SUPPRF74387",18,83,27,38,1,72,37,55,"Pilot 11","Pilot 11: bigger feedback + video + socially anxious",4,"low",-17
"SUPPRF74387",19,39,32,41,-13,77,54,66,"Pilot 11","Pilot 11: bigger feedback + video + socially anxious",4,"low",-25
"SUPPRF74387",20,64,13,35,15,85,20,18,"Pilot 11","Pilot 11: bigger feedback + video + socially anxious",4,"low",17
"SUPPRF74387",21,82,24,28,-1,70,29,29,"Pilot 11","Pilot 11: bigger feedback + video + socially anxious",4,"low",-1
"SUPPRF74387",22,83,24,47,-16,59,63,49,"Pilot 11","Pilot 11: bigger feedback + video + socially anxious",4,"low",-2
"SUPPRF74387",23,83,14,80,0,81,80,91,"Pilot 11","Pilot 11: bigger feedback + video + socially anxious",4,"low",-11
"SUPPRF74387",24,95,12,47,27,92,20,14,"Pilot 11","Pilot 11: bigger feedback + video + socially anxious",4,"low",33
"SUPPRF74387",25,89,17,29,0,85,29,28,"Pilot 11","Pilot 11: bigger feedback + video + socially anxious",4,"low",1
"SUPPRF74387",26,91,11,46,0,68,46,36,"Pilot 11","Pilot 11: bigger feedback + video + socially anxious",4,"low",10
"SUPPRF74387",27,31,65,55,-16,91,71,89,"Pilot 11","Pilot 11: bigger feedback + video + socially anxious",4,"low",-34
"SUPPRF74387",28,68,28,67,-13,69,80,60,"Pilot 11","Pilot 11: bigger feedback + video + socially anxious",4,"low",7
"SUPPRF74387",29,14,64,33,-13,72,46,79,"Pilot 11","Pilot 11: bigger feedback + video + socially anxious",4,"low",-46
"SUPPRF74387",30,33,65,56,-15,83,71,67,"Pilot 11","Pilot 11: bigger feedback + video + socially anxious",4,"low",-11
"SUPPRF74387",31,13,70,24,-13,72,37,40,"Pilot 11","Pilot 11: bigger feedback + video + socially anxious",4,"low",-16
"SUPPRF74387",32,12,80,16,-13,58,29,48,"Pilot 11","Pilot 11: bigger feedback + video + socially anxious",4,"low",-32
"SUPPRF74387",33,73,26,8,-12,77,20,9,"Pilot 11","Pilot 11: bigger feedback + video + socially anxious",4,"low",-1
"SUPPRF74387",34,92,4,94,23,69,71,73,"Pilot 11","Pilot 11: bigger feedback + video + socially anxious",4,"low",21
"SUPPRF74387",35,75,22,58,12,56,46,62,"Pilot 11","Pilot 11: bigger feedback + video + socially anxious",4,"low",-4
"SUPPRF74387",36,84,13,20,0,78,20,20,"Pilot 11","Pilot 11: bigger feedback + video + socially anxious",4,"low",0
"SUPPRF74387",37,15,77,38,-16,28,54,63,"Pilot 11","Pilot 11: bigger feedback + video + socially anxious",4,"low",-25
"SUPPRF74387",38,84,31,96,16,75,80,60,"Pilot 11","Pilot 11: bigger feedback + video + socially anxious",4,"low",36
"SUPPRF74387",39,95,11,77,14,61,63,34,"Pilot 11","Pilot 11: bigger feedback + video + socially anxious",4,"low",43
"SUPPRF74387",40,94,8,66,12,76,54,68,"Pilot 11","Pilot 11: bigger feedback + video + socially anxious",4,"low",-2
"SUPPRF74387",41,91,12,34,-12,64,46,33,"Pilot 11","Pilot 11: bigger feedback + video + socially anxious",4,"low",1
"SUPPRF74387",42,89,10,19,-1,81,20,10,"Pilot 11","Pilot 11: bigger feedback + video + socially anxious",4,"low",9
"SUPPRF74387",43,87,3,68,-12,84,80,64,"Pilot 11","Pilot 11: bigger feedback + video + socially anxious",4,"low",4
"SUPPRF74387",44,95,10,45,-1,74,46,16,"Pilot 11","Pilot 11: bigger feedback + video + socially anxious",4,"low",29
"SUPPRF74387",45,86,12,62,-1,75,63,40,"Pilot 11","Pilot 11: bigger feedback + video + socially anxious",4,"low",22
"SUPPRF74387",46,98,2,70,-1,79,71,55,"Pilot 11","Pilot 11: bigger feedback + video + socially anxious",4,"low",15
"SUPPRF74387",47,91,16,71,0,73,71,70,"Pilot 11","Pilot 11: bigger feedback + video + socially anxious",4,"low",1
"SUPPRF74387",48,88,12,61,24,72,37,36,"Pilot 11","Pilot 11: bigger feedback + video + socially anxious",4,"low",25
"SUPPRF74630",1,100,9,62,-1,100,63,15,"Pilot 8","Pilot 8: max feedback + text",5,"low",47
"SUPPRF74630",2,0,40,19,-1,43,20,10,"Pilot 8","Pilot 8: max feedback + text",5,"low",9
"SUPPRF74630",3,100,0,55,-16,0,71,0,"Pilot 8","Pilot 8: max feedback + text",5,"low",55
"SUPPRF74630",4,0,100,50,-13,0,63,62,"Pilot 8","Pilot 8: max feedback + text",5,"low",-12
"SUPPRF74630",5,14,93,28,-1,100,29,0,"Pilot 8","Pilot 8: max feedback + text",5,"low",28
"SUPPRF74630",6,60,24,46,0,0,46,6,"Pilot 8","Pilot 8: max feedback + text",5,"low",40
"SUPPRF74630",7,0,99,35,15,27,20,49,"Pilot 8","Pilot 8: max feedback + text",5,"low",-14
"SUPPRF74630",8,0,100,37,0,0,37,54,"Pilot 8","Pilot 8: max feedback + text",5,"low",-17
"SUPPRF74630",9,76,62,46,17,9,29,15,"Pilot 8","Pilot 8: max feedback + text",5,"low",31
"SUPPRF74630",10,100,0,100,20,100,80,62,"Pilot 8","Pilot 8: max feedback + text",5,"low",38
"SUPPRF74630",11,100,0,78,24,58,54,48,"Pilot 8","Pilot 8: max feedback + text",5,"low",30
"SUPPRF74630",12,0,95,29,0,77,29,35,"Pilot 8","Pilot 8: max feedback + text",5,"low",-6
"SUPPRF74630",13,100,0,96,16,39,80,25,"Pilot 8","Pilot 8: max feedback + text",5,"low",71
"SUPPRF74630",14,44,61,67,-13,35,80,44,"Pilot 8","Pilot 8: max feedback + text",5,"low",23
"SUPPRF74630",15,90,0,83,12,74,71,30,"Pilot 8","Pilot 8: max feedback + text",5,"low",53
"SUPPRF74630",16,0,100,24,-13,100,37,26,"Pilot 8","Pilot 8: max feedback + text",5,"low",-2
"SUPPRF74630",17,100,0,54,0,93,54,40,"Pilot 8","Pilot 8: max feedback + text",5,"low",14
"SUPPRF74630",18,0,0,22,-15,12,37,0,"Pilot 8","Pilot 8: max feedback + text",5,"low",22
"SUPPRF74630",19,88,99,45,-1,100,46,36,"Pilot 8","Pilot 8: max feedback + text",5,"low",9
"SUPPRF74630",20,100,2,94,23,100,71,0,"Pilot 8","Pilot 8: max feedback + text",5,"low",94
"SUPPRF74630",21,94,0,81,1,100,80,0,"Pilot 8","Pilot 8: max feedback + text",5,"low",81
"SUPPRF74630",22,100,62,41,-13,0,54,38,"Pilot 8","Pilot 8: max feedback + text",5,"low",3
"SUPPRF74630",23,0,100,8,-12,0,20,18,"Pilot 8","Pilot 8: max feedback + text",5,"low",-10
"SUPPRF74630",24,87,100,77,14,0,63,32,"Pilot 8","Pilot 8: max feedback + text",5,"low",45
"SUPPRF74630",25,75,0,71,0,0,71,28,"Pilot 8","Pilot 8: max feedback + text",5,"low",43
"SUPPRF74630",26,0,100,16,-13,59,29,85,"Pilot 8","Pilot 8: max feedback + text",5,"low",-69
"SUPPRF74630",27,0,100,15,-14,100,29,0,"Pilot 8","Pilot 8: max feedback + text",5,"low",15
"SUPPRF74630",28,100,53,80,0,81,80,50,"Pilot 8","Pilot 8: max feedback + text",5,"low",30
"SUPPRF74630",29,100,9,47,-16,100,63,0,"Pilot 8","Pilot 8: max feedback + text",5,"low",47
"SUPPRF74630",30,100,0,49,12,46,37,37,"Pilot 8","Pilot 8: max feedback + text",5,"low",12
"SUPPRF74630",31,100,0,61,24,0,37,48,"Pilot 8","Pilot 8: max feedback + text",5,"low",13
"SUPPRF74630",32,68,0,34,-12,0,46,36,"Pilot 8","Pilot 8: max feedback + text",5,"low",-2
"SUPPRF74630",33,99,0,68,-12,26,80,30,"Pilot 8","Pilot 8: max feedback + text",5,"low",38
"SUPPRF74630",34,100,0,38,1,15,37,42,"Pilot 8","Pilot 8: max feedback + text",5,"low",-4
"SUPPRF74630",35,100,0,55,1,0,54,1,"Pilot 8","Pilot 8: max feedback + text",5,"low",54
"SUPPRF74630",36,100,0,88,25,61,63,30,"Pilot 8","Pilot 8: max feedback + text",5,"low",58
"SUPPRF74630",37,71,0,47,27,0,20,57,"Pilot 8","Pilot 8: max feedback + text",5,"low",-10
"SUPPRF74630",38,100,0,66,12,0,54,2,"Pilot 8","Pilot 8: max feedback + text",5,"low",64
"SUPPRF74630",39,100,2,70,-1,0,71,25,"Pilot 8","Pilot 8: max feedback + text",5,"low",45
"SUPPRF74630",40,100,0,63,0,0,63,40,"Pilot 8","Pilot 8: max feedback + text",5,"low",23
"SUPPRF74630",41,100,1,58,12,100,46,52,"Pilot 8","Pilot 8: max feedback + text",5,"low",6
"SUPPRF74630",42,80,0,58,29,0,29,35,"Pilot 8","Pilot 8: max feedback + text",5,"low",23
"SUPPRF74630",43,0,0,20,0,0,20,17,"Pilot 8","Pilot 8: max feedback + text",5,"low",3
"SUPPRF74630",44,0,0,6,-14,0,20,25,"Pilot 8","Pilot 8: max feedback + text",5,"low",-19
"SUPPRF74630",45,100,0,38,-16,100,54,0,"Pilot 8","Pilot 8: max feedback + text",5,"low",38
"SUPPRF74630",46,94,0,33,-13,0,46,9,"Pilot 8","Pilot 8: max feedback + text",5,"low",24
"SUPPRF74630",47,100,0,75,29,0,46,5,"Pilot 8","Pilot 8: max feedback + text",5,"low",70
"SUPPRF74630",48,100,0,56,-15,100,71,4,"Pilot 8","Pilot 8: max feedback + text",5,"low",52
"SUPPRF75783",1,78,23,22,-15,19,37,22,"Pilot 7","Pilot 7: bigger feedback + text",3,"low",0
"SUPPRF75783",2,85,18,84,13,44,71,54,"Pilot 7","Pilot 7: bigger feedback + text",3,"low",30
"SUPPRF75783",3,80,13,20,0,21,20,35,"Pilot 7","Pilot 7: bigger feedback + text",3,"low",-15
"SUPPRF75783",4,75,16,16,-13,34,29,63,"Pilot 7","Pilot 7: bigger feedback + text",3,"low",-47
"SUPPRF75783",5,82,13,70,-1,92,71,7,"Pilot 7","Pilot 7: bigger feedback + text",3,"low",63
"SUPPRF75783",6,85,8,49,12,30,37,19,"Pilot 7","Pilot 7: bigger feedback + text",3,"low",30
"SUPPRF75783",7,84,9,41,-13,73,54,43,"Pilot 7","Pilot 7: bigger feedback + text",3,"low",-2
"SUPPRF75783",8,80,12,28,-1,100,29,0,"Pilot 7","Pilot 7: bigger feedback + text",3,"low",28
"SUPPRF75783",9,83,15,55,1,27,54,55,"Pilot 7","Pilot 7: bigger feedback + text",3,"low",0
"SUPPRF75783",10,82,11,96,16,51,80,54,"Pilot 7","Pilot 7: bigger feedback + text",3,"low",42
"SUPPRF75783",11,80,15,81,1,79,80,76,"Pilot 7","Pilot 7: bigger feedback + text",3,"low",5
"SUPPRF75783",12,82,15,37,0,82,37,81,"Pilot 7","Pilot 7: bigger feedback + text",3,"low",-44
"SUPPRF75783",13,82,7,97,17,60,80,65,"Pilot 7","Pilot 7: bigger feedback + text",3,"low",32
"SUPPRF75783",14,87,16,46,0,71,46,10,"Pilot 7","Pilot 7: bigger feedback + text",3,"low",36
"SUPPRF75783",15,88,13,34,-12,81,46,72,"Pilot 7","Pilot 7: bigger feedback + text",3,"low",-38
"SUPPRF75783",16,85,14,50,-13,28,63,38,"Pilot 7","Pilot 7: bigger feedback + text",3,"low",12
"SUPPRF75783",17,84,12,56,-15,58,71,66,"Pilot 7","Pilot 7: bigger feedback + text",3,"low",-10
"SUPPRF75783",18,76,13,6,-14,60,20,60,"Pilot 7","Pilot 7: bigger feedback + text",3,"low",-54
"SUPPRF75783",19,90,4,63,0,79,63,6,"Pilot 7","Pilot 7: bigger feedback + text",3,"low",57
"SUPPRF75783",20,90,13,51,14,75,37,84,"Pilot 7","Pilot 7: bigger feedback + text",3,"low",-33
"SUPPRF75783",21,76,13,15,-14,96,29,81,"Pilot 7","Pilot 7: bigger feedback + text",3,"low",-66
"SUPPRF75783",22,85,11,83,12,33,71,34,"Pilot 7","Pilot 7: bigger feedback + text",3,"low",49
"SUPPRF75783",23,85,12,47,-16,28,63,30,"Pilot 7","Pilot 7: bigger feedback + text",3,"low",17
"SUPPRF75783",24,85,10,37,17,93,20,1,"Pilot 7","Pilot 7: bigger feedback + text",3,"low",36
"SUPPRF75783",25,85,10,66,12,37,54,37,"Pilot 7","Pilot 7: bigger feedback + text",3,"low",29
"SUPPRF75783",26,75,18,29,0,35,29,61,"Pilot 7","Pilot 7: bigger feedback + text",3,"low",-32
"SUPPRF75783",27,79,19,8,-12,92,20,4,"Pilot 7","Pilot 7: bigger feedback + text",3,"low",4
"SUPPRF75783",28,85,9,46,17,85,29,16,"Pilot 7","Pilot 7: bigger feedback + text",3,"low",30
"SUPPRF75783",29,90,10,62,-1,48,63,28,"Pilot 7","Pilot 7: bigger feedback + text",3,"low",34
"SUPPRF75783",30,87,9,45,-1,50,46,25,"Pilot 7","Pilot 7: bigger feedback + text",3,"low",20
"SUPPRF75783",31,78,20,67,-13,26,80,20,"Pilot 7","Pilot 7: bigger feedback + text",3,"low",47
"SUPPRF75783",32,76,15,33,-13,57,46,28,"Pilot 7","Pilot 7: bigger feedback + text",3,"low",5
"SUPPRF75783",33,75,22,54,0,100,54,0,"Pilot 7","Pilot 7: bigger feedback + text",3,"low",54
"SUPPRF75783",34,83,10,55,-16,35,71,37,"Pilot 7","Pilot 7: bigger feedback + text",3,"low",18
"SUPPRF75783",35,89,9,71,0,90,71,93,"Pilot 7","Pilot 7: bigger feedback + text",3,"low",-22
"SUPPRF75783",36,85,17,48,19,35,29,24,"Pilot 7","Pilot 7: bigger feedback + text",3,"low",24
"SUPPRF75783",37,79,18,38,1,55,37,27,"Pilot 7","Pilot 7: bigger feedback + text",3,"low",11
"SUPPRF75783",38,81,15,65,19,33,46,37,"Pilot 7","Pilot 7: bigger feedback + text",3,"low",28
"SUPPRF75783",39,76,23,19,-1,41,20,13,"Pilot 7","Pilot 7: bigger feedback + text",3,"low",6
"SUPPRF75783",40,80,16,58,12,17,46,26,"Pilot 7","Pilot 7: bigger feedback + text",3,"low",32
"SUPPRF75783",41,74,32,35,15,92,20,1,"Pilot 7","Pilot 7: bigger feedback + text",3,"low",34
"SUPPRF75783",42,74,28,24,-13,84,37,81,"Pilot 7","Pilot 7: bigger feedback + text",3,"low",-57
"SUPPRF75783",43,91,4,80,0,63,80,70,"Pilot 7","Pilot 7: bigger feedback + text",3,"low",10
"SUPPRF75783",44,84,13,68,14,55,54,64,"Pilot 7","Pilot 7: bigger feedback + text",3,"low",4
"SUPPRF75783",45,94,9,78,15,51,63,43,"Pilot 7","Pilot 7: bigger feedback + text",3,"low",35
"SUPPRF75783",46,85,13,77,14,42,63,25,"Pilot 7","Pilot 7: bigger feedback + text",3,"low",52
"SUPPRF75783",47,72,32,38,-16,22,54,7,"Pilot 7","Pilot 7: bigger feedback + text",3,"low",31
"SUPPRF75783",48,77,18,68,-12,42,80,24,"Pilot 7","Pilot 7: bigger feedback + text",3,"low",44
"SUPPRF75922",1,87,8,46,0,81,46,65,"Pilot 9","Pilot 9: bigger feedback + text",4,"low",-19
"SUPPRF75922",2,89,7,50,-13,78,63,69,"Pilot 9","Pilot 9: bigger feedback + text",4,"low",-19
"SUPPRF75922",3,88,10,24,-13,85,37,55,"Pilot 9","Pilot 9: bigger feedback + text",4,"low",-31
"SUPPRF75922",4,94,8,71,0,90,71,60,"Pilot 9","Pilot 9: bigger feedback + text",4,"low",11
"SUPPRF75922",5,94,8,67,-13,99,80,85,"Pilot 9","Pilot 9: bigger feedback + text",4,"low",-18
"SUPPRF75922",6,93,7,96,16,78,80,59,"Pilot 9","Pilot 9: bigger feedback + text",4,"low",37
"SUPPRF75922",7,92,3,55,-16,80,71,80,"Pilot 9","Pilot 9: bigger feedback + text",4,"low",-25
"SUPPRF75922",8,91,6,47,27,50,20,25,"Pilot 9","Pilot 9: bigger feedback + text",4,"low",22
"SUPPRF75922",9,92,6,80,0,94,80,80,"Pilot 9","Pilot 9: bigger feedback + text",4,"low",0
"SUPPRF75922",10,94,6,55,1,83,54,59,"Pilot 9","Pilot 9: bigger feedback + text",4,"low",-4
"SUPPRF75922",11,96,7,45,-1,76,46,70,"Pilot 9","Pilot 9: bigger feedback + text",4,"low",-25
"SUPPRF75922",12,90,7,8,-12,47,20,40,"Pilot 9","Pilot 9: bigger feedback + text",4,"low",-32
"SUPPRF75922",13,88,4,46,17,71,29,45,"Pilot 9","Pilot 9: bigger feedback + text",4,"low",1
"SUPPRF75922",14,92,14,75,29,86,46,70,"Pilot 9","Pilot 9: bigger feedback + text",4,"low",5
"SUPPRF75922",15,95,18,6,-14,100,20,39,"Pilot 9","Pilot 9: bigger feedback + text",4,"low",-33
"SUPPRF75922",16,89,26,16,-13,25,29,75,"Pilot 9","Pilot 9: bigger feedback + text",4,"low",-59
"SUPPRF75922",17,94,9,77,14,75,63,64,"Pilot 9","Pilot 9: bigger feedback + text",4,"low",13
"SUPPRF75922",18,94,4,41,-13,82,54,33,"Pilot 9","Pilot 9: bigger feedback + text",4,"low",8
"SUPPRF75922",19,89,15,37,0,92,37,54,"Pilot 9","Pilot 9: bigger feedback + text",4,"low",-17
"SUPPRF75922",20,92,10,56,-15,94,71,68,"Pilot 9","Pilot 9: bigger feedback + text",4,"low",-12
"SUPPRF75922",21,95,5,38,-16,76,54,70,"Pilot 9","Pilot 9: bigger feedback + text",4,"low",-32
"SUPPRF75922",22,93,6,29,0,85,29,27,"Pilot 9","Pilot 9: bigger feedback + text",4,"low",2
"SUPPRF75922",23,86,7,70,-1,90,71,49,"Pilot 9","Pilot 9: bigger feedback + text",4,"low",21
"SUPPRF75922",24,97,11,66,12,98,54,50,"Pilot 9","Pilot 9: bigger feedback + text",4,"low",16
"SUPPRF75922",25,92,16,68,-12,100,80,95,"Pilot 9","Pilot 9: bigger feedback + text",4,"low",-27
"SUPPRF75922",26,91,10,22,-15,95,37,26,"Pilot 9","Pilot 9: bigger feedback + text",4,"low",-4
"SUPPRF75922",27,96,5,19,-1,98,20,36,"Pilot 9","Pilot 9: bigger feedback + text",4,"low",-17
"SUPPRF75922",28,91,7,34,-12,94,46,34,"Pilot 9","Pilot 9: bigger feedback + text",4,"low",0
"SUPPRF75922",29,93,6,94,23,99,71,80,"Pilot 9","Pilot 9: bigger feedback + text",4,"low",14
"SUPPRF75922",30,89,8,33,-13,89,46,60,"Pilot 9","Pilot 9: bigger feedback + text",4,"low",-27
"SUPPRF75922",31,94,6,83,12,100,71,88,"Pilot 9","Pilot 9: bigger feedback + text",4,"low",-5
"SUPPRF75922",32,91,15,63,0,91,63,75,"Pilot 9","Pilot 9: bigger feedback + text",4,"low",-12
"SUPPRF75922",33,92,9,58,29,51,29,40,"Pilot 9","Pilot 9: bigger feedback + text",4,"low",18
"SUPPRF75922",34,92,9,81,1,93,80,76,"Pilot 9","Pilot 9: bigger feedback + text",4,"low",5
"SUPPRF75922",35,93,8,100,20,85,80,90,"Pilot 9","Pilot 9: bigger feedback + text",4,"low",10
"SUPPRF75922",36,91,8,61,24,88,37,50,"Pilot 9","Pilot 9: bigger feedback + text",4,"low",11
"SUPPRF75922",37,89,8,28,-1,88,29,73,"Pilot 9","Pilot 9: bigger feedback + text",4,"low",-45
"SUPPRF75922",38,90,9,62,-1,87,63,80,"Pilot 9","Pilot 9: bigger feedback + text",4,"low",-18
"SUPPRF75922",39,98,6,58,12,100,46,65,"Pilot 9","Pilot 9: bigger feedback + text",4,"low",-7
"SUPPRF75922",40,88,18,47,-16,92,63,85,"Pilot 9","Pilot 9: bigger feedback + text",4,"low",-38
"SUPPRF75922",41,97,4,78,24,88,54,70,"Pilot 9","Pilot 9: bigger feedback + text",4,"low",8
"SUPPRF75922",42,92,13,49,12,100,37,53,"Pilot 9","Pilot 9: bigger feedback + text",4,"low",-4
"SUPPRF75922",43,80,28,15,-14,85,29,25,"Pilot 9","Pilot 9: bigger feedback + text",4,"low",-10
"SUPPRF75922",44,77,8,35,15,44,20,30,"Pilot 9","Pilot 9: bigger feedback + text",4,"low",5
"SUPPRF75922",45,84,17,54,0,87,54,60,"Pilot 9","Pilot 9: bigger feedback + text",4,"low",-6
"SUPPRF75922",46,95,12,88,25,99,63,55,"Pilot 9","Pilot 9: bigger feedback + text",4,"low",33
"SUPPRF75922",47,76,23,20,0,92,20,25,"Pilot 9","Pilot 9: bigger feedback + text",4,"low",-5
"SUPPRF75922",48,88,11,38,1,60,37,41,"Pilot 9","Pilot 9: bigger feedback + text",4,"low",-3
"SUPPRF76101",1,85,11,70,-1,100,71,90,"Pilot 8","Pilot 8: max feedback + text",0,"low",-20
"SUPPRF76101",2,73,14,15,-14,90,29,30,"Pilot 8","Pilot 8: max feedback + text",0,"low",-15
"SUPPRF76101",3,72,13,16,-13,60,29,10,"Pilot 8","Pilot 8: max feedback + text",0,"low",6
"SUPPRF76101",4,78,15,37,0,27,37,70,"Pilot 8","Pilot 8: max feedback + text",0,"low",-33
"SUPPRF76101",5,83,15,29,0,89,29,25,"Pilot 8","Pilot 8: max feedback + text",0,"low",4
"SUPPRF76101",6,88,4,88,25,95,63,70,"Pilot 8","Pilot 8: max feedback + text",0,"low",18
"SUPPRF76101",7,83,1,47,27,85,20,35,"Pilot 8","Pilot 8: max feedback + text",0,"low",12
"SUPPRF76101",8,83,0,55,-16,100,71,90,"Pilot 8","Pilot 8: max feedback + text",0,"low",-35
"SUPPRF76101",9,87,0,35,15,81,20,36,"Pilot 8","Pilot 8: max feedback + text",0,"low",-1
"SUPPRF76101",10,75,3,34,-12,84,46,85,"Pilot 8","Pilot 8: max feedback + text",0,"low",-51
"SUPPRF76101",11,85,0,61,24,50,37,20,"Pilot 8","Pilot 8: max feedback + text",0,"low",41
"SUPPRF76101",12,69,3,50,-13,95,63,70,"Pilot 8","Pilot 8: max feedback + text",0,"low",-20
"SUPPRF76101",13,81,0,19,-1,86,20,25,"Pilot 8","Pilot 8: max feedback + text",0,"low",-6
"SUPPRF76101",14,76,0,6,-14,86,20,20,"Pilot 8","Pilot 8: max feedback + text",0,"low",-14
"SUPPRF76101",15,71,6,67,-13,92,80,90,"Pilot 8","Pilot 8: max feedback + text",0,"low",-23
"SUPPRF76101",16,81,0,58,12,64,46,36,"Pilot 8","Pilot 8: max feedback + text",0,"low",22
"SUPPRF76101",17,65,9,28,-1,79,29,56,"Pilot 8","Pilot 8: max feedback + text",0,"low",-28
"SUPPRF76101",18,63,16,41,-13,78,54,75,"Pilot 8","Pilot 8: max feedback + text",0,"low",-34
"SUPPRF76101",19,56,13,8,-12,41,20,30,"Pilot 8","Pilot 8: max feedback + text",0,"low",-22
"SUPPRF76101",20,64,31,22,-15,100,37,0,"Pilot 8","Pilot 8: max feedback + text",0,"low",22
"SUPPRF76101",21,76,18,83,12,80,71,70,"Pilot 8","Pilot 8: max feedback + text",0,"low",13
"SUPPRF76101",22,79,8,75,29,81,46,60,"Pilot 8","Pilot 8: max feedback + text",0,"low",15
"SUPPRF76101",23,53,6,96,16,93,80,10,"Pilot 8","Pilot 8: max feedback + text",0,"low",86
"SUPPRF76101",24,63,10,38,1,72,37,50,"Pilot 8","Pilot 8: max feedback + text",0,"low",-12
"SUPPRF76101",25,57,6,24,-13,47,37,55,"Pilot 8","Pilot 8: max feedback + text",0,"low",-31
"SUPPRF76101",26,68,8,33,-13,85,46,40,"Pilot 8","Pilot 8: max feedback + text",0,"low",-7
"SUPPRF76101",27,73,4,68,-12,90,80,75,"Pilot 8","Pilot 8: max feedback + text",0,"low",-7
"SUPPRF76101",28,68,7,45,-1,71,46,60,"Pilot 8","Pilot 8: max feedback + text",0,"low",-15
"SUPPRF76101",29,67,9,66,12,74,54,61,"Pilot 8","Pilot 8: max feedback + text",0,"low",5
"SUPPRF76101",30,70,6,46,0,67,46,46,"Pilot 8","Pilot 8: max feedback + text",0,"low",0
"SUPPRF76101",31,49,8,81,1,57,80,27,"Pilot 8","Pilot 8: max feedback + text",0,"low",54
"SUPPRF76101",32,60,7,55,1,100,54,75,"Pilot 8","Pilot 8: max feedback + text",0,"low",-20
"SUPPRF76101",33,69,6,78,24,80,54,60,"Pilot 8","Pilot 8: max feedback + text",0,"low",18
"SUPPRF76101",34,72,7,47,-16,77,63,55,"Pilot 8","Pilot 8: max feedback + text",0,"low",-8
"SUPPRF76101",35,62,8,38,-16,83,54,71,"Pilot 8","Pilot 8: max feedback + text",0,"low",-33
"SUPPRF76101",36,63,7,94,23,95,71,70,"Pilot 8","Pilot 8: max feedback + text",0,"low",24
"SUPPRF76101",37,69,8,54,0,80,54,60,"Pilot 8","Pilot 8: max feedback + text",0,"low",-6
"SUPPRF76101",38,60,6,58,29,78,29,35,"Pilot 8","Pilot 8: max feedback + text",0,"low",23
"SUPPRF76101",39,64,1,62,-1,81,63,74,"Pilot 8","Pilot 8: max feedback + text",0,"low",-12
"SUPPRF76101",40,66,4,80,0,72,80,76,"Pilot 8","Pilot 8: max feedback + text",0,"low",4
"SUPPRF76101",41,64,5,77,14,84,63,50,"Pilot 8","Pilot 8: max feedback + text",0,"low",27
"SUPPRF76101",42,64,5,56,-15,90,71,70,"Pilot 8","Pilot 8: max feedback + text",0,"low",-14
"SUPPRF76101",43,84,5,71,0,90,71,75,"Pilot 8","Pilot 8: max feedback + text",0,"low",-4
"SUPPRF76101",44,78,4,63,0,83,63,50,"Pilot 8","Pilot 8: max feedback + text",0,"low",13
"SUPPRF76101",45,80,4,46,17,70,29,40,"Pilot 8","Pilot 8: max feedback + text",0,"low",6
"SUPPRF76101",46,80,7,49,12,52,37,44,"Pilot 8","Pilot 8: max feedback + text",0,"low",5
"SUPPRF76101",47,51,50,20,0,0,20,10,"Pilot 8","Pilot 8: max feedback + text",0,"low",10
"SUPPRF76101",48,89,8,100,20,90,80,79,"Pilot 8","Pilot 8: max feedback + text",0,"low",21
"SUPPRF76395",1,61,61,100,20,38,80,62,"Pilot 11","Pilot 11: bigger feedback + video + socially anxious",10,"high",38
"SUPPRF76395",2,63,57,80,0,61,80,84,"Pilot 11","Pilot 11: bigger feedback + video + socially anxious",10,"high",-4
"SUPPRF76395",3,62,60,20,0,27,20,62,"Pilot 11","Pilot 11: bigger feedback + video + socially anxious",10,"high",-42
"SUPPRF76395",4,63,61,50,-13,38,63,46,"Pilot 11","Pilot 11: bigger feedback + video + socially anxious",10,"high",4
"SUPPRF76395",5,79,56,58,29,30,29,11,"Pilot 11","Pilot 11: bigger feedback + video + socially anxious",10,"high",47
"SUPPRF76395",6,61,54,29,0,20,29,36,"Pilot 11","Pilot 11: bigger feedback + video + socially anxious",10,"high",-7
"SUPPRF76395",7,62,52,63,0,22,63,20,"Pilot 11","Pilot 11: bigger feedback + video + socially anxious",10,"high",43
"SUPPRF76395",8,50,52,35,15,29,20,37,"Pilot 11","Pilot 11: bigger feedback + video + socially anxious",10,"high",-2
"SUPPRF76395",9,66,60,56,-15,40,71,64,"Pilot 11","Pilot 11: bigger feedback + video + socially anxious",10,"high",-8
"SUPPRF76395",10,56,65,8,-12,4,20,23,"Pilot 11","Pilot 11: bigger feedback + video + socially anxious",10,"high",-15
"SUPPRF76395",11,48,64,33,-13,6,46,18,"Pilot 11","Pilot 11: bigger feedback + video + socially anxious",10,"high",15
"SUPPRF76395",12,53,68,47,-16,24,63,12,"Pilot 11","Pilot 11: bigger feedback + video + socially anxious",10,"high",35
"SUPPRF76395",13,56,69,81,1,5,80,15,"Pilot 11","Pilot 11: bigger feedback + video + socially anxious",10,"high",66
"SUPPRF76395",14,71,61,77,14,41,63,53,"Pilot 11","Pilot 11: bigger feedback + video + socially anxious",10,"high",24
"SUPPRF76395",15,59,49,88,25,41,63,35,"Pilot 11","Pilot 11: bigger feedback + video + socially anxious",10,"high",53
"SUPPRF76395",16,58,54,46,0,40,46,17,"Pilot 11","Pilot 11: bigger feedback + video + socially anxious",10,"high",29
"SUPPRF76395",17,60,52,6,-14,3,20,13,"Pilot 11","Pilot 11: bigger feedback + video + socially anxious",10,"high",-7
"SUPPRF76395",18,68,55,62,-1,25,63,16,"Pilot 11","Pilot 11: bigger feedback + video + socially anxious",10,"high",46
"SUPPRF76395",19,61,65,15,-14,30,29,34,"Pilot 11","Pilot 11: bigger feedback + video + socially anxious",10,"high",-19
"SUPPRF76395",20,75,58,70,-1,37,71,34,"Pilot 11","Pilot 11: bigger feedback + video + socially anxious",10,"high",36
"SUPPRF76395",21,86,64,28,-1,30,29,40,"Pilot 11","Pilot 11: bigger feedback + video + socially anxious",10,"high",-12
"SUPPRF76395",22,48,69,16,-13,11,29,42,"Pilot 11","Pilot 11: bigger feedback + video + socially anxious",10,"high",-26
"SUPPRF76395",23,84,67,54,0,14,54,7,"Pilot 11","Pilot 11: bigger feedback + video + socially anxious",10,"high",47
"SUPPRF76395",24,46,65,19,-1,52,20,3,"Pilot 11","Pilot 11: bigger feedback + video + socially anxious",10,"high",16
"SUPPRF76395",25,75,72,34,-12,50,46,36,"Pilot 11","Pilot 11: bigger feedback + video + socially anxious",10,"high",-2
"SUPPRF76395",26,83,55,96,16,39,80,55,"Pilot 11","Pilot 11: bigger feedback + video + socially anxious",10,"high",41
"SUPPRF76395",27,52,75,38,-16,55,54,49,"Pilot 11","Pilot 11: bigger feedback + video + socially anxious",10,"high",-11
"SUPPRF76395",28,68,76,46,17,15,29,31,"Pilot 11","Pilot 11: bigger feedback + video + socially anxious",10,"high",15
"SUPPRF76395",29,77,62,55,-16,18,71,41,"Pilot 11","Pilot 11: bigger feedback + video + socially anxious",10,"high",14
"SUPPRF76395",30,88,57,75,29,26,46,41,"Pilot 11","Pilot 11: bigger feedback + video + socially anxious",10,"high",34
"SUPPRF76395",31,66,72,41,-13,17,54,47,"Pilot 11","Pilot 11: bigger feedback + video + socially anxious",10,"high",-6
"SUPPRF76395",32,62,75,67,-13,14,80,44,"Pilot 11","Pilot 11: bigger feedback + video + socially anxious",10,"high",23
"SUPPRF76395",33,89,66,78,24,9,54,38,"Pilot 11","Pilot 11: bigger feedback + video + socially anxious",10,"high",40
"SUPPRF76395",34,85,65,61,24,1,37,32,"Pilot 11","Pilot 11: bigger feedback + video + socially anxious",10,"high",29
"SUPPRF76395",35,68,66,55,1,5,54,44,"Pilot 11","Pilot 11: bigger feedback + video + socially anxious",10,"high",11
"SUPPRF76395",36,57,70,68,-12,30,80,85,"Pilot 11","Pilot 11: bigger feedback + video + socially anxious",10,"high",-17
"SUPPRF76395",37,90,68,71,0,16,71,28,"Pilot 11","Pilot 11: bigger feedback + video + socially anxious",10,"high",43
"SUPPRF76395",38,85,52,47,27,4,20,20,"Pilot 11","Pilot 11: bigger feedback + video + socially anxious",10,"high",27
"SUPPRF76395",39,88,69,38,1,3,37,19,"Pilot 11","Pilot 11: bigger feedback + video + socially anxious",10,"high",19
"SUPPRF76395",40,66,56,45,-1,8,46,31,"Pilot 11","Pilot 11: bigger feedback + video + socially anxious",10,"high",14
"SUPPRF76395",41,68,57,49,12,4,37,14,"Pilot 11","Pilot 11: bigger feedback + video + socially anxious",10,"high",35
"SUPPRF76395",42,56,57,24,-13,9,37,32,"Pilot 11","Pilot 11: bigger feedback + video + socially anxious",10,"high",-8
"SUPPRF76395",43,77,59,58,12,34,46,19,"Pilot 11","Pilot 11: bigger feedback + video + socially anxious",10,"high",39
"SUPPRF76395",44,95,53,94,23,30,71,38,"Pilot 11","Pilot 11: bigger feedback + video + socially anxious",10,"high",56
"SUPPRF76395",45,61,70,37,0,37,37,30,"Pilot 11","Pilot 11: bigger feedback + video + socially anxious",10,"high",7
"SUPPRF76395",46,94,72,83,12,47,71,75,"Pilot 11","Pilot 11: bigger feedback + video + socially anxious",10,"high",8
"SUPPRF76395",47,72,79,22,-15,48,37,32,"Pilot 11","Pilot 11: bigger feedback + video + socially anxious",10,"high",-10
"SUPPRF76395",48,81,65,66,12,6,54,42,"Pilot 11","Pilot 11: bigger feedback + video + socially anxious",10,"high",24
"SUPPRF77020",1,21,51,15,-14,62,29,29,"Pilot 10","Pilot 10: bigger feedback + video",4,"low",-14
"SUPPRF77020",2,57,45,38,-16,34,54,36,"Pilot 10","Pilot 10: bigger feedback + video",4,"low",2
"SUPPRF77020",3,77,38,63,0,58,63,62,"Pilot 10","Pilot 10: bigger feedback + video",4,"low",1
"SUPPRF77020",4,43,42,47,-16,62,63,66,"Pilot 10","Pilot 10: bigger feedback + video",4,"low",-19
"SUPPRF77020",5,62,37,37,0,65,37,29,"Pilot 10","Pilot 10: bigger feedback + video",4,"low",8
"SUPPRF77020",6,48,30,62,-1,31,63,42,"Pilot 10","Pilot 10: bigger feedback + video",4,"low",20
"SUPPRF77020",7,53,40,67,-13,71,80,67,"Pilot 10","Pilot 10: bigger feedback + video",4,"low",0
"SUPPRF77020",8,97,21,19,-1,69,20,20,"Pilot 10","Pilot 10: bigger feedback + video",4,"low",-1
"SUPPRF77020",9,47,34,33,-13,27,46,33,"Pilot 10","Pilot 10: bigger feedback + video",4,"low",0
"SUPPRF77020",10,46,35,46,0,32,46,39,"Pilot 10","Pilot 10: bigger feedback + video",4,"low",7
"SUPPRF77020",11,45,19,38,1,71,37,25,"Pilot 10","Pilot 10: bigger feedback + video",4,"low",13
"SUPPRF77020",12,47,19,50,-13,67,63,74,"Pilot 10","Pilot 10: bigger feedback + video",4,"low",-24
"SUPPRF77020",13,34,26,58,29,36,29,24,"Pilot 10","Pilot 10: bigger feedback + video",4,"low",34
"SUPPRF77020",14,67,33,77,14,10,63,43,"Pilot 10","Pilot 10: bigger feedback + video",4,"low",34
"SUPPRF77020",15,52,22,96,16,71,80,81,"Pilot 10","Pilot 10: bigger feedback + video",4,"low",15
"SUPPRF77020",16,47,35,35,15,58,20,18,"Pilot 10","Pilot 10: bigger feedback + video",4,"low",17
"SUPPRF77020",17,66,30,70,-1,77,71,73,"Pilot 10","Pilot 10: bigger feedback + video",4,"low",-3
"SUPPRF77020",18,47,34,55,1,31,54,57,"Pilot 10","Pilot 10: bigger feedback + video",4,"low",-2
"SUPPRF77020",19,49,48,46,17,9,29,37,"Pilot 10","Pilot 10: bigger feedback + video",4,"low",9
"SUPPRF77020",20,66,35,68,-12,67,80,74,"Pilot 10","Pilot 10: bigger feedback + video",4,"low",-6
"SUPPRF77020",21,55,48,49,12,61,37,30,"Pilot 10","Pilot 10: bigger feedback + video",4,"low",19
"SUPPRF77020",22,46,40,45,-1,23,46,40,"Pilot 10","Pilot 10: bigger feedback + video",4,"low",5
"SUPPRF77020",23,38,39,24,-13,71,37,33,"Pilot 10","Pilot 10: bigger feedback + video",4,"low",-9
"SUPPRF77020",24,48,49,75,29,63,46,37,"Pilot 10","Pilot 10: bigger feedback + video",4,"low",38
"SUPPRF77020",25,45,39,28,-1,60,29,35,"Pilot 10","Pilot 10: bigger feedback + video",4,"low",-7
"SUPPRF77020",26,38,35,61,24,29,37,30,"Pilot 10","Pilot 10: bigger feedback + video",4,"low",31
"SUPPRF77020",27,44,42,94,23,40,71,59,"Pilot 10","Pilot 10: bigger feedback + video",4,"low",35
"SUPPRF77020",28,75,47,54,0,78,54,58,"Pilot 10","Pilot 10: bigger feedback + video",4,"low",-4
"SUPPRF77020",29,29,38,47,27,78,20,21,"Pilot 10","Pilot 10: bigger feedback + video",4,"low",26
"SUPPRF77020",30,53,35,41,-13,93,54,57,"Pilot 10","Pilot 10: bigger feedback + video",4,"low",-16
"SUPPRF77020",31,76,38,100,20,81,80,74,"Pilot 10","Pilot 10: bigger feedback + video",4,"low",26
"SUPPRF77020",32,33,44,56,-15,82,71,71,"Pilot 10","Pilot 10: bigger feedback + video",4,"low",-15
"SUPPRF77020",33,48,47,20,0,85,20,20,"Pilot 10","Pilot 10: bigger feedback + video",4,"low",0
"SUPPRF77020",34,56,35,66,12,77,54,58,"Pilot 10","Pilot 10: bigger feedback + video",4,"low",8
"SUPPRF77020",35,54,43,88,25,67,63,75,"Pilot 10","Pilot 10: bigger feedback + video",4,"low",13
"SUPPRF77020",36,77,31,71,0,70,71,76,"Pilot 10","Pilot 10: bigger feedback + video",4,"low",-5
"SUPPRF77020",37,50,35,80,0,83,80,83,"Pilot 10","Pilot 10: bigger feedback + video",4,"low",-3
"SUPPRF77020",38,46,50,16,-13,66,29,24,"Pilot 10","Pilot 10: bigger feedback + video",4,"low",-8
"SUPPRF77020",39,43,47,34,-12,72,46,74,"Pilot 10","Pilot 10: bigger feedback + video",4,"low",-40
"SUPPRF77020",40,52,44,78,24,67,54,62,"Pilot 10","Pilot 10: bigger feedback + video",4,"low",16
"SUPPRF77020",41,49,41,22,-15,12,37,30,"Pilot 10","Pilot 10: bigger feedback + video",4,"low",-8
"SUPPRF77020",42,44,39,58,12,40,46,58,"Pilot 10","Pilot 10: bigger feedback + video",4,"low",0
"SUPPRF77020",43,44,54,55,-16,64,71,75,"Pilot 10","Pilot 10: bigger feedback + video",4,"low",-20
"SUPPRF77020",44,49,49,81,1,52,80,75,"Pilot 10","Pilot 10: bigger feedback + video",4,"low",6
"SUPPRF77020",45,36,36,6,-14,27,20,33,"Pilot 10","Pilot 10: bigger feedback + video",4,"low",-27
"SUPPRF77020",46,53,67,83,12,69,71,74,"Pilot 10","Pilot 10: bigger feedback + video",4,"low",9
"SUPPRF77020",47,39,55,29,0,5,29,58,"Pilot 10","Pilot 10: bigger feedback + video",4,"low",-29
"SUPPRF77020",48,42,65,8,-12,26,20,72,"Pilot 10","Pilot 10: bigger feedback + video",4,"low",-64
"SUPPRF77371",1,51,41,22,-15,48,37,33,"Pilot 6","Pilot 6: feedback + text",9,"high",-11
"SUPPRF77371",2,72,45,80,0,78,80,81,"Pilot 6","Pilot 6: feedback + text",9,"high",-1
"SUPPRF77371",3,67,34,68,14,37,54,31,"Pilot 6","Pilot 6: feedback + text",9,"high",37
"SUPPRF77371",4,64,31,38,1,32,37,32,"Pilot 6","Pilot 6: feedback + text",9,"high",6
"SUPPRF77371",5,53,37,96,16,50,80,50,"Pilot 6","Pilot 6: feedback + text",9,"high",46
"SUPPRF77371",6,63,46,63,0,33,63,31,"Pilot 6","Pilot 6: feedback + text",9,"high",32
"SUPPRF77371",7,76,40,81,1,76,80,76,"Pilot 6","Pilot 6: feedback + text",9,"high",5
"SUPPRF77371",8,75,27,46,17,24,29,25,"Pilot 6","Pilot 6: feedback + text",9,"high",21
"SUPPRF77371",9,76,30,67,-13,79,80,74,"Pilot 6","Pilot 6: feedback + text",9,"high",-7
"SUPPRF77371",10,84,22,62,-1,69,63,68,"Pilot 6","Pilot 6: feedback + text",9,"high",-6
"SUPPRF77371",11,77,23,24,-13,52,37,48,"Pilot 6","Pilot 6: feedback + text",9,"high",-24
"SUPPRF77371",12,82,18,83,12,56,71,37,"Pilot 6","Pilot 6: feedback + text",9,"high",46
"SUPPRF77371",13,87,14,19,-1,6,20,9,"Pilot 6","Pilot 6: feedback + text",9,"high",10
"SUPPRF77371",14,84,14,55,1,44,54,48,"Pilot 6","Pilot 6: feedback + text",9,"high",7
"SUPPRF77371",15,89,11,16,-13,15,29,11,"Pilot 6","Pilot 6: feedback + text",9,"high",5
"SUPPRF77371",16,88,22,58,12,45,46,33,"Pilot 6","Pilot 6: feedback + text",9,"high",25
"SUPPRF77371",17,91,8,20,0,9,20,12,"Pilot 6","Pilot 6: feedback + text",9,"high",8
"SUPPRF77371",18,93,9,48,19,12,29,12,"Pilot 6","Pilot 6: feedback + text",9,"high",36
"SUPPRF77371",19,94,1,65,19,28,46,34,"Pilot 6","Pilot 6: feedback + text",9,"high",31
"SUPPRF77371",20,96,5,33,-13,16,46,40,"Pilot 6","Pilot 6: feedback + text",9,"high",-7
"SUPPRF77371",21,92,3,50,-13,55,63,53,"Pilot 6","Pilot 6: feedback + text",9,"high",-3
"SUPPRF77371",22,93,5,38,-16,41,54,56,"Pilot 6","Pilot 6: feedback + text",9,"high",-18
"SUPPRF77371",23,95,14,28,-1,30,29,57,"Pilot 6","Pilot 6: feedback + text",9,"high",-29
"SUPPRF77371",24,90,15,8,-12,16,20,16,"Pilot 6","Pilot 6: feedback + text",9,"high",-8
"SUPPRF77371",25,87,4,56,-15,45,71,62,"Pilot 6","Pilot 6: feedback + text",9,"high",-6
"SUPPRF77371",26,95,4,45,-1,38,46,40,"Pilot 6","Pilot 6: feedback + text",9,"high",5
"SUPPRF77371",27,86,11,47,-16,52,63,54,"Pilot 6","Pilot 6: feedback + text",9,"high",-7
"SUPPRF77371",28,73,15,34,-12,27,46,42,"Pilot 6","Pilot 6: feedback + text",9,"high",-8
"SUPPRF77371",29,80,17,54,0,50,54,44,"Pilot 6","Pilot 6: feedback + text",9,"high",10
"SUPPRF77371",30,82,8,37,17,18,20,21,"Pilot 6","Pilot 6: feedback + text",9,"high",16
"SUPPRF77371",31,84,14,68,-12,37,80,75,"Pilot 6","Pilot 6: feedback + text",9,"high",-7
"SUPPRF77371",32,90,5,29,0,15,29,26,"Pilot 6","Pilot 6: feedback + text",9,"high",3
"SUPPRF77371",33,82,7,15,-14,13,29,30,"Pilot 6","Pilot 6: feedback + text",9,"high",-15
"SUPPRF77371",34,75,10,78,15,48,63,20,"Pilot 6","Pilot 6: feedback + text",9,"high",58
"SUPPRF77371",35,91,7,41,-13,20,54,27,"Pilot 6","Pilot 6: feedback + text",9,"high",14
"SUPPRF77371",36,97,6,66,12,43,54,46,"Pilot 6","Pilot 6: feedback + text",9,"high",20
"SUPPRF77371",37,79,10,46,0,28,46,21,"Pilot 6","Pilot 6: feedback + text",9,"high",25
"SUPPRF77371",38,97,1,97,17,42,80,64,"Pilot 6","Pilot 6: feedback + text",9,"high",33
"SUPPRF77371",39,98,6,71,0,42,71,66,"Pilot 6","Pilot 6: feedback + text",9,"high",5
"SUPPRF77371",40,94,7,55,-16,62,71,72,"Pilot 6","Pilot 6: feedback + text",9,"high",-17
"SUPPRF77371",41,84,4,70,-1,46,71,46,"Pilot 6","Pilot 6: feedback + text",9,"high",24
"SUPPRF77371",42,87,8,84,13,53,71,54,"Pilot 6","Pilot 6: feedback + text",9,"high",30
"SUPPRF77371",43,92,4,37,0,25,37,25,"Pilot 6","Pilot 6: feedback + text",9,"high",12
"SUPPRF77371",44,96,3,49,12,34,37,28,"Pilot 6","Pilot 6: feedback + text",9,"high",21
"SUPPRF77371",45,97,6,35,15,53,20,24,"Pilot 6","Pilot 6: feedback + text",9,"high",11
"SUPPRF77371",46,98,2,77,14,62,63,40,"Pilot 6","Pilot 6: feedback + text",9,"high",37
"SUPPRF77371",47,96,2,51,14,48,37,29,"Pilot 6","Pilot 6: feedback + text",9,"high",22
"SUPPRF77371",48,93,9,6,-14,45,20,45,"Pilot 6","Pilot 6: feedback + text",9,"high",-39
"SUPPRF77733",1,53,51,8,-12,50,20,50,"Pilot 8","Pilot 8: max feedback + text",5,"low",-42
"SUPPRF77733",2,49,49,38,-16,50,54,63,"Pilot 8","Pilot 8: max feedback + text",5,"low",-25
"SUPPRF77733",3,50,50,47,-16,50,63,62,"Pilot 8","Pilot 8: max feedback + text",5,"low",-15
"SUPPRF77733",4,51,51,71,0,50,71,50,"Pilot 8","Pilot 8: max feedback + text",5,"low",21
"SUPPRF77733",5,50,48,61,24,50,37,72,"Pilot 8","Pilot 8: max feedback + text",5,"low",-11
"SUPPRF77733",6,51,53,45,-1,50,46,45,"Pilot 8","Pilot 8: max feedback + text",5,"low",0
"SUPPRF77733",7,51,50,34,-12,50,46,47,"Pilot 8","Pilot 8: max feedback + text",5,"low",-13
"SUPPRF77733",8,50,48,28,-1,50,29,30,"Pilot 8","Pilot 8: max feedback + text",5,"low",-2
"SUPPRF77733",9,50,50,50,-13,49,63,45,"Pilot 8","Pilot 8: max feedback + text",5,"low",5
"SUPPRF77733",10,48,48,56,-15,50,71,70,"Pilot 8","Pilot 8: max feedback + text",5,"low",-14
"SUPPRF77733",11,49,48,62,-1,50,63,60,"Pilot 8","Pilot 8: max feedback + text",5,"low",2
"SUPPRF77733",12,48,48,47,27,50,20,44,"Pilot 8","Pilot 8: max feedback + text",5,"low",3
"SUPPRF77733",13,49,47,22,-15,50,37,44,"Pilot 8","Pilot 8: max feedback + text",5,"low",-22
"SUPPRF77733",14,48,49,66,12,50,54,44,"Pilot 8","Pilot 8: max feedback + text",5,"low",22
"SUPPRF77733",15,50,49,46,0,50,46,47,"Pilot 8","Pilot 8: max feedback + text",5,"low",-1
"SUPPRF77733",16,49,48,78,24,50,54,58,"Pilot 8","Pilot 8: max feedback + text",5,"low",20
"SUPPRF77733",17,47,49,80,0,50,80,80,"Pilot 8","Pilot 8: max feedback + text",5,"low",0
"SUPPRF77733",18,48,48,49,12,50,37,44,"Pilot 8","Pilot 8: max feedback + text",5,"low",5
"SUPPRF77733",19,49,49,54,0,50,54,61,"Pilot 8","Pilot 8: max feedback + text",5,"low",-7
"SUPPRF77733",20,47,49,58,12,50,46,60,"Pilot 8","Pilot 8: max feedback + text",5,"low",-2
"SUPPRF77733",21,49,52,88,25,50,63,65,"Pilot 8","Pilot 8: max feedback + text",5,"low",23
"SUPPRF77733",22,50,49,24,-13,50,37,44,"Pilot 8","Pilot 8: max feedback + text",5,"low",-20
"SUPPRF77733",23,50,47,46,17,50,29,30,"Pilot 8","Pilot 8: max feedback + text",5,"low",16
"SUPPRF77733",24,50,50,100,20,50,80,68,"Pilot 8","Pilot 8: max feedback + text",5,"low",32
"SUPPRF77733",25,51,49,70,-1,50,71,60,"Pilot 8","Pilot 8: max feedback + text",5,"low",10
"SUPPRF77733",26,50,47,68,-12,50,80,70,"Pilot 8","Pilot 8: max feedback + text",5,"low",-2
"SUPPRF77733",27,50,47,83,12,50,71,59,"Pilot 8","Pilot 8: max feedback + text",5,"low",24
"SUPPRF77733",28,50,47,41,-13,50,54,60,"Pilot 8","Pilot 8: max feedback + text",5,"low",-19
"SUPPRF77733",29,48,45,81,1,50,80,62,"Pilot 8","Pilot 8: max feedback + text",5,"low",19
"SUPPRF77733",30,49,49,38,1,50,37,63,"Pilot 8","Pilot 8: max feedback + text",5,"low",-25
"SUPPRF77733",31,49,47,75,29,50,46,55,"Pilot 8","Pilot 8: max feedback + text",5,"low",20
"SUPPRF77733",32,48,49,96,16,50,80,68,"Pilot 8","Pilot 8: max feedback + text",5,"low",28
"SUPPRF77733",33,47,47,67,-13,50,80,78,"Pilot 8","Pilot 8: max feedback + text",5,"low",-11
"SUPPRF77733",34,49,49,77,14,50,63,70,"Pilot 8","Pilot 8: max feedback + text",5,"low",7
"SUPPRF77733",35,46,48,19,-1,50,20,61,"Pilot 8","Pilot 8: max feedback + text",5,"low",-42
"SUPPRF77733",36,50,48,20,0,50,20,21,"Pilot 8","Pilot 8: max feedback + text",5,"low",-1
"SUPPRF77733",37,47,47,63,0,50,63,62,"Pilot 8","Pilot 8: max feedback + text",5,"low",1
"SUPPRF77733",38,47,48,29,0,50,29,38,"Pilot 8","Pilot 8: max feedback + text",5,"low",-9
"SUPPRF77733",39,48,48,6,-14,50,20,34,"Pilot 8","Pilot 8: max feedback + text",5,"low",-28
"SUPPRF77733",40,51,50,15,-14,50,29,25,"Pilot 8","Pilot 8: max feedback + text",5,"low",-10
"SUPPRF77733",41,47,47,55,1,50,54,59,"Pilot 8","Pilot 8: max feedback + text",5,"low",-4
"SUPPRF77733",42,48,47,37,0,28,37,50,"Pilot 8","Pilot 8: max feedback + text",5,"low",-13
"SUPPRF77733",43,46,48,33,-13,50,46,39,"Pilot 8","Pilot 8: max feedback + text",5,"low",-6
"SUPPRF77733",44,48,47,58,29,50,29,30,"Pilot 8","Pilot 8: max feedback + text",5,"low",28
"SUPPRF77733",45,47,49,35,15,50,20,59,"Pilot 8","Pilot 8: max feedback + text",5,"low",-24
"SUPPRF77733",46,47,47,94,23,50,71,65,"Pilot 8","Pilot 8: max feedback + text",5,"low",29
"SUPPRF77733",47,46,48,55,-16,50,71,72,"Pilot 8","Pilot 8: max feedback + text",5,"low",-17
"SUPPRF77733",48,49,48,16,-13,50,29,32,"Pilot 8","Pilot 8: max feedback + text",5,"low",-16
"SUPPRF77780",1,20,42,8,-12,52,20,72,"Pilot 6","Pilot 6: feedback + text",8,"high",-64
"SUPPRF77780",2,27,32,28,-1,54,29,63,"Pilot 6","Pilot 6: feedback + text",8,"high",-35
"SUPPRF77780",3,29,32,46,0,79,46,61,"Pilot 6","Pilot 6: feedback + text",8,"high",-15
"SUPPRF77780",4,30,71,80,0,96,80,71,"Pilot 6","Pilot 6: feedback + text",8,"high",9
"SUPPRF77780",5,1,98,6,-14,55,20,3,"Pilot 6","Pilot 6: feedback + text",8,"high",3
"SUPPRF77780",6,57,53,63,0,57,63,56,"Pilot 6","Pilot 6: feedback + text",8,"high",7
"SUPPRF77780",7,62,35,68,14,46,54,58,"Pilot 6","Pilot 6: feedback + text",8,"high",10
"SUPPRF77780",8,58,23,51,14,78,37,31,"Pilot 6","Pilot 6: feedback + text",8,"high",20
"SUPPRF77780",9,56,44,35,15,50,20,0,"Pilot 6","Pilot 6: feedback + text",8,"high",35
"SUPPRF77780",10,57,51,50,-13,41,63,52,"Pilot 6","Pilot 6: feedback + text",8,"high",-2
"SUPPRF77780",11,52,51,55,1,51,54,52,"Pilot 6","Pilot 6: feedback + text",8,"high",3
"SUPPRF77780",12,81,32,83,12,55,71,51,"Pilot 6","Pilot 6: feedback + text",8,"high",32
"SUPPRF77780",13,43,71,22,-15,44,37,55,"Pilot 6","Pilot 6: feedback + text",8,"high",-33
"SUPPRF77780",14,35,65,33,-13,45,46,46,"Pilot 6","Pilot 6: feedback + text",8,"high",-13
"SUPPRF77780",15,51,46,65,19,53,46,49,"Pilot 6","Pilot 6: feedback + text",8,"high",16
"SUPPRF77780",16,42,66,38,1,56,37,48,"Pilot 6","Pilot 6: feedback + text",8,"high",-10
"SUPPRF77780",17,47,57,67,-13,43,80,56,"Pilot 6","Pilot 6: feedback + text",8,"high",11
"SUPPRF77780",18,56,47,46,17,54,29,36,"Pilot 6","Pilot 6: feedback + text",8,"high",10
"SUPPRF77780",19,24,64,54,0,60,54,71,"Pilot 6","Pilot 6: feedback + text",8,"high",-17
"SUPPRF77780",20,47,65,37,17,42,20,53,"Pilot 6","Pilot 6: feedback + text",8,"high",-16
"SUPPRF77780",21,47,48,34,-12,57,46,40,"Pilot 6","Pilot 6: feedback + text",8,"high",-6
"SUPPRF77780",22,35,68,16,-13,46,29,55,"Pilot 6","Pilot 6: feedback + text",8,"high",-39
"SUPPRF77780",23,55,43,71,0,55,71,49,"Pilot 6","Pilot 6: feedback + text",8,"high",22
"SUPPRF77780",24,50,66,81,1,43,80,46,"Pilot 6","Pilot 6: feedback + text",8,"high",35
"SUPPRF77780",25,27,70,84,13,50,71,35,"Pilot 6","Pilot 6: feedback + text",8,"high",49
"SUPPRF77780",26,19,94,24,-13,30,37,31,"Pilot 6","Pilot 6: feedback + text",8,"high",-7
"SUPPRF77780",27,4,73,48,19,54,29,48,"Pilot 6","Pilot 6: feedback + text",8,"high",0
"SUPPRF77780",28,35,86,20,0,76,20,7,"Pilot 6","Pilot 6: feedback + text",8,"high",13
"SUPPRF77780",29,58,46,47,-16,43,63,48,"Pilot 6","Pilot 6: feedback + text",8,"high",-1
"SUPPRF77780",30,50,61,62,-1,59,63,42,"Pilot 6","Pilot 6: feedback + text",8,"high",20
"SUPPRF77780",31,63,47,70,-1,61,71,39,"Pilot 6","Pilot 6: feedback + text",8,"high",31
"SUPPRF77780",32,57,51,77,14,54,63,50,"Pilot 6","Pilot 6: feedback + text",8,"high",27
"SUPPRF77780",33,52,47,38,-16,54,54,98,"Pilot 6","Pilot 6: feedback + text",8,"high",-60
"SUPPRF77780",34,51,49,58,12,42,46,47,"Pilot 6","Pilot 6: feedback + text",8,"high",11
"SUPPRF77780",35,50,50,56,-15,51,71,47,"Pilot 6","Pilot 6: feedback + text",8,"high",9
"SUPPRF77780",36,41,50,55,-16,42,71,53,"Pilot 6","Pilot 6: feedback + text",8,"high",2
"SUPPRF77780",37,41,48,41,-13,50,54,56,"Pilot 6","Pilot 6: feedback + text",8,"high",-15
"SUPPRF77780",38,50,52,15,-14,44,29,52,"Pilot 6","Pilot 6: feedback + text",8,"high",-37
"SUPPRF77780",39,58,53,66,12,51,54,56,"Pilot 6","Pilot 6: feedback + text",8,"high",10
"SUPPRF77780",40,49,54,96,16,53,80,47,"Pilot 6","Pilot 6: feedback + text",8,"high",49
"SUPPRF77780",41,50,47,45,-1,47,46,52,"Pilot 6","Pilot 6: feedback + text",8,"high",-7
"SUPPRF77780",42,50,63,29,0,55,29,51,"Pilot 6","Pilot 6: feedback + text",8,"high",-22
"SUPPRF77780",43,61,52,68,-12,62,80,50,"Pilot 6","Pilot 6: feedback + text",8,"high",18
"SUPPRF77780",44,45,52,37,0,58,37,51,"Pilot 6","Pilot 6: feedback + text",8,"high",-14
"SUPPRF77780",45,45,55,19,-1,59,20,51,"Pilot 6","Pilot 6: feedback + text",8,"high",-32
"SUPPRF77780",46,54,44,49,12,42,37,54,"Pilot 6","Pilot 6: feedback + text",8,"high",-5
"SUPPRF77780",47,48,53,97,17,44,80,54,"Pilot 6","Pilot 6: feedback + text",8,"high",43
"SUPPRF77780",48,53,52,78,15,51,63,50,"Pilot 6","Pilot 6: feedback + text",8,"high",28
"SUPPRF78020",1,27,15,78,15,75,63,65,"Pilot 7","Pilot 7: bigger feedback + text",2,"low",13
"SUPPRF78020",2,28,9,49,12,79,37,30,"Pilot 7","Pilot 7: bigger feedback + text",2,"low",19
"SUPPRF78020",3,32,12,8,-12,72,20,26,"Pilot 7","Pilot 7: bigger feedback + text",2,"low",-18
"SUPPRF78020",4,30,12,33,-13,81,46,45,"Pilot 7","Pilot 7: bigger feedback + text",2,"low",-12
"SUPPRF78020",5,26,14,55,-16,38,71,39,"Pilot 7","Pilot 7: bigger feedback + text",2,"low",16
"SUPPRF78020",6,28,7,45,-1,76,46,47,"Pilot 7","Pilot 7: bigger feedback + text",2,"low",-2
"SUPPRF78020",7,26,10,84,13,71,71,70,"Pilot 7","Pilot 7: bigger feedback + text",2,"low",14
"SUPPRF78020",8,29,4,46,17,79,29,24,"Pilot 7","Pilot 7: bigger feedback + text",2,"low",22
"SUPPRF78020",9,27,6,22,-15,78,37,34,"Pilot 7","Pilot 7: bigger feedback + text",2,"low",-12
"SUPPRF78020",10,31,3,16,-13,79,29,27,"Pilot 7","Pilot 7: bigger feedback + text",2,"low",-11
"SUPPRF78020",11,29,3,97,17,78,80,75,"Pilot 7","Pilot 7: bigger feedback + text",2,"low",22
"SUPPRF78020",12,29,2,77,14,75,63,68,"Pilot 7","Pilot 7: bigger feedback + text",2,"low",9
"SUPPRF78020",13,28,2,29,0,80,29,29,"Pilot 7","Pilot 7: bigger feedback + text",2,"low",0
"SUPPRF78020",14,29,3,63,0,74,63,38,"Pilot 7","Pilot 7: bigger feedback + text",2,"low",25
"SUPPRF78020",15,30,1,28,-1,72,29,27,"Pilot 7","Pilot 7: bigger feedback + text",2,"low",1
"SUPPRF78020",16,36,2,51,14,75,37,32,"Pilot 7","Pilot 7: bigger feedback + text",2,"low",19
"SUPPRF78020",17,38,1,68,-12,76,80,74,"Pilot 7","Pilot 7: bigger feedback + text",2,"low",-6
"SUPPRF78020",18,30,1,62,-1,74,63,40,"Pilot 7","Pilot 7: bigger feedback + text",2,"low",22
"SUPPRF78020",19,32,2,34,-12,79,46,40,"Pilot 7","Pilot 7: bigger feedback + text",2,"low",-6
"SUPPRF78020",20,34,1,55,1,76,54,38,"Pilot 7","Pilot 7: bigger feedback + text",2,"low",17
"SUPPRF78020",21,34,2,48,19,77,29,25,"Pilot 7","Pilot 7: bigger feedback + text",2,"low",23
"SUPPRF78020",22,31,1,47,-16,78,63,71,"Pilot 7","Pilot 7: bigger feedback + text",2,"low",-24
"SUPPRF78020",23,31,1,67,-13,47,80,29,"Pilot 7","Pilot 7: bigger feedback + text",2,"low",38
"SUPPRF78020",24,33,2,96,16,77,80,72,"Pilot 7","Pilot 7: bigger feedback + text",2,"low",24
"SUPPRF78020",25,37,2,65,19,78,46,39,"Pilot 7","Pilot 7: bigger feedback + text",2,"low",26
"SUPPRF78020",26,36,2,66,12,71,54,52,"Pilot 7","Pilot 7: bigger feedback + text",2,"low",14
"SUPPRF78020",27,33,1,24,-13,74,37,43,"Pilot 7","Pilot 7: bigger feedback + text",2,"low",-19
"SUPPRF78020",28,36,2,50,-13,74,63,68,"Pilot 7","Pilot 7: bigger feedback + text",2,"low",-18
"SUPPRF78020",29,34,1,38,-16,23,54,49,"Pilot 7","Pilot 7: bigger feedback + text",2,"low",-11
"SUPPRF78020",30,37,1,81,1,72,80,80,"Pilot 7","Pilot 7: bigger feedback + text",2,"low",1
"SUPPRF78020",31,34,1,20,0,81,20,21,"Pilot 7","Pilot 7: bigger feedback + text",2,"low",-1
"SUPPRF78020",32,33,1,37,17,71,20,20,"Pilot 7","Pilot 7: bigger feedback + text",2,"low",17
"SUPPRF78020",33,31,3,19,-1,71,20,25,"Pilot 7","Pilot 7: bigger feedback + text",2,"low",-6
"SUPPRF78020",34,35,2,71,0,77,71,74,"Pilot 7","Pilot 7: bigger feedback + text",2,"low",-3
"SUPPRF78020",35,34,2,35,15,73,20,25,"Pilot 7","Pilot 7: bigger feedback + text",2,"low",10
"SUPPRF78020",36,34,0,15,-14,23,29,46,"Pilot 7","Pilot 7: bigger feedback + text",2,"low",-31
"SUPPRF78020",37,28,1,6,-14,79,20,26,"Pilot 7","Pilot 7: bigger feedback + text",2,"low",-20
"SUPPRF78020",38,39,1,68,14,18,54,51,"Pilot 7","Pilot 7: bigger feedback + text",2,"low",17
"SUPPRF78020",39,31,2,38,1,18,37,51,"Pilot 7","Pilot 7: bigger feedback + text",2,"low",-13
"SUPPRF78020",40,33,1,83,12,76,71,74,"Pilot 7","Pilot 7: bigger feedback + text",2,"low",9
"SUPPRF78020",41,32,2,41,-13,74,54,67,"Pilot 7","Pilot 7: bigger feedback + text",2,"low",-26
"SUPPRF78020",42,31,1,46,0,18,46,68,"Pilot 7","Pilot 7: bigger feedback + text",2,"low",-22
"SUPPRF78020",43,33,2,37,0,17,37,49,"Pilot 7","Pilot 7: bigger feedback + text",2,"low",-12
"SUPPRF78020",44,36,1,56,-15,76,71,69,"Pilot 7","Pilot 7: bigger feedback + text",2,"low",-13
"SUPPRF78020",45,34,1,54,0,75,54,63,"Pilot 7","Pilot 7: bigger feedback + text",2,"low",-9
"SUPPRF78020",46,32,1,80,0,72,80,66,"Pilot 7","Pilot 7: bigger feedback + text",2,"low",14
"SUPPRF78020",47,22,1,70,-1,75,71,74,"Pilot 7","Pilot 7: bigger feedback + text",2,"low",-4
"SUPPRF78020",48,17,1,58,12,74,46,33,"Pilot 7","Pilot 7: bigger feedback + text",2,"low",25
"SUPPRF78305",1,10,91,63,0,73,63,63,"Pilot 10","Pilot 10: bigger feedback + video",11,"high",0
"SUPPRF78305",2,31,73,47,27,89,20,18,"Pilot 10","Pilot 10: bigger feedback + video",11,"high",29
"SUPPRF78305",3,38,64,80,0,89,80,76,"Pilot 10","Pilot 10: bigger feedback + video",11,"high",4
"SUPPRF78305",4,36,68,78,24,19,54,25,"Pilot 10","Pilot 10: bigger feedback + video",11,"high",53
"SUPPRF78305",5,30,79,49,12,11,37,70,"Pilot 10","Pilot 10: bigger feedback + video",11,"high",-21
"SUPPRF78305",6,17,78,55,-16,98,71,74,"Pilot 10","Pilot 10: bigger feedback + video",11,"high",-19
"SUPPRF78305",7,74,42,46,17,86,29,40,"Pilot 10","Pilot 10: bigger feedback + video",11,"high",6
"SUPPRF78305",8,31,69,66,12,56,54,50,"Pilot 10","Pilot 10: bigger feedback + video",11,"high",16
"SUPPRF78305",9,31,67,38,1,93,37,40,"Pilot 10","Pilot 10: bigger feedback + video",11,"high",-2
"SUPPRF78305",10,11,81,33,-13,92,46,42,"Pilot 10","Pilot 10: bigger feedback + video",11,"high",-9
"SUPPRF78305",11,12,80,38,-16,85,54,62,"Pilot 10","Pilot 10: bigger feedback + video",11,"high",-24
"SUPPRF78305",12,6,88,24,-13,91,37,30,"Pilot 10","Pilot 10: bigger feedback + video",11,"high",-6
"SUPPRF78305",13,36,63,77,14,80,63,62,"Pilot 10","Pilot 10: bigger feedback + video",11,"high",15
"SUPPRF78305",14,29,77,62,-1,93,63,63,"Pilot 10","Pilot 10: bigger feedback + video",11,"high",-1
"SUPPRF78305",15,29,71,46,0,96,46,51,"Pilot 10","Pilot 10: bigger feedback + video",11,"high",-5
"SUPPRF78305",16,34,81,68,-12,84,80,73,"Pilot 10","Pilot 10: bigger feedback + video",11,"high",-5
"SUPPRF78305",17,21,74,58,12,95,46,54,"Pilot 10","Pilot 10: bigger feedback + video",11,"high",4
"SUPPRF78305",18,8,83,34,-12,93,46,52,"Pilot 10","Pilot 10: bigger feedback + video",11,"high",-18
"SUPPRF78305",19,28,67,100,20,84,80,75,"Pilot 10","Pilot 10: bigger feedback + video",11,"high",25
"SUPPRF78305",20,4,83,19,-1,87,20,20,"Pilot 10","Pilot 10: bigger feedback + video",11,"high",-1
"SUPPRF78305",21,4,88,28,-1,39,29,35,"Pilot 10","Pilot 10: bigger feedback + video",11,"high",-7
"SUPPRF78305",22,7,44,61,24,82,37,35,"Pilot 10","Pilot 10: bigger feedback + video",11,"high",26
"SUPPRF78305",23,5,46,45,-1,89,46,43,"Pilot 10","Pilot 10: bigger feedback + video",11,"high",2
"SUPPRF78305",24,1,39,15,-14,35,29,51,"Pilot 10","Pilot 10: bigger feedback + video",11,"high",-36
"SUPPRF78305",25,0,41,71,0,82,71,69,"Pilot 10","Pilot 10: bigger feedback + video",11,"high",2
"SUPPRF78305",26,4,37,50,-13,76,63,50,"Pilot 10","Pilot 10: bigger feedback + video",11,"high",0
"SUPPRF78305",27,1,41,22,-15,77,37,39,"Pilot 10","Pilot 10: bigger feedback + video",11,"high",-17
"SUPPRF78305",28,2,34,8,-12,89,20,22,"Pilot 10","Pilot 10: bigger feedback + video",11,"high",-14
"SUPPRF78305",29,0,27,88,25,35,63,62,"Pilot 10","Pilot 10: bigger feedback + video",11,"high",26
"SUPPRF78305",30,4,31,54,0,89,54,60,"Pilot 10","Pilot 10: bigger feedback + video",11,"high",-6
"SUPPRF78305",31,3,28,55,1,89,54,53,"Pilot 10","Pilot 10: bigger feedback + video",11,"high",2
"SUPPRF78305",32,2,16,75,29,61,46,50,"Pilot 10","Pilot 10: bigger feedback + video",11,"high",25
"SUPPRF78305",33,11,32,96,16,89,80,69,"Pilot 10","Pilot 10: bigger feedback + video",11,"high",27
"SUPPRF78305",34,2,26,35,15,97,20,22,"Pilot 10","Pilot 10: bigger feedback + video",11,"high",13
"SUPPRF78305",35,8,33,81,1,95,80,86,"Pilot 10","Pilot 10: bigger feedback + video",11,"high",-5
"SUPPRF78305",36,1,24,67,-13,90,80,90,"Pilot 10","Pilot 10: bigger feedback + video",11,"high",-23
"SUPPRF78305",37,2,30,58,29,92,29,23,"Pilot 10","Pilot 10: bigger feedback + video",11,"high",35
"SUPPRF78305",38,1,24,70,-1,95,71,62,"Pilot 10","Pilot 10: bigger feedback + video",11,"high",8
"SUPPRF78305",39,0,30,41,-13,82,54,54,"Pilot 10","Pilot 10: bigger feedback + video",11,"high",-13
"SUPPRF78305",40,1,22,83,12,95,71,70,"Pilot 10","Pilot 10: bigger feedback + video",11,"high",13
"SUPPRF78305",41,0,23,16,-13,77,29,27,"Pilot 10","Pilot 10: bigger feedback + video",11,"high",-11
"SUPPRF78305",42,0,22,6,-14,89,20,16,"Pilot 10","Pilot 10: bigger feedback + video",11,"high",-10
"SUPPRF78305",43,7,26,94,23,87,71,68,"Pilot 10","Pilot 10: bigger feedback + video",11,"high",26
"SUPPRF78305",44,2,20,37,0,75,37,33,"Pilot 10","Pilot 10: bigger feedback + video",11,"high",4
"SUPPRF78305",45,0,24,56,-15,93,71,74,"Pilot 10","Pilot 10: bigger feedback + video",11,"high",-18
"SUPPRF78305",46,0,24,29,0,82,29,37,"Pilot 10","Pilot 10: bigger feedback + video",11,"high",-8
"SUPPRF78305",47,0,24,20,0,88,20,20,"Pilot 10","Pilot 10: bigger feedback + video",11,"high",0
"SUPPRF78305",48,0,22,47,-16,82,63,32,"Pilot 10","Pilot 10: bigger feedback + video",11,"high",15
"SUPPRF78461_p11",1,77,19,37,0,68,37,30,"Pilot 11","Pilot 11: bigger feedback + video + socially anxious",6,"high",7
"SUPPRF78461_p11",2,68,27,56,-15,70,71,72,"Pilot 11","Pilot 11: bigger feedback + video + socially anxious",6,"high",-16
"SUPPRF78461_p11",3,70,33,24,-13,65,37,37,"Pilot 11","Pilot 11: bigger feedback + video + socially anxious",6,"high",-13
"SUPPRF78461_p11",4,69,33,41,-13,69,54,43,"Pilot 11","Pilot 11: bigger feedback + video + socially anxious",6,"high",-2
"SUPPRF78461_p11",5,63,30,34,-12,72,46,39,"Pilot 11","Pilot 11: bigger feedback + video + socially anxious",6,"high",-5
"SUPPRF78461_p11",6,83,15,96,16,81,80,77,"Pilot 11","Pilot 11: bigger feedback + video + socially anxious",6,"high",19
"SUPPRF78461_p11",7,50,49,80,0,51,80,52,"Pilot 11","Pilot 11: bigger feedback + video + socially anxious",6,"high",28
"SUPPRF78461_p11",8,67,35,45,-1,78,46,43,"Pilot 11","Pilot 11: bigger feedback + video + socially anxious",6,"high",2
"SUPPRF78461_p11",9,58,43,55,-16,77,71,78,"Pilot 11","Pilot 11: bigger feedback + video + socially anxious",6,"high",-23
"SUPPRF78461_p11",10,66,31,83,12,76,71,78,"Pilot 11","Pilot 11: bigger feedback + video + socially anxious",6,"high",5
"SUPPRF78461_p11",11,64,34,38,1,66,37,33,"Pilot 11","Pilot 11: bigger feedback + video + socially anxious",6,"high",5
"SUPPRF78461_p11",12,60,39,50,-13,63,63,67,"Pilot 11","Pilot 11: bigger feedback + video + socially anxious",6,"high",-17
"SUPPRF78461_p11",13,54,42,49,12,59,37,36,"Pilot 11","Pilot 11: bigger feedback + video + socially anxious",6,"high",13
"SUPPRF78461_p11",14,61,39,47,27,70,20,18,"Pilot 11","Pilot 11: bigger feedback + video + socially anxious",6,"high",29
"SUPPRF78461_p11",15,69,33,75,29,62,46,42,"Pilot 11","Pilot 11: bigger feedback + video + socially anxious",6,"high",33
"SUPPRF78461_p11",16,46,54,38,-16,64,54,63,"Pilot 11","Pilot 11: bigger feedback + video + socially anxious",6,"high",-25
"SUPPRF78461_p11",17,55,42,20,0,71,20,23,"Pilot 11","Pilot 11: bigger feedback + video + socially anxious",6,"high",-3
"SUPPRF78461_p11",18,50,52,22,-15,67,37,33,"Pilot 11","Pilot 11: bigger feedback + video + socially anxious",6,"high",-11
"SUPPRF78461_p11",19,59,35,94,23,60,71,75,"Pilot 11","Pilot 11: bigger feedback + video + socially anxious",6,"high",19
"SUPPRF78461_p11",20,56,38,66,12,48,54,51,"Pilot 11","Pilot 11: bigger feedback + video + socially anxious",6,"high",15
"SUPPRF78461_p11",21,60,40,58,29,68,29,23,"Pilot 11","Pilot 11: bigger feedback + video + socially anxious",6,"high",35
"SUPPRF78461_p11",22,57,41,55,1,73,54,57,"Pilot 11","Pilot 11: bigger feedback + video + socially anxious",6,"high",-2
"SUPPRF78461_p11",23,68,32,46,17,63,29,19,"Pilot 11","Pilot 11: bigger feedback + video + socially anxious",6,"high",27
"SUPPRF78461_p11",24,63,31,71,0,81,71,75,"Pilot 11","Pilot 11: bigger feedback + video + socially anxious",6,"high",-4
"SUPPRF78461_p11",25,70,22,88,25,60,63,36,"Pilot 11","Pilot 11: bigger feedback + video + socially anxious",6,"high",52
"SUPPRF78461_p11",26,62,36,61,24,69,37,35,"Pilot 11","Pilot 11: bigger feedback + video + socially anxious",6,"high",26
"SUPPRF78461_p11",27,56,37,33,-13,64,46,33,"Pilot 11","Pilot 11: bigger feedback + video + socially anxious",6,"high",0
"SUPPRF78461_p11",28,56,43,19,-1,63,20,17,"Pilot 11","Pilot 11: bigger feedback + video + socially anxious",6,"high",2
"SUPPRF78461_p11",29,58,36,78,24,70,54,44,"Pilot 11","Pilot 11: bigger feedback + video + socially anxious",6,"high",34
"SUPPRF78461_p11",30,69,27,81,1,78,80,73,"Pilot 11","Pilot 11: bigger feedback + video + socially anxious",6,"high",8
"SUPPRF78461_p11",31,66,35,77,14,71,63,74,"Pilot 11","Pilot 11: bigger feedback + video + socially anxious",6,"high",3
"SUPPRF78461_p11",32,70,32,62,-1,66,63,68,"Pilot 11","Pilot 11: bigger feedback + video + socially anxious",6,"high",-6
"SUPPRF78461_p11",33,36,60,8,-12,68,20,19,"Pilot 11","Pilot 11: bigger feedback + video + socially anxious",6,"high",-11
"SUPPRF78461_p11",34,56,45,63,0,71,63,68,"Pilot 11","Pilot 11: bigger feedback + video + socially anxious",6,"high",-5
"SUPPRF78461_p11",35,52,44,35,15,63,20,20,"Pilot 11","Pilot 11: bigger feedback + video + socially anxious",6,"high",15
"SUPPRF78461_p11",36,54,44,58,12,74,46,41,"Pilot 11","Pilot 11: bigger feedback + video + socially anxious",6,"high",17
"SUPPRF78461_p11",37,52,45,70,-1,79,71,74,"Pilot 11","Pilot 11: bigger feedback + video + socially anxious",6,"high",-4
"SUPPRF78461_p11",38,55,45,29,0,69,29,26,"Pilot 11","Pilot 11: bigger feedback + video + socially anxious",6,"high",3
"SUPPRF78461_p11",39,24,63,6,-14,66,20,18,"Pilot 11","Pilot 11: bigger feedback + video + socially anxious",6,"high",-12
"SUPPRF78461_p11",40,63,33,46,0,21,46,34,"Pilot 11","Pilot 11: bigger feedback + video + socially anxious",6,"high",12
"SUPPRF78461_p11",41,34,59,47,-16,28,63,68,"Pilot 11","Pilot 11: bigger feedback + video + socially anxious",6,"high",-21
"SUPPRF78461_p11",42,57,45,28,-1,67,29,25,"Pilot 11","Pilot 11: bigger feedback + video + socially anxious",6,"high",3
"SUPPRF78461_p11",43,35,64,67,-13,69,80,84,"Pilot 11","Pilot 11: bigger feedback + video + socially anxious",6,"high",-17
"SUPPRF78461_p11",44,28,75,15,-14,63,29,28,"Pilot 11","Pilot 11: bigger feedback + video + socially anxious",6,"high",-13
"SUPPRF78461_p11",45,25,68,68,-12,66,80,84,"Pilot 11","Pilot 11: bigger feedback + video + socially anxious",6,"high",-16
"SUPPRF78461_p11",46,41,63,54,0,37,54,57,"Pilot 11","Pilot 11: bigger feedback + video + socially anxious",6,"high",-3
"SUPPRF78461_p11",47,75,24,100,20,60,80,81,"Pilot 11","Pilot 11: bigger feedback + video + socially anxious",6,"high",19
"SUPPRF78461_p11",48,31,65,16,-13,60,29,30,"Pilot 11","Pilot 11: bigger feedback + video + socially anxious",6,"high",-14
"SUPPRF78461_p7",1,49,52,70,-1,45,71,33,"Pilot 7","Pilot 7: bigger feedback + text",10,"high",37
"SUPPRF78461_p7",2,31,65,22,-15,35,37,36,"Pilot 7","Pilot 7: bigger feedback + text",10,"high",-14
"SUPPRF78461_p7",3,36,67,47,-16,32,63,59,"Pilot 7","Pilot 7: bigger feedback + text",10,"high",-12
"SUPPRF78461_p7",4,55,35,51,14,35,37,40,"Pilot 7","Pilot 7: bigger feedback + text",10,"high",11
"SUPPRF78461_p7",5,51,51,49,12,44,37,36,"Pilot 7","Pilot 7: bigger feedback + text",10,"high",13
"SUPPRF78461_p7",6,41,56,50,-13,49,63,48,"Pilot 7","Pilot 7: bigger feedback + text",10,"high",2
"SUPPRF78461_p7",7,35,60,34,-12,34,46,61,"Pilot 7","Pilot 7: bigger feedback + text",10,"high",-27
"SUPPRF78461_p7",8,61,38,63,0,41,63,65,"Pilot 7","Pilot 7: bigger feedback + text",10,"high",-2
"SUPPRF78461_p7",9,59,47,35,15,45,20,21,"Pilot 7","Pilot 7: bigger feedback + text",10,"high",14
"SUPPRF78461_p7",10,55,39,66,12,63,54,68,"Pilot 7","Pilot 7: bigger feedback + text",10,"high",-2
"SUPPRF78461_p7",11,61,35,58,12,43,46,43,"Pilot 7","Pilot 7: bigger feedback + text",10,"high",15
"SUPPRF78461_p7",12,76,32,80,0,64,80,85,"Pilot 7","Pilot 7: bigger feedback + text",10,"high",-5
"SUPPRF78461_p7",13,46,55,20,0,49,20,17,"Pilot 7","Pilot 7: bigger feedback + text",10,"high",3
"SUPPRF78461_p7",14,11,87,6,-14,60,20,22,"Pilot 7","Pilot 7: bigger feedback + text",10,"high",-16
"SUPPRF78461_p7",15,45,45,67,-13,61,80,64,"Pilot 7","Pilot 7: bigger feedback + text",10,"high",3
"SUPPRF78461_p7",16,28,75,33,-13,51,46,48,"Pilot 7","Pilot 7: bigger feedback + text",10,"high",-15
"SUPPRF78461_p7",17,74,28,71,0,57,71,69,"Pilot 7","Pilot 7: bigger feedback + text",10,"high",2
"SUPPRF78461_p7",18,39,65,29,0,59,29,34,"Pilot 7","Pilot 7: bigger feedback + text",10,"high",-5
"SUPPRF78461_p7",19,27,66,54,0,63,54,62,"Pilot 7","Pilot 7: bigger feedback + text",10,"high",-8
"SUPPRF78461_p7",20,62,35,48,19,47,29,30,"Pilot 7","Pilot 7: bigger feedback + text",10,"high",18
"SUPPRF78461_p7",21,34,69,37,0,51,37,54,"Pilot 7","Pilot 7: bigger feedback + text",10,"high",-17
"SUPPRF78461_p7",22,15,80,55,-16,59,71,75,"Pilot 7","Pilot 7: bigger feedback + text",10,"high",-20
"SUPPRF78461_p7",23,72,32,78,15,63,63,53,"Pilot 7","Pilot 7: bigger feedback + text",10,"high",25
"SUPPRF78461_p7",24,8,79,38,-16,69,54,64,"Pilot 7","Pilot 7: bigger feedback + text",10,"high",-26
"SUPPRF78461_p7",25,81,25,68,14,59,54,56,"Pilot 7","Pilot 7: bigger feedback + text",10,"high",12
"SUPPRF78461_p7",26,96,6,97,17,67,80,81,"Pilot 7","Pilot 7: bigger feedback + text",10,"high",16
"SUPPRF78461_p7",27,11,87,15,-14,42,29,24,"Pilot 7","Pilot 7: bigger feedback + text",10,"high",-9
"SUPPRF78461_p7",28,54,51,24,-13,54,37,26,"Pilot 7","Pilot 7: bigger feedback + text",10,"high",-2
"SUPPRF78461_p7",29,50,47,28,-1,46,29,27,"Pilot 7","Pilot 7: bigger feedback + text",10,"high",1
"SUPPRF78461_p7",30,63,29,84,13,59,71,82,"Pilot 7","Pilot 7: bigger feedback + text",10,"high",2
"SUPPRF78461_p7",31,12,79,46,17,62,29,64,"Pilot 7","Pilot 7: bigger feedback + text",10,"high",-18
"SUPPRF78461_p7",32,15,83,19,-1,41,20,30,"Pilot 7","Pilot 7: bigger feedback + text",10,"high",-11
"SUPPRF78461_p7",33,59,33,37,17,71,20,18,"Pilot 7","Pilot 7: bigger feedback + text",10,"high",19
"SUPPRF78461_p7",34,65,36,77,14,24,63,72,"Pilot 7","Pilot 7: bigger feedback + text",10,"high",5
"SUPPRF78461_p7",35,76,39,83,12,35,71,68,"Pilot 7","Pilot 7: bigger feedback + text",10,"high",15
"SUPPRF78461_p7",36,31,54,8,-12,53,20,7,"Pilot 7","Pilot 7: bigger feedback + text",10,"high",1
"SUPPRF78461_p7",37,97,36,96,16,43,80,60,"Pilot 7","Pilot 7: bigger feedback + text",10,"high",36
"SUPPRF78461_p7",38,39,50,55,1,45,54,63,"Pilot 7","Pilot 7: bigger feedback + text",10,"high",-8
"SUPPRF78461_p7",39,23,63,56,-15,49,71,74,"Pilot 7","Pilot 7: bigger feedback + text",10,"high",-18
"SUPPRF78461_p7",40,34,66,41,-13,47,54,58,"Pilot 7","Pilot 7: bigger feedback + text",10,"high",-17
"SUPPRF78461_p7",41,67,50,65,19,48,46,38,"Pilot 7","Pilot 7: bigger feedback + text",10,"high",27
"SUPPRF78461_p7",42,57,44,62,-1,48,63,51,"Pilot 7","Pilot 7: bigger feedback + text",10,"high",11
"SUPPRF78461_p7",43,90,46,81,1,54,80,57,"Pilot 7","Pilot 7: bigger feedback + text",10,"high",24
"SUPPRF78461_p7",44,50,52,45,-1,49,46,43,"Pilot 7","Pilot 7: bigger feedback + text",10,"high",2
"SUPPRF78461_p7",45,52,54,38,1,54,37,34,"Pilot 7","Pilot 7: bigger feedback + text",10,"high",4
"SUPPRF78461_p7",46,52,53,46,0,49,46,48,"Pilot 7","Pilot 7: bigger feedback + text",10,"high",-2
"SUPPRF78461_p7",47,22,65,68,-12,60,80,81,"Pilot 7","Pilot 7: bigger feedback + text",10,"high",-13
"SUPPRF78461_p7",48,40,53,16,-13,49,29,22,"Pilot 7","Pilot 7: bigger feedback + text",10,"high",-6
"SUPPRF78720",1,49,51,58,29,59,29,40,"Pilot 9","Pilot 9: bigger feedback + text",7,"high",18
"SUPPRF78720",2,54,49,62,-1,49,63,61,"Pilot 9","Pilot 9: bigger feedback + text",7,"high",1
"SUPPRF78720",3,49,50,29,0,50,29,36,"Pilot 9","Pilot 9: bigger feedback + text",7,"high",-7
"SUPPRF78720",4,50,30,41,-13,49,54,43,"Pilot 9","Pilot 9: bigger feedback + text",7,"high",-2
"SUPPRF78720",5,61,28,80,0,69,80,75,"Pilot 9","Pilot 9: bigger feedback + text",7,"high",5
"SUPPRF78720",6,54,26,63,0,31,63,51,"Pilot 9","Pilot 9: bigger feedback + text",7,"high",12
"SUPPRF78720",7,54,26,96,16,51,80,37,"Pilot 9","Pilot 9: bigger feedback + text",7,"high",59
"SUPPRF78720",8,53,37,33,-13,32,46,61,"Pilot 9","Pilot 9: bigger feedback + text",7,"high",-28
"SUPPRF78720",9,51,32,19,-1,66,20,13,"Pilot 9","Pilot 9: bigger feedback + text",7,"high",6
"SUPPRF78720",10,55,51,38,1,37,37,39,"Pilot 9","Pilot 9: bigger feedback + text",7,"high",-1
"SUPPRF78720",11,50,44,58,12,54,46,61,"Pilot 9","Pilot 9: bigger feedback + text",7,"high",-3
"SUPPRF78720",12,52,49,47,27,57,20,27,"Pilot 9","Pilot 9: bigger feedback + text",7,"high",20
"SUPPRF78720",13,49,47,94,23,45,71,47,"Pilot 9","Pilot 9: bigger feedback + text",7,"high",47
"SUPPRF78720",14,50,50,70,-1,65,71,65,"Pilot 9","Pilot 9: bigger feedback + text",7,"high",5
"SUPPRF78720",15,47,51,71,0,45,71,62,"Pilot 9","Pilot 9: bigger feedback + text",7,"high",9
"SUPPRF78720",16,57,38,100,20,59,80,71,"Pilot 9","Pilot 9: bigger feedback + text",7,"high",29
"SUPPRF78720",17,49,49,77,14,44,63,58,"Pilot 9","Pilot 9: bigger feedback + text",7,"high",19
"SUPPRF78720",18,51,51,68,-12,50,80,67,"Pilot 9","Pilot 9: bigger feedback + text",7,"high",1
"SUPPRF78720",19,50,48,66,12,46,54,49,"Pilot 9","Pilot 9: bigger feedback + text",7,"high",17
"SUPPRF78720",20,49,51,83,12,67,71,52,"Pilot 9","Pilot 9: bigger feedback + text",7,"high",31
"SUPPRF78720",21,50,52,22,-15,59,37,24,"Pilot 9","Pilot 9: bigger feedback + text",7,"high",-2
"SUPPRF78720",22,50,50,75,29,29,46,37,"Pilot 9","Pilot 9: bigger feedback + text",7,"high",38
"SUPPRF78720",23,49,48,38,-16,61,54,40,"Pilot 9","Pilot 9: bigger feedback + text",7,"high",-2
"SUPPRF78720",24,49,48,46,17,27,29,49,"Pilot 9","Pilot 9: bigger feedback + text",7,"high",-3
"SUPPRF78720",25,49,50,61,24,38,37,51,"Pilot 9","Pilot 9: bigger feedback + text",7,"high",10
"SUPPRF78720",26,48,49,24,-13,31,37,44,"Pilot 9","Pilot 9: bigger feedback + text",7,"high",-20
"SUPPRF78720",27,51,51,28,-1,58,29,23,"Pilot 9","Pilot 9: bigger feedback + text",7,"high",5
"SUPPRF78720",28,50,51,37,0,49,37,39,"Pilot 9","Pilot 9: bigger feedback + text",7,"high",-2
"SUPPRF78720",29,49,51,56,-15,49,71,44,"Pilot 9","Pilot 9: bigger feedback + text",7,"high",12
"SUPPRF78720",30,49,50,15,-14,66,29,39,"Pilot 9","Pilot 9: bigger feedback + text",7,"high",-24
"SUPPRF78720",31,49,51,20,0,47,20,61,"Pilot 9","Pilot 9: bigger feedback + text",7,"high",-41
"SUPPRF78720",32,49,50,81,1,59,80,57,"Pilot 9","Pilot 9: bigger feedback + text",7,"high",24
"SUPPRF78720",33,51,51,49,12,50,37,63,"Pilot 9","Pilot 9: bigger feedback + text",7,"high",-14
"SUPPRF78720",34,49,48,6,-14,31,20,29,"Pilot 9","Pilot 9: bigger feedback + text",7,"high",-23
"SUPPRF78720",35,51,50,47,-16,44,63,56,"Pilot 9","Pilot 9: bigger feedback + text",7,"high",-9
"SUPPRF78720",36,49,50,50,-13,21,63,40,"Pilot 9","Pilot 9: bigger feedback + text",7,"high",10
"SUPPRF78720",37,50,49,67,-13,63,80,11,"Pilot 9","Pilot 9: bigger feedback + text",7,"high",56
"SUPPRF78720",38,51,51,88,25,60,63,54,"Pilot 9","Pilot 9: bigger feedback + text",7,"high",34
"SUPPRF78720",39,51,51,78,24,54,54,62,"Pilot 9","Pilot 9: bigger feedback + text",7,"high",16
"SUPPRF78720",40,52,50,35,15,21,20,49,"Pilot 9","Pilot 9: bigger feedback + text",7,"high",-14
"SUPPRF78720",41,50,50,16,-13,68,29,24,"Pilot 9","Pilot 9: bigger feedback + text",7,"high",-8
"SUPPRF78720",42,48,48,34,-12,99,46,6,"Pilot 9","Pilot 9: bigger feedback + text",7,"high",28
"SUPPRF78720",43,49,50,45,-1,42,46,34,"Pilot 9","Pilot 9: bigger feedback + text",7,"high",11
"SUPPRF78720",44,48,49,46,0,64,46,47,"Pilot 9","Pilot 9: bigger feedback + text",7,"high",-1
"SUPPRF78720",45,51,51,54,0,60,54,35,"Pilot 9","Pilot 9: bigger feedback + text",7,"high",19
"SUPPRF78720",46,49,47,55,-16,24,71,37,"Pilot 9","Pilot 9: bigger feedback + text",7,"high",18
"SUPPRF78720",47,49,50,55,1,76,54,49,"Pilot 9","Pilot 9: bigger feedback + text",7,"high",6
"SUPPRF78720",48,41,54,8,-12,64,20,43,"Pilot 9","Pilot 9: bigger feedback + text",7,"high",-35
"SUPPRF78865",1,45,70,15,-14,55,29,27,"Pilot 10","Pilot 10: bigger feedback + video",7,"high",-12
"SUPPRF78865",2,41,70,80,0,43,80,73,"Pilot 10","Pilot 10: bigger feedback + video",7,"high",7
"SUPPRF78865",3,46,67,49,12,38,37,30,"Pilot 10","Pilot 10: bigger feedback + video",7,"high",19
"SUPPRF78865",4,35,69,47,-16,60,63,65,"Pilot 10","Pilot 10: bigger feedback + video",7,"high",-18
"SUPPRF78865",5,43,72,56,-15,27,71,50,"Pilot 10","Pilot 10: bigger feedback + video",7,"high",6
"SUPPRF78865",6,42,73,50,-13,64,63,60,"Pilot 10","Pilot 10: bigger feedback + video",7,"high",-10
"SUPPRF78865",7,31,74,67,-13,63,80,79,"Pilot 10","Pilot 10: bigger feedback + video",7,"high",-12
"SUPPRF78865",8,47,82,16,-13,67,29,27,"Pilot 10","Pilot 10: bigger feedback + video",7,"high",-11
"SUPPRF78865",9,43,81,6,-14,29,20,41,"Pilot 10","Pilot 10: bigger feedback + video",7,"high",-35
"SUPPRF78865",10,40,74,61,24,39,37,33,"Pilot 10","Pilot 10: bigger feedback + video",7,"high",28
"SUPPRF78865",11,31,77,35,15,29,20,38,"Pilot 10","Pilot 10: bigger feedback + video",7,"high",-3
"SUPPRF78865",12,29,78,81,1,27,80,29,"Pilot 10","Pilot 10: bigger feedback + video",7,"high",52
"SUPPRF78865",13,43,80,88,25,11,63,50,"Pilot 10","Pilot 10: bigger feedback + video",7,"high",38
"SUPPRF78865",14,40,80,100,20,65,80,73,"Pilot 10","Pilot 10: bigger feedback + video",7,"high",27
"SUPPRF78865",15,32,78,46,17,50,29,31,"Pilot 10","Pilot 10: bigger feedback + video",7,"high",15
"SUPPRF78865",16,39,78,77,14,58,63,65,"Pilot 10","Pilot 10: bigger feedback + video",7,"high",12
"SUPPRF78865",17,41,78,34,-12,24,46,58,"Pilot 10","Pilot 10: bigger feedback + video",7,"high",-24
"SUPPRF78865",18,42,70,83,12,53,71,66,"Pilot 10","Pilot 10: bigger feedback + video",7,"high",17
"SUPPRF78865",19,37,74,55,1,60,54,56,"Pilot 10","Pilot 10: bigger feedback + video",7,"high",-1
"SUPPRF78865",20,37,80,37,0,28,37,50,"Pilot 10","Pilot 10: bigger feedback + video",7,"high",-13
"SUPPRF78865",21,36,72,75,29,26,46,59,"Pilot 10","Pilot 10: bigger feedback + video",7,"high",16
"SUPPRF78865",22,34,74,29,0,54,29,29,"Pilot 10","Pilot 10: bigger feedback + video",7,"high",0
"SUPPRF78865",23,42,67,66,12,56,54,53,"Pilot 10","Pilot 10: bigger feedback + video",7,"high",13
"SUPPRF78865",24,30,68,71,0,66,71,66,"Pilot 10","Pilot 10: bigger feedback + video",7,"high",5
"SUPPRF78865",25,35,73,20,0,12,20,50,"Pilot 10","Pilot 10: bigger feedback + video",7,"high",-30
"SUPPRF78865",26,39,74,62,-1,45,63,55,"Pilot 10","Pilot 10: bigger feedback + video",7,"high",7
"SUPPRF78865",27,26,78,96,16,31,80,54,"Pilot 10","Pilot 10: bigger feedback + video",7,"high",42
"SUPPRF78865",28,34,87,68,-12,72,80,79,"Pilot 10","Pilot 10: bigger feedback + video",7,"high",-11
"SUPPRF78865",29,25,88,78,24,59,54,51,"Pilot 10","Pilot 10: bigger feedback + video",7,"high",27
"SUPPRF78865",30,25,81,94,23,27,71,51,"Pilot 10","Pilot 10: bigger feedback + video",7,"high",43
"SUPPRF78865",31,37,83,33,-13,56,46,48,"Pilot 10","Pilot 10: bigger feedback + video",7,"high",-15
"SUPPRF78865",32,33,81,24,-13,57,37,48,"Pilot 10","Pilot 10: bigger feedback + video",7,"high",-24
"SUPPRF78865",33,25,79,63,0,50,63,63,"Pilot 10","Pilot 10: bigger feedback + video",7,"high",0
"SUPPRF78865",34,36,75,41,-13,67,54,51,"Pilot 10","Pilot 10: bigger feedback + video",7,"high",-10
"SUPPRF78865",35,29,82,54,0,63,54,51,"Pilot 10","Pilot 10: bigger feedback + video",7,"high",3
"SUPPRF78865",36,38,75,47,27,63,20,18,"Pilot 10","Pilot 10: bigger feedback + video",7,"high",29
"SUPPRF78865",37,32,79,22,-15,67,37,33,"Pilot 10","Pilot 10: bigger feedback + video",7,"high",-11
"SUPPRF78865",38,27,78,38,1,70,37,37,"Pilot 10","Pilot 10: bigger feedback + video",7,"high",1
"SUPPRF78865",39,28,60,58,29,70,29,28,"Pilot 10","Pilot 10: bigger feedback + video",7,"high",30
"SUPPRF78865",40,41,68,70,-1,50,71,36,"Pilot 10","Pilot 10: bigger feedback + video",7,"high",34
"SUPPRF78865",41,44,78,28,-1,71,29,26,"Pilot 10","Pilot 10: bigger feedback + video",7,"high",2
"SUPPRF78865",42,26,77,8,-12,66,20,15,"Pilot 10","Pilot 10: bigger feedback + video",7,"high",-7
"SUPPRF78865",43,33,73,58,12,64,46,39,"Pilot 10","Pilot 10: bigger feedback + video",7,"high",19
"SUPPRF78865",44,26,78,55,-16,23,71,50,"Pilot 10","Pilot 10: bigger feedback + video",7,"high",5
"SUPPRF78865",45,31,68,38,-16,65,54,50,"Pilot 10","Pilot 10: bigger feedback + video",7,"high",-12
"SUPPRF78865",46,23,71,45,-1,72,46,36,"Pilot 10","Pilot 10: bigger feedback + video",7,"high",9
"SUPPRF78865",47,29,74,19,-1,80,20,17,"Pilot 10","Pilot 10: bigger feedback + video",7,"high",2
"SUPPRF78865",48,27,78,46,0,75,46,40,"Pilot 10","Pilot 10: bigger feedback + video",7,"high",6
"SUPPRF79160",1,67,50,61,24,70,37,41,"Pilot 10","Pilot 10: bigger feedback + video",8,"high",20
"SUPPRF79160",2,61,34,55,1,71,54,55,"Pilot 10","Pilot 10: bigger feedback + video",8,"high",0
"SUPPRF79160",3,71,28,46,0,75,46,47,"Pilot 10","Pilot 10: bigger feedback + video",8,"high",-1
"SUPPRF79160",4,68,21,58,12,65,46,50,"Pilot 10","Pilot 10: bigger feedback + video",8,"high",8
"SUPPRF79160",5,26,8,15,-14,75,29,22,"Pilot 10","Pilot 10: bigger feedback + video",8,"high",-7
"SUPPRF79160",6,52,36,67,-13,60,80,75,"Pilot 10","Pilot 10: bigger feedback + video",8,"high",-8
"SUPPRF79160",7,50,59,54,0,55,54,40,"Pilot 10","Pilot 10: bigger feedback + video",8,"high",14
"SUPPRF79160",8,24,71,24,-13,50,37,40,"Pilot 10","Pilot 10: bigger feedback + video",8,"high",-16
"SUPPRF79160",9,39,64,37,0,60,37,27,"Pilot 10","Pilot 10: bigger feedback + video",8,"high",10
"SUPPRF79160",10,80,40,81,1,61,80,80,"Pilot 10","Pilot 10: bigger feedback + video",8,"high",1
"SUPPRF79160",11,30,67,29,0,70,29,24,"Pilot 10","Pilot 10: bigger feedback + video",8,"high",5
"SUPPRF79160",12,50,62,20,0,70,20,17,"Pilot 10","Pilot 10: bigger feedback + video",8,"high",3
"SUPPRF79160",13,52,49,28,-1,69,29,22,"Pilot 10","Pilot 10: bigger feedback + video",8,"high",6
"SUPPRF79160",14,51,50,38,1,48,37,40,"Pilot 10","Pilot 10: bigger feedback + video",8,"high",-2
"SUPPRF79160",15,68,31,78,24,38,54,44,"Pilot 10","Pilot 10: bigger feedback + video",8,"high",34
"SUPPRF79160",16,50,50,49,12,60,37,40,"Pilot 10","Pilot 10: bigger feedback + video",8,"high",9
"SUPPRF79160",17,0,69,6,-14,70,20,23,"Pilot 10","Pilot 10: bigger feedback + video",8,"high",-17
"SUPPRF79160",18,99,25,96,16,82,80,76,"Pilot 10","Pilot 10: bigger feedback + video",8,"high",20
"SUPPRF79160",19,52,49,62,-1,74,63,65,"Pilot 10","Pilot 10: bigger feedback + video",8,"high",-3
"SUPPRF79160",20,48,59,45,-1,71,46,40,"Pilot 10","Pilot 10: bigger feedback + video",8,"high",5
"SUPPRF79160",21,66,48,77,14,41,63,55,"Pilot 10","Pilot 10: bigger feedback + video",8,"high",22
"SUPPRF79160",22,51,50,66,12,50,54,60,"Pilot 10","Pilot 10: bigger feedback + video",8,"high",6
"SUPPRF79160",23,38,65,56,-15,60,71,70,"Pilot 10","Pilot 10: bigger feedback + video",8,"high",-14
"SUPPRF79160",24,51,73,35,15,50,20,15,"Pilot 10","Pilot 10: bigger feedback + video",8,"high",20
"SUPPRF79160",25,59,57,70,-1,50,71,67,"Pilot 10","Pilot 10: bigger feedback + video",8,"high",3
"SUPPRF79160",26,71,50,83,12,38,71,60,"Pilot 10","Pilot 10: bigger feedback + video",8,"high",23
"SUPPRF79160",27,14,74,8,-12,40,20,20,"Pilot 10","Pilot 10: bigger feedback + video",8,"high",-12
"SUPPRF79160",28,47,74,16,-13,70,29,25,"Pilot 10","Pilot 10: bigger feedback + video",8,"high",-9
"SUPPRF79160",29,66,72,58,29,37,29,21,"Pilot 10","Pilot 10: bigger feedback + video",8,"high",37
"SUPPRF79160",30,51,58,50,-13,71,63,68,"Pilot 10","Pilot 10: bigger feedback + video",8,"high",-18
"SUPPRF79160",31,67,34,47,27,60,20,17,"Pilot 10","Pilot 10: bigger feedback + video",8,"high",30
"SUPPRF79160",32,65,49,46,17,50,29,25,"Pilot 10","Pilot 10: bigger feedback + video",8,"high",21
"SUPPRF79160",33,26,63,38,-16,52,54,62,"Pilot 10","Pilot 10: bigger feedback + video",8,"high",-24
"SUPPRF79160",34,73,23,75,29,65,46,46,"Pilot 10","Pilot 10: bigger feedback + video",8,"high",29
"SUPPRF79160",35,52,63,63,0,30,63,55,"Pilot 10","Pilot 10: bigger feedback + video",8,"high",8
"SUPPRF79160",36,9,76,22,-15,70,37,44,"Pilot 10","Pilot 10: bigger feedback + video",8,"high",-22
"SUPPRF79160",37,33,78,19,-1,78,20,16,"Pilot 10","Pilot 10: bigger feedback + video",8,"high",3
"SUPPRF79160",38,54,34,71,0,70,71,76,"Pilot 10","Pilot 10: bigger feedback + video",8,"high",-5
"SUPPRF79160",39,50,60,41,-13,66,54,57,"Pilot 10","Pilot 10: bigger feedback + video",8,"high",-16
"SUPPRF79160",40,31,50,33,-13,31,46,50,"Pilot 10","Pilot 10: bigger feedback + video",8,"high",-17
"SUPPRF79160",41,100,18,100,20,81,80,74,"Pilot 10","Pilot 10: bigger feedback + video",8,"high",26
"SUPPRF79160",42,78,35,88,25,50,63,60,"Pilot 10","Pilot 10: bigger feedback + video",8,"high",28
"SUPPRF79160",43,100,11,94,23,71,71,83,"Pilot 10","Pilot 10: bigger feedback + video",8,"high",11
"SUPPRF79160",44,48,65,47,-16,28,63,60,"Pilot 10","Pilot 10: bigger feedback + video",8,"high",-13
"SUPPRF79160",45,26,59,68,-12,80,80,84,"Pilot 10","Pilot 10: bigger feedback + video",8,"high",-16
"SUPPRF79160",46,72,51,80,0,41,80,77,"Pilot 10","Pilot 10: bigger feedback + video",8,"high",3
"SUPPRF79160",47,34,65,34,-12,26,46,52,"Pilot 10","Pilot 10: bigger feedback + video",8,"high",-18
"SUPPRF79160",48,13,78,55,-16,59,71,78,"Pilot 10","Pilot 10: bigger feedback + video",8,"high",-23
"SUPPRF79304",1,52,46,83,12,60,71,67,"Pilot 11","Pilot 11: bigger feedback + video + socially anxious",8,"high",16
"SUPPRF79304",2,50,39,61,24,50,37,30,"Pilot 11","Pilot 11: bigger feedback + video + socially anxious",8,"high",31
"SUPPRF79304",3,50,32,28,-1,53,29,37,"Pilot 11","Pilot 11: bigger feedback + video + socially anxious",8,"high",-9
"SUPPRF79304",4,51,37,77,14,37,63,39,"Pilot 11","Pilot 11: bigger feedback + video + socially anxious",8,"high",38
"SUPPRF79304",5,47,35,33,-13,19,46,40,"Pilot 11","Pilot 11: bigger feedback + video + socially anxious",8,"high",-7
"SUPPRF79304",6,37,37,55,1,20,54,28,"Pilot 11","Pilot 11: bigger feedback + video + socially anxious",8,"high",27
"SUPPRF79304",7,51,26,8,-12,10,20,33,"Pilot 11","Pilot 11: bigger feedback + video + socially anxious",8,"high",-25
"SUPPRF79304",8,46,43,49,12,10,37,37,"Pilot 11","Pilot 11: bigger feedback + video + socially anxious",8,"high",12
"SUPPRF79304",9,43,23,75,29,21,46,38,"Pilot 11","Pilot 11: bigger feedback + video + socially anxious",8,"high",37
"SUPPRF79304",10,51,23,50,-13,9,63,59,"Pilot 11","Pilot 11: bigger feedback + video + socially anxious",8,"high",-9
"SUPPRF79304",11,52,38,41,-13,45,54,31,"Pilot 11","Pilot 11: bigger feedback + video + socially anxious",8,"high",10
"SUPPRF79304",12,30,25,24,-13,25,37,49,"Pilot 11","Pilot 11: bigger feedback + video + socially anxious",8,"high",-25
"SUPPRF79304",13,46,31,19,-1,64,20,24,"Pilot 11","Pilot 11: bigger feedback + video + socially anxious",8,"high",-5
"SUPPRF79304",14,43,31,15,-14,55,29,32,"Pilot 11","Pilot 11: bigger feedback + video + socially anxious",8,"high",-17
"SUPPRF79304",15,30,41,35,15,67,20,10,"Pilot 11","Pilot 11: bigger feedback + video + socially anxious",8,"high",25
"SUPPRF79304",16,48,32,80,0,66,80,68,"Pilot 11","Pilot 11: bigger feedback + video + socially anxious",8,"high",12
"SUPPRF79304",17,28,33,46,17,28,29,63,"Pilot 11","Pilot 11: bigger feedback + video + socially anxious",8,"high",-17
"SUPPRF79304",18,31,25,54,0,46,54,39,"Pilot 11","Pilot 11: bigger feedback + video + socially anxious",8,"high",15
"SUPPRF79304",19,21,30,68,-12,4,80,29,"Pilot 11","Pilot 11: bigger feedback + video + socially anxious",8,"high",39
"SUPPRF79304",20,32,23,56,-15,6,71,36,"Pilot 11","Pilot 11: bigger feedback + video + socially anxious",8,"high",20
"SUPPRF79304",21,27,28,37,0,57,37,25,"Pilot 11","Pilot 11: bigger feedback + video + socially anxious",8,"high",12
"SUPPRF79304",22,26,21,29,0,65,29,28,"Pilot 11","Pilot 11: bigger feedback + video + socially anxious",8,"high",1
"SUPPRF79304",23,26,32,55,-16,63,71,39,"Pilot 11","Pilot 11: bigger feedback + video + socially anxious",8,"high",16
"SUPPRF79304",24,28,26,6,-14,63,20,39,"Pilot 11","Pilot 11: bigger feedback + video + socially anxious",8,"high",-33
"SUPPRF79304",25,27,24,16,-13,48,29,19,"Pilot 11","Pilot 11: bigger feedback + video + socially anxious",8,"high",-3
"SUPPRF79304",26,31,19,70,-1,51,71,30,"Pilot 11","Pilot 11: bigger feedback + video + socially anxious",8,"high",40
"SUPPRF79304",27,19,30,96,16,34,80,50,"Pilot 11","Pilot 11: bigger feedback + video + socially anxious",8,"high",46
"SUPPRF79304",28,31,28,66,12,49,54,56,"Pilot 11","Pilot 11: bigger feedback + video + socially anxious",8,"high",10
"SUPPRF79304",29,22,17,67,-13,70,80,70,"Pilot 11","Pilot 11: bigger feedback + video + socially anxious",8,"high",-3
"SUPPRF79304",30,27,27,46,0,52,46,32,"Pilot 11","Pilot 11: bigger feedback + video + socially anxious",8,"high",14
"SUPPRF79304",31,27,18,34,-12,47,46,33,"Pilot 11","Pilot 11: bigger feedback + video + socially anxious",8,"high",1
"SUPPRF79304",32,29,28,88,25,60,63,70,"Pilot 11","Pilot 11: bigger feedback + video + socially anxious",8,"high",18
"SUPPRF79304",33,17,21,45,-1,42,46,51,"Pilot 11","Pilot 11: bigger feedback + video + socially anxious",8,"high",-6
"SUPPRF79304",34,33,27,71,0,45,71,67,"Pilot 11","Pilot 11: bigger feedback + video + socially anxious",8,"high",4
"SUPPRF79304",35,43,28,81,1,60,80,70,"Pilot 11","Pilot 11: bigger feedback + video + socially anxious",8,"high",11
"SUPPRF79304",36,28,26,58,12,68,46,46,"Pilot 11","Pilot 11: bigger feedback + video + socially anxious",8,"high",12
"SUPPRF79304",37,32,24,47,27,51,20,17,"Pilot 11","Pilot 11: bigger feedback + video + socially anxious",8,"high",30
"SUPPRF79304",38,29,29,78,24,43,54,35,"Pilot 11","Pilot 11: bigger feedback + video + socially anxious",8,"high",43
"SUPPRF79304",39,36,23,62,-1,43,63,46,"Pilot 11","Pilot 11: bigger feedback + video + socially anxious",8,"high",16
"SUPPRF79304",40,32,21,94,23,29,71,40,"Pilot 11","Pilot 11: bigger feedback + video + socially anxious",8,"high",54
"SUPPRF79304",41,23,24,58,29,48,29,16,"Pilot 11","Pilot 11: bigger feedback + video + socially anxious",8,"high",42
"SUPPRF79304",42,23,17,20,0,44,20,15,"Pilot 11","Pilot 11: bigger feedback + video + socially anxious",8,"high",5
"SUPPRF79304",43,30,13,100,20,48,80,30,"Pilot 11","Pilot 11: bigger feedback + video + socially anxious",8,"high",70
"SUPPRF79304",44,25,26,47,-16,63,63,67,"Pilot 11","Pilot 11: bigger feedback + video + socially anxious",8,"high",-20
"SUPPRF79304",45,21,30,38,1,34,37,26,"Pilot 11","Pilot 11: bigger feedback + video + socially anxious",8,"high",12
"SUPPRF79304",46,18,22,22,-15,36,37,22,"Pilot 11","Pilot 11: bigger feedback + video + socially anxious",8,"high",0
"SUPPRF79304",47,27,18,63,0,41,63,37,"Pilot 11","Pilot 11: bigger feedback + video + socially anxious",8,"high",26
"SUPPRF79304",48,25,19,38,-16,40,54,55,"Pilot 11","Pilot 11: bigger feedback + video + socially anxious",8,"high",-17
"SUPPRF79935",1,29,29,55,1,41,54,23,"Pilot 9","Pilot 9: bigger feedback + text",9,"high",32
"SUPPRF79935",2,30,26,63,0,79,63,79,"Pilot 9","Pilot 9: bigger feedback + text",9,"high",-16
"SUPPRF79935",3,30,31,33,-13,69,46,79,"Pilot 9","Pilot 9: bigger feedback + text",9,"high",-46
"SUPPRF79935",4,31,29,75,29,60,46,55,"Pilot 9","Pilot 9: bigger feedback + text",9,"high",20
"SUPPRF79935",5,31,28,71,0,73,71,79,"Pilot 9","Pilot 9: bigger feedback + text",9,"high",-8
"SUPPRF79935",6,28,30,66,12,69,54,69,"Pilot 9","Pilot 9: bigger feedback + text",9,"high",-3
"SUPPRF79935",7,33,34,88,25,70,63,66,"Pilot 9","Pilot 9: bigger feedback + text",9,"high",22
"SUPPRF79935",8,31,27,58,29,48,29,39,"Pilot 9","Pilot 9: bigger feedback + text",9,"high",19
"SUPPRF79935",9,28,31,70,-1,70,71,75,"Pilot 9","Pilot 9: bigger feedback + text",9,"high",-5
"SUPPRF79935",10,33,31,19,-1,53,20,50,"Pilot 9","Pilot 9: bigger feedback + text",9,"high",-31
"SUPPRF79935",11,31,34,46,17,46,29,48,"Pilot 9","Pilot 9: bigger feedback + text",9,"high",-2
"SUPPRF79935",12,28,28,35,15,77,20,78,"Pilot 9","Pilot 9: bigger feedback + text",9,"high",-43
"SUPPRF79935",13,22,25,45,-1,24,46,23,"Pilot 9","Pilot 9: bigger feedback + text",9,"high",22
"SUPPRF79935",14,28,29,96,16,41,80,34,"Pilot 9","Pilot 9: bigger feedback + text",9,"high",62
"SUPPRF79935",15,27,22,34,-12,80,46,85,"Pilot 9","Pilot 9: bigger feedback + text",9,"high",-51
"SUPPRF79935",16,18,19,68,-12,42,80,21,"Pilot 9","Pilot 9: bigger feedback + text",9,"high",47
"SUPPRF79935",17,22,22,6,-14,22,20,22,"Pilot 9","Pilot 9: bigger feedback + text",9,"high",-16
"SUPPRF79935",18,25,25,55,-16,27,71,27,"Pilot 9","Pilot 9: bigger feedback + text",9,"high",28
"SUPPRF79935",19,22,23,47,27,51,20,26,"Pilot 9","Pilot 9: bigger feedback + text",9,"high",21
"SUPPRF79935",20,27,26,46,0,69,46,75,"Pilot 9","Pilot 9: bigger feedback + text",9,"high",-29
"SUPPRF79935",21,31,36,77,14,51,63,32,"Pilot 9","Pilot 9: bigger feedback + text",9,"high",45
"SUPPRF79935",22,29,26,38,-16,85,54,82,"Pilot 9","Pilot 9: bigger feedback + text",9,"high",-44
"SUPPRF79935",23,34,36,41,-13,63,54,70,"Pilot 9","Pilot 9: bigger feedback + text",9,"high",-29
"SUPPRF79935",24,51,50,24,-13,73,37,67,"Pilot 9","Pilot 9: bigger feedback + text",9,"high",-43
"SUPPRF79935",25,32,35,62,-1,84,63,83,"Pilot 9","Pilot 9: bigger feedback + text",9,"high",-21
"SUPPRF79935",26,32,42,61,24,68,37,75,"Pilot 9","Pilot 9: bigger feedback + text",9,"high",-14
"SUPPRF79935",27,37,45,67,-13,55,80,41,"Pilot 9","Pilot 9: bigger feedback + text",9,"high",26
"SUPPRF79935",28,21,31,100,20,71,80,72,"Pilot 9","Pilot 9: bigger feedback + text",9,"high",28
"SUPPRF79935",29,34,33,81,1,47,80,50,"Pilot 9","Pilot 9: bigger feedback + text",9,"high",31
"SUPPRF79935",30,30,30,49,12,70,37,66,"Pilot 9","Pilot 9: bigger feedback + text",9,"high",-17
"SUPPRF79935",31,33,32,16,-13,87,29,80,"Pilot 9","Pilot 9: bigger feedback + text",9,"high",-64
"SUPPRF79935",32,34,35,56,-15,84,71,93,"Pilot 9","Pilot 9: bigger feedback + text",9,"high",-37
"SUPPRF79935",33,35,37,38,1,82,37,69,"Pilot 9","Pilot 9: bigger feedback + text",9,"high",-31
"SUPPRF79935",34,37,57,78,24,65,54,61,"Pilot 9","Pilot 9: bigger feedback + text",9,"high",17
"SUPPRF79935",35,24,28,28,-1,31,29,34,"Pilot 9","Pilot 9: bigger feedback + text",9,"high",-6
"SUPPRF79935",36,30,33,58,12,67,46,61,"Pilot 9","Pilot 9: bigger feedback + text",9,"high",-3
"SUPPRF79935",37,40,46,54,0,42,54,38,"Pilot 9","Pilot 9: bigger feedback + text",9,"high",16
"SUPPRF79935",38,23,32,37,0,40,37,39,"Pilot 9","Pilot 9: bigger feedback + text",9,"high",-2
"SUPPRF79935",39,27,27,20,0,23,20,26,"Pilot 9","Pilot 9: bigger feedback + text",9,"high",-6
"SUPPRF79935",40,31,37,83,12,35,71,32,"Pilot 9","Pilot 9: bigger feedback + text",9,"high",51
"SUPPRF79935",41,20,29,50,-13,33,63,27,"Pilot 9","Pilot 9: bigger feedback + text",9,"high",23
"SUPPRF79935",42,36,47,80,0,51,80,44,"Pilot 9","Pilot 9: bigger feedback + text",9,"high",36
"SUPPRF79935",43,30,27,47,-16,52,63,45,"Pilot 9","Pilot 9: bigger feedback + text",9,"high",2
"SUPPRF79935",44,42,38,29,0,48,29,50,"Pilot 9","Pilot 9: bigger feedback + text",9,"high",-21
"SUPPRF79935",45,32,33,15,-14,70,29,27,"Pilot 9","Pilot 9: bigger feedback + text",9,"high",-12
"SUPPRF79935",46,23,25,8,-12,87,20,95,"Pilot 9","Pilot 9: bigger feedback + text",9,"high",-87
"SUPPRF79935",47,30,31,94,23,41,71,37,"Pilot 9","Pilot 9: bigger feedback + text",9,"high",57
"SUPPRF79935",48,24,25,22,-15,29,37,25,"Pilot 9","Pilot 9: bigger feedback + text",9,"high",-3
"SUPPRF79962",1,36,0,8,-12,72,20,25,"Pilot 8","Pilot 8: max feedback + text",10,"high",-17
"SUPPRF79962",2,34,0,15,-14,77,29,30,"Pilot 8","Pilot 8: max feedback + text",10,"high",-15
"SUPPRF79962",3,34,0,55,-16,61,71,66,"Pilot 8","Pilot 8: max feedback + text",10,"high",-11
"SUPPRF79962",4,33,0,22,-15,0,37,17,"Pilot 8","Pilot 8: max feedback + text",10,"high",5
"SUPPRF79962",5,27,0,24,-13,61,37,21,"Pilot 8","Pilot 8: max feedback + text",10,"high",3
"SUPPRF79962",6,30,0,6,-14,7,20,21,"Pilot 8","Pilot 8: max feedback + text",10,"high",-15
"SUPPRF79962",7,32,0,88,25,63,63,68,"Pilot 8","Pilot 8: max feedback + text",10,"high",20
"SUPPRF79962",8,32,0,37,0,84,37,33,"Pilot 8","Pilot 8: max feedback + text",10,"high",4
"SUPPRF79962",9,31,0,29,0,5,29,58,"Pilot 8","Pilot 8: max feedback + text",10,"high",-29
"SUPPRF79962",10,29,0,67,-13,0,80,46,"Pilot 8","Pilot 8: max feedback + text",10,"high",21
"SUPPRF79962",11,29,0,41,-13,60,54,55,"Pilot 8","Pilot 8: max feedback + text",10,"high",-14
"SUPPRF79962",12,32,0,77,14,0,63,0,"Pilot 8","Pilot 8: max feedback + text",10,"high",77
"SUPPRF79962",13,39,0,78,24,36,54,51,"Pilot 8","Pilot 8: max feedback + text",10,"high",27
"SUPPRF79962",14,32,0,55,1,55,54,59,"Pilot 8","Pilot 8: max feedback + text",10,"high",-4
"SUPPRF79962",15,29,0,49,12,27,37,50,"Pilot 8","Pilot 8: max feedback + text",10,"high",-1
"SUPPRF79962",16,34,0,45,-1,62,46,26,"Pilot 8","Pilot 8: max feedback + text",10,"high",19
"SUPPRF79962",17,32,0,58,29,61,29,29,"Pilot 8","Pilot 8: max feedback + text",10,"high",29
"SUPPRF79962",18,27,0,47,-16,21,63,37,"Pilot 8","Pilot 8: max feedback + text",10,"high",10
"SUPPRF79962",19,33,0,96,16,78,80,72,"Pilot 8","Pilot 8: max feedback + text",10,"high",24
"SUPPRF79962",20,30,0,19,-1,81,20,20,"Pilot 8","Pilot 8: max feedback + text",10,"high",-1
"SUPPRF79962",21,33,0,71,0,71,71,70,"Pilot 8","Pilot 8: max feedback + text",10,"high",1
"SUPPRF79962",22,29,0,16,-13,20,29,32,"Pilot 8","Pilot 8: max feedback + text",10,"high",-16
"SUPPRF79962",23,34,0,100,20,83,80,84,"Pilot 8","Pilot 8: max feedback + text",10,"high",16
"SUPPRF79962",24,37,0,80,0,68,80,80,"Pilot 8","Pilot 8: max feedback + text",10,"high",0
"SUPPRF79962",25,30,0,68,-12,61,80,80,"Pilot 8","Pilot 8: max feedback + text",10,"high",-12
"SUPPRF79962",26,31,0,33,-13,72,46,45,"Pilot 8","Pilot 8: max feedback + text",10,"high",-12
"SUPPRF79962",27,35,0,38,-16,68,54,55,"Pilot 8","Pilot 8: max feedback + text",10,"high",-17
"SUPPRF79962",28,32,0,66,12,67,54,54,"Pilot 8","Pilot 8: max feedback + text",10,"high",12
"SUPPRF79962",29,29,0,58,12,16,46,40,"Pilot 8","Pilot 8: max feedback + text",10,"high",18
"SUPPRF79962",30,20,0,47,27,70,20,25,"Pilot 8","Pilot 8: max feedback + text",10,"high",22
"SUPPRF79962",31,17,0,34,-12,70,46,42,"Pilot 8","Pilot 8: max feedback + text",10,"high",-8
"SUPPRF79962",32,20,0,46,0,61,46,45,"Pilot 8","Pilot 8: max feedback + text",10,"high",1
"SUPPRF79962",33,24,0,46,17,77,29,26,"Pilot 8","Pilot 8: max feedback + text",10,"high",20
"SUPPRF79962",34,19,0,28,-1,65,29,23,"Pilot 8","Pilot 8: max feedback + text",10,"high",5
"SUPPRF79962",35,19,1,54,0,67,54,60,"Pilot 8","Pilot 8: max feedback + text",10,"high",-6
"SUPPRF79962",36,16,0,75,29,70,46,48,"Pilot 8","Pilot 8: max feedback + text",10,"high",27
"SUPPRF79962",37,16,0,62,-1,63,63,47,"Pilot 8","Pilot 8: max feedback + text",10,"high",15
"SUPPRF79962",38,17,0,70,-1,80,71,73,"Pilot 8","Pilot 8: max feedback + text",10,"high",-3
"SUPPRF79962",39,15,0,61,24,30,37,45,"Pilot 8","Pilot 8: max feedback + text",10,"high",16
"SUPPRF79962",40,17,0,20,0,66,20,21,"Pilot 8","Pilot 8: max feedback + text",10,"high",-1
"SUPPRF79962",41,14,0,81,1,32,80,28,"Pilot 8","Pilot 8: max feedback + text",10,"high",53
"SUPPRF79962",42,12,0,50,-13,62,63,68,"Pilot 8","Pilot 8: max feedback + text",10,"high",-18
"SUPPRF79962",43,12,0,56,-15,79,71,65,"Pilot 8","Pilot 8: max feedback + text",10,"high",-9
"SUPPRF79962",44,10,4,94,23,7,71,23,"Pilot 8","Pilot 8: max feedback + text",10,"high",71
"SUPPRF79962",45,16,0,38,1,20,37,57,"Pilot 8","Pilot 8: max feedback + text",10,"high",-19
"SUPPRF79962",46,11,0,83,12,32,71,71,"Pilot 8","Pilot 8: max feedback + text",10,"high",12
"SUPPRF79962",47,13,0,63,0,36,63,64,"Pilot 8","Pilot 8: max feedback + text",10,"high",-1
"SUPPRF79962",48,12,0,35,15,27,20,14,"Pilot 8","Pilot 8: max feedback + text",10,"high",21
"SUPPRF80130",1,21,83,55,-16,32,71,81,"Pilot 11","Pilot 11: bigger feedback + video + socially anxious",10,"high",-26
"SUPPRF80130",2,47,87,83,12,32,71,38,"Pilot 11","Pilot 11: bigger feedback + video + socially anxious",10,"high",45
"SUPPRF80130",3,61,71,77,14,10,63,51,"Pilot 11","Pilot 11: bigger feedback + video + socially anxious",10,"high",26
"SUPPRF80130",4,57,59,62,-1,3,63,69,"Pilot 11","Pilot 11: bigger feedback + video + socially anxious",10,"high",-7
"SUPPRF80130",5,35,73,19,-1,56,20,67,"Pilot 11","Pilot 11: bigger feedback + video + socially anxious",10,"high",-48
"SUPPRF80130",6,69,49,96,16,55,80,85,"Pilot 11","Pilot 11: bigger feedback + video + socially anxious",10,"high",11
"SUPPRF80130",7,56,47,58,12,42,46,44,"Pilot 11","Pilot 11: bigger feedback + video + socially anxious",10,"high",14
"SUPPRF80130",8,52,49,50,-13,58,63,40,"Pilot 11","Pilot 11: bigger feedback + video + socially anxious",10,"high",10
"SUPPRF80130",9,54,33,46,17,60,29,53,"Pilot 11","Pilot 11: bigger feedback + video + socially anxious",10,"high",-7
"SUPPRF80130",10,74,26,47,27,72,20,56,"Pilot 11","Pilot 11: bigger feedback + video + socially anxious",10,"high",-9
"SUPPRF80130",11,82,21,47,-16,57,63,56,"Pilot 11","Pilot 11: bigger feedback + video + socially anxious",10,"high",-9
"SUPPRF80130",12,35,26,6,-14,17,20,87,"Pilot 11","Pilot 11: bigger feedback + video + socially anxious",10,"high",-81
"SUPPRF80130",13,66,25,88,25,51,63,65,"Pilot 11","Pilot 11: bigger feedback + video + socially anxious",10,"high",23
"SUPPRF80130",14,75,28,20,0,57,20,55,"Pilot 11","Pilot 11: bigger feedback + video + socially anxious",10,"high",-35
"SUPPRF80130",15,60,53,75,29,38,46,58,"Pilot 11","Pilot 11: bigger feedback + video + socially anxious",10,"high",17
"SUPPRF80130",16,66,64,66,12,43,54,59,"Pilot 11","Pilot 11: bigger feedback + video + socially anxious",10,"high",7
"SUPPRF80130",17,54,38,16,-13,38,29,63,"Pilot 11","Pilot 11: bigger feedback + video + socially anxious",10,"high",-47
"SUPPRF80130",18,65,35,22,-15,36,37,56,"Pilot 11","Pilot 11: bigger feedback + video + socially anxious",10,"high",-34
"SUPPRF80130",19,64,56,34,-12,45,46,70,"Pilot 11","Pilot 11: bigger feedback + video + socially anxious",10,"high",-36
"SUPPRF80130",20,71,54,28,-1,34,29,62,"Pilot 11","Pilot 11: bigger feedback + video + socially anxious",10,"high",-34
"SUPPRF80130",21,71,34,94,23,51,71,48,"Pilot 11","Pilot 11: bigger feedback + video + socially anxious",10,"high",46
"SUPPRF80130",22,65,40,15,-14,35,29,53,"Pilot 11","Pilot 11: bigger feedback + video + socially anxious",10,"high",-38
"SUPPRF80130",23,66,31,38,-16,30,54,61,"Pilot 11","Pilot 11: bigger feedback + video + socially anxious",10,"high",-23
"SUPPRF80130",24,67,33,81,1,42,80,68,"Pilot 11","Pilot 11: bigger feedback + video + socially anxious",10,"high",13
"SUPPRF80130",25,65,33,78,24,47,54,46,"Pilot 11","Pilot 11: bigger feedback + video + socially anxious",10,"high",32
"SUPPRF80130",26,62,35,37,0,56,37,43,"Pilot 11","Pilot 11: bigger feedback + video + socially anxious",10,"high",-6
"SUPPRF80130",27,64,30,63,0,43,63,46,"Pilot 11","Pilot 11: bigger feedback + video + socially anxious",10,"high",17
"SUPPRF80130",28,59,37,24,-13,56,37,57,"Pilot 11","Pilot 11: bigger feedback + video + socially anxious",10,"high",-33
"SUPPRF80130",29,65,37,41,-13,44,54,53,"Pilot 11","Pilot 11: bigger feedback + video + socially anxious",10,"high",-12
"SUPPRF80130",30,59,27,49,12,48,37,62,"Pilot 11","Pilot 11: bigger feedback + video + socially anxious",10,"high",-13
"SUPPRF80130",31,55,33,33,-13,72,46,52,"Pilot 11","Pilot 11: bigger feedback + video + socially anxious",10,"high",-19
"SUPPRF80130",32,67,33,56,-15,39,71,53,"Pilot 11","Pilot 11: bigger feedback + video + socially anxious",10,"high",3
"SUPPRF80130",33,72,34,61,24,40,37,59,"Pilot 11","Pilot 11: bigger feedback + video + socially anxious",10,"high",2
"SUPPRF80130",34,40,44,100,20,50,80,55,"Pilot 11","Pilot 11: bigger feedback + video + socially anxious",10,"high",45
"SUPPRF80130",35,52,38,8,-12,36,20,54,"Pilot 11","Pilot 11: bigger feedback + video + socially anxious",10,"high",-46
"SUPPRF80130",36,61,26,70,-1,35,71,62,"Pilot 11","Pilot 11: bigger feedback + video + socially anxious",10,"high",8
"SUPPRF80130",37,45,40,54,0,41,54,51,"Pilot 11","Pilot 11: bigger feedback + video + socially anxious",10,"high",3
"SUPPRF80130",38,55,27,29,0,33,29,47,"Pilot 11","Pilot 11: bigger feedback + video + socially anxious",10,"high",-18
"SUPPRF80130",39,57,34,80,0,51,80,53,"Pilot 11","Pilot 11: bigger feedback + video + socially anxious",10,"high",27
"SUPPRF80130",40,66,34,35,15,47,20,72,"Pilot 11","Pilot 11: bigger feedback + video + socially anxious",10,"high",-37
"SUPPRF80130",41,55,45,38,1,32,37,56,"Pilot 11","Pilot 11: bigger feedback + video + socially anxious",10,"high",-18
"SUPPRF80130",42,65,26,71,0,36,71,38,"Pilot 11","Pilot 11: bigger feedback + video + socially anxious",10,"high",33
"SUPPRF80130",43,64,32,68,-12,37,80,63,"Pilot 11","Pilot 11: bigger feedback + video + socially anxious",10,"high",5
"SUPPRF80130",44,61,51,58,29,33,29,57,"Pilot 11","Pilot 11: bigger feedback + video + socially anxious",10,"high",1
"SUPPRF80130",45,63,46,46,0,39,46,59,"Pilot 11","Pilot 11: bigger feedback + video + socially anxious",10,"high",-13
"SUPPRF80130",46,69,32,67,-13,36,80,40,"Pilot 11","Pilot 11: bigger feedback + video + socially anxious",10,"high",27
"SUPPRF80130",47,57,31,45,-1,36,46,70,"Pilot 11","Pilot 11: bigger feedback + video + socially anxious",10,"high",-25
"SUPPRF80130",48,93,10,55,1,30,54,49,"Pilot 11","Pilot 11: bigger feedback + video + socially anxious",10,"high",6
"SUPPRF80658",1,54,24,6,-14,56,20,20,"Pilot 8","Pilot 8: max feedback + text",3,"low",-14
"SUPPRF80658",2,70,23,96,16,67,80,70,"Pilot 8","Pilot 8: max feedback + text",3,"low",26
"SUPPRF80658",3,76,22,58,29,84,29,19,"Pilot 8","Pilot 8: max feedback + text",3,"low",39
"SUPPRF80658",4,76,14,94,23,79,71,61,"Pilot 8","Pilot 8: max feedback + text",3,"low",33
"SUPPRF80658",5,66,16,15,-14,74,29,38,"Pilot 8","Pilot 8: max feedback + text",3,"low",-23
"SUPPRF80658",6,81,15,80,0,75,80,24,"Pilot 8","Pilot 8: max feedback + text",3,"low",56
"SUPPRF80658",7,74,17,68,-12,81,80,80,"Pilot 8","Pilot 8: max feedback + text",3,"low",-12
"SUPPRF80658",8,63,15,35,15,57,20,57,"Pilot 8","Pilot 8: max feedback + text",3,"low",-22
"SUPPRF80658",9,75,20,47,-16,35,63,27,"Pilot 8","Pilot 8: max feedback + text",3,"low",20
"SUPPRF80658",10,73,17,29,0,43,29,11,"Pilot 8","Pilot 8: max feedback + text",3,"low",18
"SUPPRF80658",11,83,17,49,12,11,37,54,"Pilot 8","Pilot 8: max feedback + text",3,"low",-5
"SUPPRF80658",12,59,16,8,-12,56,20,76,"Pilot 8","Pilot 8: max feedback + text",3,"low",-68
"SUPPRF80658",13,55,18,38,1,32,37,36,"Pilot 8","Pilot 8: max feedback + text",3,"low",2
"SUPPRF80658",14,58,19,34,-12,18,46,21,"Pilot 8","Pilot 8: max feedback + text",3,"low",13
"SUPPRF80658",15,62,20,61,24,29,37,23,"Pilot 8","Pilot 8: max feedback + text",3,"low",38
"SUPPRF80658",16,74,21,62,-1,43,63,45,"Pilot 8","Pilot 8: max feedback + text",3,"low",17
"SUPPRF80658",17,73,21,41,-13,32,54,41,"Pilot 8","Pilot 8: max feedback + text",3,"low",0
"SUPPRF80658",18,72,19,46,17,20,29,22,"Pilot 8","Pilot 8: max feedback + text",3,"low",24
"SUPPRF80658",19,70,22,77,14,29,63,28,"Pilot 8","Pilot 8: max feedback + text",3,"low",49
"SUPPRF80658",20,65,25,67,-13,38,80,45,"Pilot 8","Pilot 8: max feedback + text",3,"low",22
"SUPPRF80658",21,59,26,38,-16,28,54,34,"Pilot 8","Pilot 8: max feedback + text",3,"low",4
"SUPPRF80658",22,68,26,100,20,64,80,69,"Pilot 8","Pilot 8: max feedback + text",3,"low",31
"SUPPRF80658",23,68,25,56,-15,12,71,9,"Pilot 8","Pilot 8: max feedback + text",3,"low",47
"SUPPRF80658",24,74,21,58,12,25,46,46,"Pilot 8","Pilot 8: max feedback + text",3,"low",12
"SUPPRF80658",25,63,31,66,12,23,54,37,"Pilot 8","Pilot 8: max feedback + text",3,"low",29
"SUPPRF80658",26,62,24,55,-16,48,71,59,"Pilot 8","Pilot 8: max feedback + text",3,"low",-4
"SUPPRF80658",27,66,22,33,-13,31,46,22,"Pilot 8","Pilot 8: max feedback + text",3,"low",11
"SUPPRF80658",28,53,30,16,-13,31,29,49,"Pilot 8","Pilot 8: max feedback + text",3,"low",-33
"SUPPRF80658",29,56,53,37,0,31,37,30,"Pilot 8","Pilot 8: max feedback + text",3,"low",7
"SUPPRF80658",30,56,37,55,1,34,54,35,"Pilot 8","Pilot 8: max feedback + text",3,"low",20
"SUPPRF80658",31,59,33,45,-1,45,46,29,"Pilot 8","Pilot 8: max feedback + text",3,"low",16
"SUPPRF80658",32,63,33,28,-1,70,29,25,"Pilot 8","Pilot 8: max feedback + text",3,"low",3
"SUPPRF80658",33,61,34,47,27,33,20,33,"Pilot 8","Pilot 8: max feedback + text",3,"low",14
"SUPPRF80658",34,59,34,63,0,47,63,73,"Pilot 8","Pilot 8: max feedback + text",3,"low",-10
"SUPPRF80658",35,64,31,75,29,49,46,57,"Pilot 8","Pilot 8: max feedback + text",3,"low",18
"SUPPRF80658",36,65,30,54,0,36,54,28,"Pilot 8","Pilot 8: max feedback + text",3,"low",26
"SUPPRF80658",37,63,27,71,0,34,71,40,"Pilot 8","Pilot 8: max feedback + text",3,"low",31
"SUPPRF80658",38,65,26,50,-13,55,63,64,"Pilot 8","Pilot 8: max feedback + text",3,"low",-14
"SUPPRF80658",39,64,40,83,12,26,71,35,"Pilot 8","Pilot 8: max feedback + text",3,"low",48
"SUPPRF80658",40,71,33,24,-13,38,37,39,"Pilot 8","Pilot 8: max feedback + text",3,"low",-15
"SUPPRF80658",41,66,27,46,0,47,46,47,"Pilot 8","Pilot 8: max feedback + text",3,"low",-1
"SUPPRF80658",42,58,35,88,25,32,63,51,"Pilot 8","Pilot 8: max feedback + text",3,"low",37
"SUPPRF80658",43,59,31,20,0,19,20,19,"Pilot 8","Pilot 8: max feedback + text",3,"low",1
"SUPPRF80658",44,54,33,22,-15,26,37,45,"Pilot 8","Pilot 8: max feedback + text",3,"low",-23
"SUPPRF80658",45,56,30,19,-1,62,20,19,"Pilot 8","Pilot 8: max feedback + text",3,"low",0
"SUPPRF80658",46,58,34,81,1,39,80,60,"Pilot 8","Pilot 8: max feedback + text",3,"low",21
"SUPPRF80658",47,61,34,78,24,26,54,46,"Pilot 8","Pilot 8: max feedback + text",3,"low",32
"SUPPRF80658",48,65,32,70,-1,39,71,46,"Pilot 8","Pilot 8: max feedback + text",3,"low",24
"SUPPRF82563",1,36,35,71,0,37,71,39,"Pilot 10","Pilot 10: bigger feedback + video",7,"high",32
"SUPPRF82563",2,35,28,38,-16,3,54,51,"Pilot 10","Pilot 10: bigger feedback + video",7,"high",-13
"SUPPRF82563",3,34,33,46,17,59,29,35,"Pilot 10","Pilot 10: bigger feedback + video",7,"high",11
"SUPPRF82563",4,33,27,68,-12,40,80,48,"Pilot 10","Pilot 10: bigger feedback + video",7,"high",20
"SUPPRF82563",5,28,27,81,1,46,80,47,"Pilot 10","Pilot 10: bigger feedback + video",7,"high",34
"SUPPRF82563",6,36,25,34,-12,40,46,31,"Pilot 10","Pilot 10: bigger feedback + video",7,"high",3
"SUPPRF82563",7,30,21,41,-13,61,54,21,"Pilot 10","Pilot 10: bigger feedback + video",7,"high",20
"SUPPRF82563",8,30,20,58,29,56,29,31,"Pilot 10","Pilot 10: bigger feedback + video",7,"high",27
"SUPPRF82563",9,30,19,38,1,16,37,40,"Pilot 10","Pilot 10: bigger feedback + video",7,"high",-2
"SUPPRF82563",10,27,31,37,0,32,37,14,"Pilot 10","Pilot 10: bigger feedback + video",7,"high",23
"SUPPRF82563",11,40,31,77,14,62,63,33,"Pilot 10","Pilot 10: bigger feedback + video",7,"high",44
"SUPPRF82563",12,32,30,46,0,55,46,57,"Pilot 10","Pilot 10: bigger feedback + video",7,"high",-11
"SUPPRF82563",13,35,37,67,-13,72,80,56,"Pilot 10","Pilot 10: bigger feedback + video",7,"high",11
"SUPPRF82563",14,33,32,33,-13,54,46,25,"Pilot 10","Pilot 10: bigger feedback + video",7,"high",8
"SUPPRF82563",15,36,37,56,-15,50,71,28,"Pilot 10","Pilot 10: bigger feedback + video",7,"high",28
"SUPPRF82563",16,34,36,47,-16,37,63,27,"Pilot 10","Pilot 10: bigger feedback + video",7,"high",20
"SUPPRF82563",17,38,32,28,-1,43,29,27,"Pilot 10","Pilot 10: bigger feedback + video",7,"high",1
"SUPPRF82563",18,32,35,66,12,32,54,22,"Pilot 10","Pilot 10: bigger feedback + video",7,"high",44
"SUPPRF82563",19,35,31,80,0,67,80,66,"Pilot 10","Pilot 10: bigger feedback + video",7,"high",14
"SUPPRF82563",20,32,34,63,0,42,63,51,"Pilot 10","Pilot 10: bigger feedback + video",7,"high",12
"SUPPRF82563",21,32,32,54,0,13,54,38,"Pilot 10","Pilot 10: bigger feedback + video",7,"high",16
"SUPPRF82563",22,30,33,50,-13,26,63,40,"Pilot 10","Pilot 10: bigger feedback + video",7,"high",10
"SUPPRF82563",23,33,34,55,-16,9,71,31,"Pilot 10","Pilot 10: bigger feedback + video",7,"high",24
"SUPPRF82563",24,32,35,88,25,18,63,23,"Pilot 10","Pilot 10: bigger feedback + video",7,"high",65
"SUPPRF82563",25,34,43,20,0,39,20,38,"Pilot 10","Pilot 10: bigger feedback + video",7,"high",-18
"SUPPRF82563",26,32,33,24,-13,9,37,38,"Pilot 10","Pilot 10: bigger feedback + video",7,"high",-14
"SUPPRF82563",27,36,34,70,-1,18,71,43,"Pilot 10","Pilot 10: bigger feedback + video",7,"high",27
"SUPPRF82563",28,38,35,22,-15,26,37,66,"Pilot 10","Pilot 10: bigger feedback + video",7,"high",-44
"SUPPRF82563",29,36,34,61,24,63,37,48,"Pilot 10","Pilot 10: bigger feedback + video",7,"high",13
"SUPPRF82563",30,33,34,55,1,20,54,39,"Pilot 10","Pilot 10: bigger feedback + video",7,"high",16
"SUPPRF82563",31,36,42,16,-13,71,29,29,"Pilot 10","Pilot 10: bigger feedback + video",7,"high",-13
"SUPPRF82563",32,35,37,96,16,26,80,34,"Pilot 10","Pilot 10: bigger feedback + video",7,"high",62
"SUPPRF82563",33,39,39,49,12,66,37,58,"Pilot 10","Pilot 10: bigger feedback + video",7,"high",-9
"SUPPRF82563",34,37,38,94,23,33,71,35,"Pilot 10","Pilot 10: bigger feedback + video",7,"high",59
"SUPPRF82563",35,31,21,29,0,13,29,27,"Pilot 10","Pilot 10: bigger feedback + video",7,"high",2
"SUPPRF82563",36,34,35,35,15,61,20,50,"Pilot 10","Pilot 10: bigger feedback + video",7,"high",-15
"SUPPRF82563",37,29,31,47,27,13,20,15,"Pilot 10","Pilot 10: bigger feedback + video",7,"high",32
"SUPPRF82563",38,37,38,75,29,57,46,59,"Pilot 10","Pilot 10: bigger feedback + video",7,"high",16
"SUPPRF82563",39,35,38,19,-1,32,20,13,"Pilot 10","Pilot 10: bigger feedback + video",7,"high",6
"SUPPRF82563",40,30,33,83,12,9,71,30,"Pilot 10","Pilot 10: bigger feedback + video",7,"high",53
"SUPPRF82563",41,36,34,78,24,18,54,30,"Pilot 10","Pilot 10: bigger feedback + video",7,"high",48
"SUPPRF82563",42,34,36,58,12,68,46,18,"Pilot 10","Pilot 10: bigger feedback + video",7,"high",40
"SUPPRF82563",43,34,35,45,-1,54,46,63,"Pilot 10","Pilot 10: bigger feedback + video",7,"high",-18
"SUPPRF82563",44,26,43,8,-12,56,20,33,"Pilot 10","Pilot 10: bigger feedback + video",7,"high",-25
"SUPPRF82563",45,34,33,15,-14,57,29,20,"Pilot 10","Pilot 10: bigger feedback + video",7,"high",-5
"SUPPRF82563",46,25,42,6,-14,23,20,40,"Pilot 10","Pilot 10: bigger feedback + video",7,"high",-34
"SUPPRF82563",47,49,27,100,20,24,80,28,"Pilot 10","Pilot 10: bigger feedback + video",7,"high",72
"SUPPRF82563",48,39,39,62,-1,14,63,31,"Pilot 10","Pilot 10: bigger feedback + video",7,"high",31
"SUPPRF83022",1,38,77,51,14,18,37,15,"Pilot 7","Pilot 7: bigger feedback + text",10,"high",36
"SUPPRF83022",2,7,95,20,0,24,20,23,"Pilot 7","Pilot 7: bigger feedback + text",10,"high",-3
"SUPPRF83022",3,42,62,46,17,19,29,12,"Pilot 7","Pilot 7: bigger feedback + text",10,"high",34
"SUPPRF83022",4,9,85,34,-12,54,46,46,"Pilot 7","Pilot 7: bigger feedback + text",10,"high",-12
"SUPPRF83022",5,30,64,49,12,42,37,29,"Pilot 7","Pilot 7: bigger feedback + text",10,"high",20
"SUPPRF83022",6,28,33,56,-15,19,71,42,"Pilot 7","Pilot 7: bigger feedback + text",10,"high",14
"SUPPRF83022",7,51,41,66,12,32,54,20,"Pilot 7","Pilot 7: bigger feedback + text",10,"high",46
"SUPPRF83022",8,1,100,8,-12,65,20,52,"Pilot 7","Pilot 7: bigger feedback + text",10,"high",-44
"SUPPRF83022",9,69,88,38,-16,37,54,45,"Pilot 7","Pilot 7: bigger feedback + text",10,"high",-7
"SUPPRF83022",10,64,51,65,19,45,46,58,"Pilot 7","Pilot 7: bigger feedback + text",10,"high",7
"SUPPRF83022",11,34,76,16,-13,24,29,50,"Pilot 7","Pilot 7: bigger feedback + text",10,"high",-34
"SUPPRF83022",12,53,55,29,0,24,29,17,"Pilot 7","Pilot 7: bigger feedback + text",10,"high",12
"SUPPRF83022",13,46,32,33,-13,55,46,58,"Pilot 7","Pilot 7: bigger feedback + text",10,"high",-25
"SUPPRF83022",14,53,49,19,-1,41,20,44,"Pilot 7","Pilot 7: bigger feedback + text",10,"high",-25
"SUPPRF83022",15,45,34,24,-13,36,37,49,"Pilot 7","Pilot 7: bigger feedback + text",10,"high",-25
"SUPPRF83022",16,66,40,50,-13,40,63,36,"Pilot 7","Pilot 7: bigger feedback + text",10,"high",14
"SUPPRF83022",17,35,36,38,1,50,37,42,"Pilot 7","Pilot 7: bigger feedback + text",10,"high",-4
"SUPPRF83022",18,51,67,28,-1,8,29,36,"Pilot 7","Pilot 7: bigger feedback + text",10,"high",-8
"SUPPRF83022",19,49,36,37,0,45,37,56,"Pilot 7","Pilot 7: bigger feedback + text",10,"high",-19
"SUPPRF83022",20,42,61,96,16,38,80,25,"Pilot 7","Pilot 7: bigger feedback + text",10,"high",71
"SUPPRF83022",21,49,57,48,19,41,29,44,"Pilot 7","Pilot 7: bigger feedback + text",10,"high",4
"SUPPRF83022",22,38,34,45,-1,37,46,42,"Pilot 7","Pilot 7: bigger feedback + text",10,"high",3
"SUPPRF83022",23,100,65,80,0,55,80,32,"Pilot 7","Pilot 7: bigger feedback + text",10,"high",48
"SUPPRF83022",24,58,31,68,-12,71,80,36,"Pilot 7","Pilot 7: bigger feedback + text",10,"high",32
"SUPPRF83022",25,27,51,46,0,23,46,10,"Pilot 7","Pilot 7: bigger feedback + text",10,"high",36
"SUPPRF83022",26,60,40,54,0,54,54,32,"Pilot 7","Pilot 7: bigger feedback + text",10,"high",22
"SUPPRF83022",27,30,73,35,15,16,20,27,"Pilot 7","Pilot 7: bigger feedback + text",10,"high",8
"SUPPRF83022",28,79,11,67,-13,39,80,32,"Pilot 7","Pilot 7: bigger feedback + text",10,"high",35
"SUPPRF83022",29,25,41,37,17,55,20,30,"Pilot 7","Pilot 7: bigger feedback + text",10,"high",7
"SUPPRF83022",30,19,100,15,-14,74,29,63,"Pilot 7","Pilot 7: bigger feedback + text",10,"high",-48
"SUPPRF83022",31,97,25,62,-1,74,63,71,"Pilot 7","Pilot 7: bigger feedback + text",10,"high",-9
"SUPPRF83022",32,26,6,84,13,51,71,65,"Pilot 7","Pilot 7: bigger feedback + text",10,"high",19
"SUPPRF83022",33,85,27,68,14,43,54,62,"Pilot 7","Pilot 7: bigger feedback + text",10,"high",6
"SUPPRF83022",34,11,71,6,-14,82,20,9,"Pilot 7","Pilot 7: bigger feedback + text",10,"high",-3
"SUPPRF83022",35,66,40,58,12,74,46,48,"Pilot 7","Pilot 7: bigger feedback + text",10,"high",10
"SUPPRF83022",36,99,4,81,1,0,80,20,"Pilot 7","Pilot 7: bigger feedback + text",10,"high",61
"SUPPRF83022",37,88,37,71,0,59,71,75,"Pilot 7","Pilot 7: bigger feedback + text",10,"high",-4
"SUPPRF83022",38,36,83,41,-13,87,54,56,"Pilot 7","Pilot 7: bigger feedback + text",10,"high",-15
"SUPPRF83022",39,91,46,55,-16,61,71,55,"Pilot 7","Pilot 7: bigger feedback + text",10,"high",0
"SUPPRF83022",40,57,52,22,-15,80,37,44,"Pilot 7","Pilot 7: bigger feedback + text",10,"high",-22
"SUPPRF83022",41,85,37,77,14,31,63,66,"Pilot 7","Pilot 7: bigger feedback + text",10,"high",11
"SUPPRF83022",42,90,0,97,17,3,80,16,"Pilot 7","Pilot 7: bigger feedback + text",10,"high",81
"SUPPRF83022",43,98,7,78,15,74,63,55,"Pilot 7","Pilot 7: bigger feedback + text",10,"high",23
"SUPPRF83022",44,59,40,63,0,83,63,70,"Pilot 7","Pilot 7: bigger feedback + text",10,"high",-7
"SUPPRF83022",45,67,64,55,1,83,54,38,"Pilot 7","Pilot 7: bigger feedback + text",10,"high",17
"SUPPRF83022",46,32,72,47,-16,26,63,39,"Pilot 7","Pilot 7: bigger feedback + text",10,"high",8
"SUPPRF83022",47,65,66,83,12,97,71,73,"Pilot 7","Pilot 7: bigger feedback + text",10,"high",10
"SUPPRF83022",48,95,0,70,-1,30,71,64,"Pilot 7","Pilot 7: bigger feedback + text",10,"high",6
"SUPPRF83676",1,45,31,29,0,26,29,37,"Pilot 8","Pilot 8: max feedback + text",6,"high",-8
"SUPPRF83676",2,40,46,63,0,47,63,62,"Pilot 8","Pilot 8: max feedback + text",6,"high",1
"SUPPRF83676",3,48,37,68,-12,46,80,73,"Pilot 8","Pilot 8: max feedback + text",6,"high",-5
"SUPPRF83676",4,49,34,81,1,37,80,67,"Pilot 8","Pilot 8: max feedback + text",6,"high",14
"SUPPRF83676",5,50,37,88,25,47,63,61,"Pilot 8","Pilot 8: max feedback + text",6,"high",27
"SUPPRF83676",6,51,53,47,27,35,20,20,"Pilot 8","Pilot 8: max feedback + text",6,"high",27
"SUPPRF83676",7,1,99,22,-15,50,37,30,"Pilot 8","Pilot 8: max feedback + text",6,"high",-8
"SUPPRF83676",8,39,47,49,12,47,37,20,"Pilot 8","Pilot 8: max feedback + text",6,"high",29
"SUPPRF83676",9,50,47,71,0,47,71,70,"Pilot 8","Pilot 8: max feedback + text",6,"high",1
"SUPPRF83676",10,51,49,55,1,42,54,55,"Pilot 8","Pilot 8: max feedback + text",6,"high",0
"SUPPRF83676",11,44,46,70,-1,49,71,71,"Pilot 8","Pilot 8: max feedback + text",6,"high",-1
"SUPPRF83676",12,54,50,62,-1,49,63,44,"Pilot 8","Pilot 8: max feedback + text",6,"high",18
"SUPPRF83676",13,51,55,47,-16,50,63,68,"Pilot 8","Pilot 8: max feedback + text",6,"high",-21
"SUPPRF83713",1,0,2,58,29,83,29,78,"Pilot 8","Pilot 8: max feedback + text",0,"low",-20
"SUPPRF83713",2,79,1,81,1,37,80,32,"Pilot 8","Pilot 8: max feedback + text",0,"low",49
"SUPPRF83713",3,70,1,33,-13,63,46,36,"Pilot 8","Pilot 8: max feedback + text",0,"low",-3
"SUPPRF83713",4,78,0,56,-15,85,71,75,"Pilot 8","Pilot 8: max feedback + text",0,"low",-19
"SUPPRF83713",5,82,1,80,0,31,80,71,"Pilot 8","Pilot 8: max feedback + text",0,"low",9
"SUPPRF83713",6,76,1,15,-14,69,29,78,"Pilot 8","Pilot 8: max feedback + text",0,"low",-63
"SUPPRF83713",7,75,0,49,12,10,37,67,"Pilot 8","Pilot 8: max feedback + text",0,"low",-18
"SUPPRF83713",8,74,2,34,-12,15,46,60,"Pilot 8","Pilot 8: max feedback + text",0,"low",-26
"SUPPRF83713",9,73,1,29,0,30,29,74,"Pilot 8","Pilot 8: max feedback + text",0,"low",-45
"SUPPRF83713",10,72,0,50,-13,79,63,89,"Pilot 8","Pilot 8: max feedback + text",0,"low",-39
"SUPPRF83713",11,74,0,71,0,60,71,70,"Pilot 8","Pilot 8: max feedback + text",0,"low",1
"SUPPRF83713",12,74,1,22,-15,20,37,65,"Pilot 8","Pilot 8: max feedback + text",0,"low",-43
"SUPPRF83713",13,64,1,37,0,63,37,76,"Pilot 8","Pilot 8: max feedback + text",0,"low",-39
"SUPPRF83713",14,75,1,20,0,57,20,76,"Pilot 8","Pilot 8: max feedback + text",0,"low",-56
"SUPPRF83713",15,70,1,58,12,51,46,71,"Pilot 8","Pilot 8: max feedback + text",0,"low",-13
"SUPPRF83713",16,70,3,68,-12,57,80,70,"Pilot 8","Pilot 8: max feedback + text",0,"low",-2
"SUPPRF83713",17,76,1,46,17,84,29,21,"Pilot 8","Pilot 8: max feedback + text",0,"low",25
"SUPPRF83713",18,77,0,45,-1,17,46,51,"Pilot 8","Pilot 8: max feedback + text",0,"low",-6
"SUPPRF83713",19,67,1,28,-1,25,29,61,"Pilot 8","Pilot 8: max feedback + text",0,"low",-33
"SUPPRF83713",20,75,4,67,-13,80,80,71,"Pilot 8","Pilot 8: max feedback + text",0,"low",-4
"SUPPRF83713",21,77,1,6,-14,73,20,12,"Pilot 8","Pilot 8: max feedback + text",0,"low",-6
"SUPPRF83713",22,71,0,75,29,71,46,43,"Pilot 8","Pilot 8: max feedback + text",0,"low",32
"SUPPRF83713",23,73,0,19,-1,20,20,58,"Pilot 8","Pilot 8: max feedback + text",0,"low",-39
"SUPPRF83713",24,75,3,41,-13,17,54,63,"Pilot 8","Pilot 8: max feedback + text",0,"low",-22
"SUPPRF83713",25,65,0,100,20,2,80,76,"Pilot 8","Pilot 8: max feedback + text",0,"low",24
"SUPPRF83713",26,4,9,47,27,24,20,71,"Pilot 8","Pilot 8: max feedback + text",0,"low",-24
"SUPPRF83713",27,70,10,38,1,8,37,67,"Pilot 8","Pilot 8: max feedback + text",0,"low",-29
"SUPPRF83713",28,76,12,70,-1,11,71,57,"Pilot 8","Pilot 8: max feedback + text",0,"low",13
"SUPPRF83713",29,82,3,96,16,86,80,90,"Pilot 8","Pilot 8: max feedback + text",0,"low",6
"SUPPRF83713",30,78,1,24,-13,84,37,20,"Pilot 8","Pilot 8: max feedback + text",0,"low",4
"SUPPRF83713",31,80,3,88,25,70,63,37,"Pilot 8","Pilot 8: max feedback + text",0,"low",51
"SUPPRF83713",32,75,6,78,24,19,54,86,"Pilot 8","Pilot 8: max feedback + text",0,"low",-8
"SUPPRF83713",33,74,10,94,23,14,71,72,"Pilot 8","Pilot 8: max feedback + text",0,"low",22
"SUPPRF83713",34,73,4,66,12,59,54,38,"Pilot 8","Pilot 8: max feedback + text",0,"low",28
"SUPPRF83713",35,69,3,38,-16,84,54,90,"Pilot 8","Pilot 8: max feedback + text",0,"low",-52
"SUPPRF83713",36,75,0,16,-13,86,29,84,"Pilot 8","Pilot 8: max feedback + text",0,"low",-68
"SUPPRF83713",37,79,5,8,-12,24,20,70,"Pilot 8","Pilot 8: max feedback + text",0,"low",-62
"SUPPRF83713",38,78,3,62,-1,17,63,70,"Pilot 8","Pilot 8: max feedback + text",0,"low",-8
"SUPPRF83713",39,80,5,61,24,17,37,79,"Pilot 8","Pilot 8: max feedback + text",0,"low",-18
"SUPPRF83713",40,72,2,46,0,99,46,99,"Pilot 8","Pilot 8: max feedback + text",0,"low",-53
"SUPPRF83713",41,78,8,35,15,21,20,77,"Pilot 8","Pilot 8: max feedback + text",0,"low",-42
"SUPPRF83713",42,70,3,54,0,18,54,87,"Pilot 8","Pilot 8: max feedback + text",0,"low",-33
"SUPPRF83713",43,83,9,83,12,14,71,67,"Pilot 8","Pilot 8: max feedback + text",0,"low",16
"SUPPRF83713",44,70,15,77,14,12,63,88,"Pilot 8","Pilot 8: max feedback + text",0,"low",-11
"SUPPRF83713",45,76,9,55,1,6,54,46,"Pilot 8","Pilot 8: max feedback + text",0,"low",9
"SUPPRF83713",46,80,7,47,-16,77,63,47,"Pilot 8","Pilot 8: max feedback + text",0,"low",0
"SUPPRF83713",47,81,12,63,0,3,63,22,"Pilot 8","Pilot 8: max feedback + text",0,"low",41
"SUPPRF83713",48,84,10,55,-16,83,71,19,"Pilot 8","Pilot 8: max feedback + text",0,"low",36
"SUPPRF84283",1,34,45,33,-13,78,46,58,"Pilot 7","Pilot 7: bigger feedback + text",8,"high",-25
"SUPPRF84283",2,49,57,66,12,80,54,44,"Pilot 7","Pilot 7: bigger feedback + text",8,"high",22
"SUPPRF84283",3,49,59,81,1,79,80,60,"Pilot 7","Pilot 7: bigger feedback + text",8,"high",21
"SUPPRF84283",4,44,61,49,12,77,37,39,"Pilot 7","Pilot 7: bigger feedback + text",8,"high",10
"SUPPRF84283",5,45,64,56,-15,82,71,71,"Pilot 7","Pilot 7: bigger feedback + text",8,"high",-15
"SUPPRF84283",6,42,60,16,-13,53,29,57,"Pilot 7","Pilot 7: bigger feedback + text",8,"high",-41
"SUPPRF84283",7,42,65,47,-16,61,63,58,"Pilot 7","Pilot 7: bigger feedback + text",8,"high",-11
"SUPPRF84283",8,38,61,58,12,80,46,46,"Pilot 7","Pilot 7: bigger feedback + text",8,"high",12
"SUPPRF84283",9,37,62,34,-12,52,46,57,"Pilot 7","Pilot 7: bigger feedback + text",8,"high",-23
"SUPPRF84283",10,36,68,62,-1,52,63,57,"Pilot 7","Pilot 7: bigger feedback + text",8,"high",5
"SUPPRF84283",11,42,60,77,14,77,63,60,"Pilot 7","Pilot 7: bigger feedback + text",8,"high",17
"SUPPRF84283",12,34,67,38,-16,59,54,55,"Pilot 7","Pilot 7: bigger feedback + text",8,"high",-17
"SUPPRF84283",13,42,64,80,0,70,80,62,"Pilot 7","Pilot 7: bigger feedback + text",8,"high",18
"SUPPRF84283",14,35,64,97,17,90,80,83,"Pilot 7","Pilot 7: bigger feedback + text",8,"high",14
"SUPPRF84283",15,32,64,28,-1,77,29,60,"Pilot 7","Pilot 7: bigger feedback + text",8,"high",-32
"SUPPRF84283",16,38,64,22,-15,61,37,54,"Pilot 7","Pilot 7: bigger feedback + text",8,"high",-32
"SUPPRF84283",17,40,65,37,0,75,37,81,"Pilot 7","Pilot 7: bigger feedback + text",8,"high",-44
"SUPPRF84283",18,33,66,38,1,46,37,49,"Pilot 7","Pilot 7: bigger feedback + text",8,"high",-11
"SUPPRF84283",19,33,63,50,-13,68,63,75,"Pilot 7","Pilot 7: bigger feedback + text",8,"high",-25
"SUPPRF84283",20,31,68,54,0,79,54,70,"Pilot 7","Pilot 7: bigger feedback + text",8,"high",-16
"SUPPRF84283",21,39,70,55,-16,71,71,68,"Pilot 7","Pilot 7: bigger feedback + text",8,"high",-13
"SUPPRF84283",22,38,63,37,17,58,20,70,"Pilot 7","Pilot 7: bigger feedback + text",8,"high",-33
"SUPPRF84283",23,43,59,29,0,52,29,49,"Pilot 7","Pilot 7: bigger feedback + text",8,"high",-20
"SUPPRF84283",24,35,68,71,0,84,71,93,"Pilot 7","Pilot 7: bigger feedback + text",8,"high",-22
"SUPPRF84283",25,44,61,19,-1,43,20,53,"Pilot 7","Pilot 7: bigger feedback + text",8,"high",-34
"SUPPRF84283",26,40,65,78,15,81,63,61,"Pilot 7","Pilot 7: bigger feedback + text",8,"high",17
"SUPPRF84283",27,40,67,15,-14,60,29,42,"Pilot 7","Pilot 7: bigger feedback + text",8,"high",-27
"SUPPRF84283",28,40,67,68,-12,83,80,82,"Pilot 7","Pilot 7: bigger feedback + text",8,"high",-14
"SUPPRF84283",29,36,64,45,-1,66,46,56,"Pilot 7","Pilot 7: bigger feedback + text",8,"high",-11
"SUPPRF84283",30,35,68,65,19,63,46,58,"Pilot 7","Pilot 7: bigger feedback + text",8,"high",7
"SUPPRF84283",31,35,70,6,-14,83,20,65,"Pilot 7","Pilot 7: bigger feedback + text",8,"high",-59
"SUPPRF84283",32,41,64,63,0,78,63,76,"Pilot 7","Pilot 7: bigger feedback + text",8,"high",-13
"SUPPRF84283",33,39,60,24,-13,75,37,63,"Pilot 7","Pilot 7: bigger feedback + text",8,"high",-39
"SUPPRF84283",34,43,63,48,19,68,29,65,"Pilot 7","Pilot 7: bigger feedback + text",8,"high",-17
"SUPPRF84283",35,38,63,84,13,100,71,100,"Pilot 7","Pilot 7: bigger feedback + text",8,"high",-16
"SUPPRF84283",36,34,67,46,17,78,29,71,"Pilot 7","Pilot 7: bigger feedback + text",8,"high",-25
"SUPPRF84283",37,36,60,35,15,81,20,66,"Pilot 7","Pilot 7: bigger feedback + text",8,"high",-31
"SUPPRF84283",38,40,63,51,14,71,37,64,"Pilot 7","Pilot 7: bigger feedback + text",8,"high",-13
"SUPPRF84283",39,40,70,96,16,86,80,73,"Pilot 7","Pilot 7: bigger feedback + text",8,"high",23
"SUPPRF84283",40,37,72,70,-1,90,71,85,"Pilot 7","Pilot 7: bigger feedback + text",8,"high",-15
"SUPPRF84283",41,41,70,8,-12,76,20,66,"Pilot 7","Pilot 7: bigger feedback + text",8,"high",-58
"SUPPRF84283",42,32,71,41,-13,83,54,86,"Pilot 7","Pilot 7: bigger feedback + text",8,"high",-45
"SUPPRF84283",43,41,62,55,1,72,54,67,"Pilot 7","Pilot 7: bigger feedback + text",8,"high",-12
"SUPPRF84283",44,37,69,46,0,85,46,79,"Pilot 7","Pilot 7: bigger feedback + text",8,"high",-33
"SUPPRF84283",45,27,64,20,0,78,20,63,"Pilot 7","Pilot 7: bigger feedback + text",8,"high",-43
"SUPPRF84283",46,35,64,67,-13,72,80,69,"Pilot 7","Pilot 7: bigger feedback + text",8,"high",-2
"SUPPRF84283",47,40,70,83,12,92,71,75,"Pilot 7","Pilot 7: bigger feedback + text",8,"high",8
"SUPPRF84283",48,41,62,68,14,88,54,71,"Pilot 7","Pilot 7: bigger feedback + text",8,"high",-3
"SUPPRF84309",1,59,44,22,-15,72,37,41,"Pilot 11","Pilot 11: bigger feedback + video + socially anxious",9,"high",-19
"SUPPRF84309",2,52,51,58,29,65,29,26,"Pilot 11","Pilot 11: bigger feedback + video + socially anxious",9,"high",32
"SUPPRF84309",3,55,48,38,1,72,37,33,"Pilot 11","Pilot 11: bigger feedback + video + socially anxious",9,"high",5
"SUPPRF84309",4,68,41,68,-12,70,80,68,"Pilot 11","Pilot 11: bigger feedback + video + socially anxious",9,"high",0
"SUPPRF84309",5,55,51,58,12,35,46,59,"Pilot 11","Pilot 11: bigger feedback + video + socially anxious",9,"high",-1
"SUPPRF84309",6,55,37,70,-1,68,71,64,"Pilot 11","Pilot 11: bigger feedback + video + socially anxious",9,"high",6
"SUPPRF84309",7,24,46,38,-16,49,54,64,"Pilot 11","Pilot 11: bigger feedback + video + socially anxious",9,"high",-26
"SUPPRF84309",8,43,45,15,-14,70,29,26,"Pilot 11","Pilot 11: bigger feedback + video + socially anxious",9,"high",-11
"SUPPRF84309",9,49,46,55,1,28,54,45,"Pilot 11","Pilot 11: bigger feedback + video + socially anxious",9,"high",10
"SUPPRF84309",10,47,54,28,-1,64,29,47,"Pilot 11","Pilot 11: bigger feedback + video + socially anxious",9,"high",-19
"SUPPRF84309",11,46,49,24,-13,22,37,55,"Pilot 11","Pilot 11: bigger feedback + video + socially anxious",9,"high",-31
"SUPPRF84309",12,63,37,81,1,69,80,83,"Pilot 11","Pilot 11: bigger feedback + video + socially anxious",9,"high",-2
"SUPPRF84309",13,35,67,6,-14,76,20,13,"Pilot 11","Pilot 11: bigger feedback + video + socially anxious",9,"high",-7
"SUPPRF84309",14,49,46,54,0,69,54,54,"Pilot 11","Pilot 11: bigger feedback + video + socially anxious",9,"high",0
"SUPPRF84309",15,63,36,77,14,16,63,75,"Pilot 11","Pilot 11: bigger feedback + video + socially anxious",9,"high",2
"SUPPRF84309",16,44,63,33,-13,61,46,50,"Pilot 11","Pilot 11: bigger feedback + video + socially anxious",9,"high",-17
"SUPPRF84309",17,56,35,63,0,71,63,57,"Pilot 11","Pilot 11: bigger feedback + video + socially anxious",9,"high",6
"SUPPRF84309",18,47,43,71,0,45,71,44,"Pilot 11","Pilot 11: bigger feedback + video + socially anxious",9,"high",27
"SUPPRF84309",19,55,41,49,12,57,37,56,"Pilot 11","Pilot 11: bigger feedback + video + socially anxious",9,"high",-7
"SUPPRF84309",20,59,42,50,-13,70,63,60,"Pilot 11","Pilot 11: bigger feedback + video + socially anxious",9,"high",-10
"SUPPRF84309",21,66,51,80,0,75,80,84,"Pilot 11","Pilot 11: bigger feedback + video + socially anxious",9,"high",-4
"SUPPRF84309",22,35,62,19,-1,54,20,29,"Pilot 11","Pilot 11: bigger feedback + video + socially anxious",9,"high",-10
"SUPPRF84309",23,56,45,62,-1,46,63,83,"Pilot 11","Pilot 11: bigger feedback + video + socially anxious",9,"high",-21
"SUPPRF84309",24,79,24,88,25,89,63,62,"Pilot 11","Pilot 11: bigger feedback + video + socially anxious",9,"high",26
"SUPPRF84309",25,87,18,100,20,82,80,84,"Pilot 11","Pilot 11: bigger feedback + video + socially anxious",9,"high",16
"SUPPRF84309",26,23,60,45,-1,67,46,58,"Pilot 11","Pilot 11: bigger feedback + video + socially anxious",9,"high",-13
"SUPPRF84309",27,70,39,47,27,74,20,11,"Pilot 11","Pilot 11: bigger feedback + video + socially anxious",9,"high",36
"SUPPRF84309",28,29,21,34,-12,59,46,58,"Pilot 11","Pilot 11: bigger feedback + video + socially anxious",9,"high",-24
"SUPPRF84309",29,9,9,29,0,55,29,51,"Pilot 11","Pilot 11: bigger feedback + video + socially anxious",9,"high",-22
"SUPPRF84309",30,13,12,35,15,76,20,22,"Pilot 11","Pilot 11: bigger feedback + video + socially anxious",9,"high",13
"SUPPRF84309",31,15,19,37,0,72,37,39,"Pilot 11","Pilot 11: bigger feedback + video + socially anxious",9,"high",-2
"SUPPRF84309",32,17,13,16,-13,78,29,20,"Pilot 11","Pilot 11: bigger feedback + video + socially anxious",9,"high",-4
"SUPPRF84309",33,14,10,8,-12,76,20,20,"Pilot 11","Pilot 11: bigger feedback + video + socially anxious",9,"high",-12
"SUPPRF84309",34,22,17,78,24,72,54,40,"Pilot 11","Pilot 11: bigger feedback + video + socially anxious",9,"high",38
"SUPPRF84309",35,27,14,94,23,69,71,60,"Pilot 11","Pilot 11: bigger feedback + video + socially anxious",9,"high",34
"SUPPRF84309",36,38,14,75,29,56,46,48,"Pilot 11","Pilot 11: bigger feedback + video + socially anxious",9,"high",27
"SUPPRF84309",37,20,18,56,-15,67,71,56,"Pilot 11","Pilot 11: bigger feedback + video + socially anxious",9,"high",0
"SUPPRF84309",38,34,14,83,12,64,71,62,"Pilot 11","Pilot 11: bigger feedback + video + socially anxious",9,"high",21
"SUPPRF84309",39,27,13,66,12,70,54,45,"Pilot 11","Pilot 11: bigger feedback + video + socially anxious",9,"high",21
"SUPPRF84309",40,15,15,67,-13,66,80,79,"Pilot 11","Pilot 11: bigger feedback + video + socially anxious",9,"high",-12
"SUPPRF84309",41,14,13,47,-16,63,63,54,"Pilot 11","Pilot 11: bigger feedback + video + socially anxious",9,"high",-7
"SUPPRF84309",42,23,12,46,0,62,46,51,"Pilot 11","Pilot 11: bigger feedback + video + socially anxious",9,"high",-5
"SUPPRF84309",43,16,11,55,-16,65,71,67,"Pilot 11","Pilot 11: bigger feedback + video + socially anxious",9,"high",-12
"SUPPRF84309",44,34,10,41,-13,28,54,59,"Pilot 11","Pilot 11: bigger feedback + video + socially anxious",9,"high",-18
"SUPPRF84309",45,14,14,61,24,46,37,41,"Pilot 11","Pilot 11: bigger feedback + video + socially anxious",9,"high",20
"SUPPRF84309",46,17,16,46,17,77,29,11,"Pilot 11","Pilot 11: bigger feedback + video + socially anxious",9,"high",35
"SUPPRF84309",47,38,12,96,16,84,80,86,"Pilot 11","Pilot 11: bigger feedback + video + socially anxious",9,"high",10
"SUPPRF84309",48,9,12,20,0,84,20,16,"Pilot 11","Pilot 11: bigger feedback + video + socially anxious",9,"high",4
"SUPPRF85297",1,41,60,38,1,65,37,39,"Pilot 9","Pilot 9: bigger feedback + text",7,"high",-1
"SUPPRF85297",2,43,50,58,12,61,46,44,"Pilot 9","Pilot 9: bigger feedback + text",7,"high",14
"SUPPRF85297",3,43,48,46,0,66,46,50,"Pilot 9","Pilot 9: bigger feedback + text",7,"high",-4
"SUPPRF85297",4,44,52,28,-1,54,29,36,"Pilot 9","Pilot 9: bigger feedback + text",7,"high",-8
"SUPPRF85297",5,50,46,75,29,67,46,48,"Pilot 9","Pilot 9: bigger feedback + text",7,"high",27
"SUPPRF85297",6,43,62,33,-13,48,46,32,"Pilot 9","Pilot 9: bigger feedback + text",7,"high",1
"SUPPRF85297",7,52,61,62,-1,68,63,65,"Pilot 9","Pilot 9: bigger feedback + text",7,"high",-3
"SUPPRF85297",8,46,56,61,24,63,37,36,"Pilot 9","Pilot 9: bigger feedback + text",7,"high",25
"SUPPRF85297",9,46,52,35,15,58,20,23,"Pilot 9","Pilot 9: bigger feedback + text",7,"high",12
"SUPPRF85297",10,43,49,66,12,34,54,55,"Pilot 9","Pilot 9: bigger feedback + text",7,"high",11
"SUPPRF85297",11,47,49,63,0,47,63,66,"Pilot 9","Pilot 9: bigger feedback + text",7,"high",-3
"SUPPRF85297",12,49,53,50,-13,5,63,49,"Pilot 9","Pilot 9: bigger feedback + text",7,"high",1
"SUPPRF85297",13,44,47,24,-13,16,37,49,"Pilot 9","Pilot 9: bigger feedback + text",7,"high",-25
"SUPPRF85297",14,49,53,81,1,70,80,86,"Pilot 9","Pilot 9: bigger feedback + text",7,"high",-5
"SUPPRF85297",15,57,48,58,29,58,29,26,"Pilot 9","Pilot 9: bigger feedback + text",7,"high",32
"SUPPRF85297",16,32,54,38,-16,60,54,63,"Pilot 9","Pilot 9: bigger feedback + text",7,"high",-25
"SUPPRF85297",17,61,48,80,0,64,80,80,"Pilot 9","Pilot 9: bigger feedback + text",7,"high",0
"SUPPRF85297",18,52,57,29,0,44,29,24,"Pilot 9","Pilot 9: bigger feedback + text",7,"high",5
"SUPPRF85297",19,31,59,22,-15,17,37,49,"Pilot 9","Pilot 9: bigger feedback + text",7,"high",-27
"SUPPRF85297",20,39,47,19,-1,53,20,24,"Pilot 9","Pilot 9: bigger feedback + text",7,"high",-5
"SUPPRF85297",21,75,48,94,23,69,71,79,"Pilot 9","Pilot 9: bigger feedback + text",7,"high",15
"SUPPRF85297",22,52,42,55,-16,75,71,80,"Pilot 9","Pilot 9: bigger feedback + text",7,"high",-25
"SUPPRF85297",23,48,50,15,-14,65,29,18,"Pilot 9","Pilot 9: bigger feedback + text",7,"high",-3
"SUPPRF85297",24,48,40,34,-12,66,46,28,"Pilot 9","Pilot 9: bigger feedback + text",7,"high",6
"SUPPRF85297",25,47,48,83,12,50,71,51,"Pilot 9","Pilot 9: bigger feedback + text",7,"high",32
"SUPPRF85297",26,50,49,47,-16,45,63,38,"Pilot 9","Pilot 9: bigger feedback + text",7,"high",9
"SUPPRF85297",27,50,48,47,27,72,20,23,"Pilot 9","Pilot 9: bigger feedback + text",7,"high",24
"SUPPRF85297",28,50,50,96,16,24,80,53,"Pilot 9","Pilot 9: bigger feedback + text",7,"high",43
"SUPPRF85297",29,51,48,70,-1,19,71,57,"Pilot 9","Pilot 9: bigger feedback + text",7,"high",13
"SUPPRF85297",30,39,49,8,-12,64,20,26,"Pilot 9","Pilot 9: bigger feedback + text",7,"high",-18
"SUPPRF85297",31,46,50,54,0,19,54,60,"Pilot 9","Pilot 9: bigger feedback + text",7,"high",-6
"SUPPRF85297",32,48,47,37,0,48,37,26,"Pilot 9","Pilot 9: bigger feedback + text",7,"high",11
"SUPPRF85297",33,52,52,77,14,49,63,34,"Pilot 9","Pilot 9: bigger feedback + text",7,"high",43
"SUPPRF85297",34,49,56,78,24,38,54,70,"Pilot 9","Pilot 9: bigger feedback + text",7,"high",8
"SUPPRF85297",35,51,52,71,0,37,71,40,"Pilot 9","Pilot 9: bigger feedback + text",7,"high",31
"SUPPRF85297",36,33,48,6,-14,65,20,20,"Pilot 9","Pilot 9: bigger feedback + text",7,"high",-14
"SUPPRF85297",37,44,50,56,-15,51,71,80,"Pilot 9","Pilot 9: bigger feedback + text",7,"high",-24
"SUPPRF85297",38,48,51,41,-13,64,54,59,"Pilot 9","Pilot 9: bigger feedback + text",7,"high",-18
"SUPPRF85297",39,49,52,55,1,45,54,40,"Pilot 9","Pilot 9: bigger feedback + text",7,"high",15
"SUPPRF85297",40,50,52,49,12,64,37,31,"Pilot 9","Pilot 9: bigger feedback + text",7,"high",18
"SUPPRF85297",41,49,49,46,17,53,29,52,"Pilot 9","Pilot 9: bigger feedback + text",7,"high",-6
"SUPPRF85297",42,49,52,100,20,50,80,40,"Pilot 9","Pilot 9: bigger feedback + text",7,"high",60
"SUPPRF85297",43,52,53,45,-1,55,46,36,"Pilot 9","Pilot 9: bigger feedback + text",7,"high",9
"SUPPRF85297",44,52,61,68,-12,59,80,64,"Pilot 9","Pilot 9: bigger feedback + text",7,"high",4
"SUPPRF85297",45,40,42,16,-13,22,29,53,"Pilot 9","Pilot 9: bigger feedback + text",7,"high",-37
"SUPPRF85297",46,52,51,67,-13,78,80,84,"Pilot 9","Pilot 9: bigger feedback + text",7,"high",-17
"SUPPRF85297",47,48,46,20,0,51,20,51,"Pilot 9","Pilot 9: bigger feedback + text",7,"high",-31
"SUPPRF85297",48,49,48,88,25,66,63,30,"Pilot 9","Pilot 9: bigger feedback + text",7,"high",58
"SUPPRF85444",1,66,66,58,29,27,29,65,"Pilot 9","Pilot 9: bigger feedback + text",5,"low",-7
"SUPPRF85444",2,34,75,29,0,63,29,54,"Pilot 9","Pilot 9: bigger feedback + text",5,"low",-25
"SUPPRF85444",3,57,62,47,27,63,20,22,"Pilot 9","Pilot 9: bigger feedback + text",5,"low",25
"SUPPRF85444",4,84,30,88,25,79,63,83,"Pilot 9","Pilot 9: bigger feedback + text",5,"low",5
"SUPPRF85444",5,67,40,80,0,57,80,62,"Pilot 9","Pilot 9: bigger feedback + text",5,"low",18
"SUPPRF85444",6,67,26,83,12,86,71,82,"Pilot 9","Pilot 9: bigger feedback + text",5,"low",1
"SUPPRF85444",7,63,33,22,-15,71,37,33,"Pilot 9","Pilot 9: bigger feedback + text",5,"low",-11
"SUPPRF85444",8,54,27,28,-1,55,29,35,"Pilot 9","Pilot 9: bigger feedback + text",5,"low",-7
"SUPPRF85444",9,64,19,38,1,57,37,29,"Pilot 9","Pilot 9: bigger feedback + text",5,"low",9
"SUPPRF85444",10,67,8,66,12,78,54,64,"Pilot 9","Pilot 9: bigger feedback + text",5,"low",2
"SUPPRF85444",11,26,22,15,-14,66,29,32,"Pilot 9","Pilot 9: bigger feedback + text",5,"low",-17
"SUPPRF85444",12,75,4,62,-1,71,63,70,"Pilot 9","Pilot 9: bigger feedback + text",5,"low",-8
"SUPPRF85444",13,77,2,68,-12,40,80,40,"Pilot 9","Pilot 9: bigger feedback + text",5,"low",28
"SUPPRF85444",14,82,2,49,12,38,37,8,"Pilot 9","Pilot 9: bigger feedback + text",5,"low",41
"SUPPRF85444",15,67,2,70,-1,81,71,77,"Pilot 9","Pilot 9: bigger feedback + text",5,"low",-7
"SUPPRF85444",16,88,0,78,24,66,54,66,"Pilot 9","Pilot 9: bigger feedback + text",5,"low",12
"SUPPRF85444",17,94,0,35,15,51,20,19,"Pilot 9","Pilot 9: bigger feedback + text",5,"low",16
"SUPPRF85444",18,30,1,24,-13,63,37,53,"Pilot 9","Pilot 9: bigger feedback + text",5,"low",-29
"SUPPRF85444",19,50,4,41,-13,54,54,65,"Pilot 9","Pilot 9: bigger feedback + text",5,"low",-24
"SUPPRF85444",20,77,1,67,-13,79,80,79,"Pilot 9","Pilot 9: bigger feedback + text",5,"low",-12
"SUPPRF85444",21,75,0,61,24,38,37,36,"Pilot 9","Pilot 9: bigger feedback + text",5,"low",25
"SUPPRF85444",22,69,1,37,0,70,37,39,"Pilot 9","Pilot 9: bigger feedback + text",5,"low",-2
"SUPPRF85444",23,80,0,75,29,59,46,32,"Pilot 9","Pilot 9: bigger feedback + text",5,"low",43
"SUPPRF85444",24,85,0,100,20,78,80,73,"Pilot 9","Pilot 9: bigger feedback + text",5,"low",27
"SUPPRF85444",25,76,1,77,14,78,63,60,"Pilot 9","Pilot 9: bigger feedback + text",5,"low",17
"SUPPRF85444",26,77,1,63,0,83,63,66,"Pilot 9","Pilot 9: bigger feedback + text",5,"low",-3
"SUPPRF85444",27,92,1,96,16,84,80,80,"Pilot 9","Pilot 9: bigger feedback + text",5,"low",16
"SUPPRF85444",28,76,1,20,0,80,20,59,"Pilot 9","Pilot 9: bigger feedback + text",5,"low",-39
"SUPPRF85444",29,86,1,45,-1,38,46,38,"Pilot 9","Pilot 9: bigger feedback + text",5,"low",7
"SUPPRF85444",30,27,1,34,-12,72,46,50,"Pilot 9","Pilot 9: bigger feedback + text",5,"low",-16
"SUPPRF85444",31,90,0,81,1,71,80,76,"Pilot 9","Pilot 9: bigger feedback + text",5,"low",5
"SUPPRF85444",32,86,0,54,0,85,54,55,"Pilot 9","Pilot 9: bigger feedback + text",5,"low",-1
"SUPPRF85444",33,79,1,38,-16,76,54,55,"Pilot 9","Pilot 9: bigger feedback + text",5,"low",-17
"SUPPRF85444",34,80,1,58,12,72,46,56,"Pilot 9","Pilot 9: bigger feedback + text",5,"low",2
"SUPPRF85444",35,80,0,6,-14,78,20,22,"Pilot 9","Pilot 9: bigger feedback + text",5,"low",-16
"SUPPRF85444",36,62,2,56,-15,55,71,39,"Pilot 9","Pilot 9: bigger feedback + text",5,"low",17
"SUPPRF85444",37,54,2,55,1,73,54,69,"Pilot 9","Pilot 9: bigger feedback + text",5,"low",-14
"SUPPRF85444",38,77,1,71,0,27,71,51,"Pilot 9","Pilot 9: bigger feedback + text",5,"low",20
"SUPPRF85444",39,78,1,46,17,73,29,36,"Pilot 9","Pilot 9: bigger feedback + text",5,"low",10
"SUPPRF85444",40,19,0,19,-1,75,20,43,"Pilot 9","Pilot 9: bigger feedback + text",5,"low",-24
"SUPPRF85444",41,23,0,47,-16,76,63,51,"Pilot 9","Pilot 9: bigger feedback + text",5,"low",-4
"SUPPRF85444",42,92,1,94,23,78,71,55,"Pilot 9","Pilot 9: bigger feedback + text",5,"low",39
"SUPPRF85444",43,22,1,46,0,33,46,65,"Pilot 9","Pilot 9: bigger feedback + text",5,"low",-19
"SUPPRF85444",44,14,0,8,-12,67,20,51,"Pilot 9","Pilot 9: bigger feedback + text",5,"low",-43
"SUPPRF85444",45,19,1,33,-13,29,46,52,"Pilot 9","Pilot 9: bigger feedback + text",5,"low",-19
"SUPPRF85444",46,9,0,55,-16,78,71,59,"Pilot 9","Pilot 9: bigger feedback + text",5,"low",-4
"SUPPRF85444",47,10,0,50,-13,31,63,55,"Pilot 9","Pilot 9: bigger feedback + text",5,"low",-5
"SUPPRF85444",48,6,1,16,-13,37,29,51,"Pilot 9","Pilot 9: bigger feedback + text",5,"low",-35
"SUPPRF86181",1,64,17,58,12,47,46,52,"Pilot 8","Pilot 8: max feedback + text",5,"low",6
"SUPPRF86181",2,55,27,49,12,58,37,32,"Pilot 8","Pilot 8: max feedback + text",5,"low",17
"SUPPRF86181",3,27,16,6,-14,35,20,57,"Pilot 8","Pilot 8: max feedback + text",5,"low",-51
"SUPPRF86181",4,54,27,47,27,21,20,19,"Pilot 8","Pilot 8: max feedback + text",5,"low",28
"SUPPRF86181",5,41,42,38,-16,54,54,50,"Pilot 8","Pilot 8: max feedback + text",5,"low",-12
"SUPPRF86181",6,45,14,24,-13,49,37,50,"Pilot 8","Pilot 8: max feedback + text",5,"low",-26
"SUPPRF86181",7,35,36,58,29,38,29,34,"Pilot 8","Pilot 8: max feedback + text",5,"low",24
"SUPPRF86181",8,49,18,94,23,72,71,64,"Pilot 8","Pilot 8: max feedback + text",5,"low",30
"SUPPRF86181",9,20,39,34,-12,60,46,53,"Pilot 8","Pilot 8: max feedback + text",5,"low",-19
"SUPPRF86181",10,23,27,66,12,57,54,37,"Pilot 8","Pilot 8: max feedback + text",5,"low",29
"SUPPRF86181",11,44,44,41,-13,50,54,40,"Pilot 8","Pilot 8: max feedback + text",5,"low",1
"SUPPRF86181",12,35,47,50,-13,13,63,27,"Pilot 8","Pilot 8: max feedback + text",5,"low",23
"SUPPRF86181",13,23,15,16,-13,19,29,49,"Pilot 8","Pilot 8: max feedback + text",5,"low",-33
"SUPPRF86181",14,58,44,67,-13,55,80,35,"Pilot 8","Pilot 8: max feedback + text",5,"low",32
"SUPPRF86181",15,60,27,68,-12,28,80,43,"Pilot 8","Pilot 8: max feedback + text",5,"low",25
"SUPPRF86181",16,78,22,46,17,68,29,79,"Pilot 8","Pilot 8: max feedback + text",5,"low",-33
"SUPPRF86181",17,73,31,45,-1,61,46,49,"Pilot 8","Pilot 8: max feedback + text",5,"low",-4
"SUPPRF86181",18,75,26,100,20,28,80,52,"Pilot 8","Pilot 8: max feedback + text",5,"low",48
"SUPPRF86181",19,49,20,46,0,53,46,57,"Pilot 8","Pilot 8: max feedback + text",5,"low",-11
"SUPPRF86181",20,36,24,29,0,55,29,65,"Pilot 8","Pilot 8: max feedback + text",5,"low",-36
"SUPPRF86181",21,75,12,80,0,79,80,70,"Pilot 8","Pilot 8: max feedback + text",5,"low",10
"SUPPRF86181",22,61,26,56,-15,74,71,64,"Pilot 8","Pilot 8: max feedback + text",5,"low",-8
"SUPPRF86181",23,61,21,38,1,64,37,51,"Pilot 8","Pilot 8: max feedback + text",5,"low",-13
"SUPPRF86181",24,60,28,15,-14,28,29,50,"Pilot 8","Pilot 8: max feedback + text",5,"low",-35
"SUPPRF86181",25,38,35,37,0,50,37,40,"Pilot 8","Pilot 8: max feedback + text",5,"low",-3
"SUPPRF86181",26,57,30,35,15,30,20,66,"Pilot 8","Pilot 8: max feedback + text",5,"low",-31
"SUPPRF86181",27,57,32,62,-1,47,63,41,"Pilot 8","Pilot 8: max feedback + text",5,"low",21
"SUPPRF86181",28,66,23,55,1,70,54,58,"Pilot 8","Pilot 8: max feedback + text",5,"low",-3
"SUPPRF86181",29,53,55,33,-13,55,46,47,"Pilot 8","Pilot 8: max feedback + text",5,"low",-14
"SUPPRF86181",30,57,31,61,24,53,37,46,"Pilot 8","Pilot 8: max feedback + text",5,"low",15
"SUPPRF86181",31,49,56,55,-16,70,71,58,"Pilot 8","Pilot 8: max feedback + text",5,"low",-3
"SUPPRF86181",32,60,29,96,16,81,80,72,"Pilot 8","Pilot 8: max feedback + text",5,"low",24
"SUPPRF86181",33,63,22,54,0,73,54,65,"Pilot 8","Pilot 8: max feedback + text",5,"low",-11
"SUPPRF86181",34,65,26,81,1,77,80,84,"Pilot 8","Pilot 8: max feedback + text",5,"low",-3
"SUPPRF86181",35,51,21,19,-1,27,20,72,"Pilot 8","Pilot 8: max feedback + text",5,"low",-53
"SUPPRF86181",36,74,21,28,-1,70,29,32,"Pilot 8","Pilot 8: max feedback + text",5,"low",-4
"SUPPRF86181",37,57,24,22,-15,64,37,54,"Pilot 8","Pilot 8: max feedback + text",5,"low",-32
"SUPPRF86181",38,64,64,47,-16,61,63,41,"Pilot 8","Pilot 8: max feedback + text",5,"low",6
"SUPPRF86181",39,60,32,78,24,81,54,54,"Pilot 8","Pilot 8: max feedback + text",5,"low",24
"SUPPRF86181",40,79,26,20,0,28,20,39,"Pilot 8","Pilot 8: max feedback + text",5,"low",-19
"SUPPRF86181",41,62,29,75,29,73,46,53,"Pilot 8","Pilot 8: max feedback + text",5,"low",22
"SUPPRF86181",42,66,62,71,0,52,71,51,"Pilot 8","Pilot 8: max feedback + text",5,"low",20
"SUPPRF86181",43,63,32,70,-1,59,71,28,"Pilot 8","Pilot 8: max feedback + text",5,"low",42
"SUPPRF86181",44,67,19,77,14,61,63,64,"Pilot 8","Pilot 8: max feedback + text",5,"low",13
"SUPPRF86181",45,72,21,8,-12,84,20,21,"Pilot 8","Pilot 8: max feedback + text",5,"low",-13
"SUPPRF86181",46,66,26,83,12,63,71,68,"Pilot 8","Pilot 8: max feedback + text",5,"low",15
"SUPPRF86181",47,79,23,88,25,76,63,71,"Pilot 8","Pilot 8: max feedback + text",5,"low",17
"SUPPRF86181",48,75,27,63,0,20,63,58,"Pilot 8","Pilot 8: max feedback + text",5,"low",5
"SUPPRF86350",1,49,68,61,24,45,37,36,"Pilot 9","Pilot 9: bigger feedback + text",11,"high",25
"SUPPRF86350",2,68,37,94,23,67,71,81,"Pilot 9","Pilot 9: bigger feedback + text",11,"high",13
"SUPPRF86350",3,29,52,55,-16,73,71,73,"Pilot 9","Pilot 9: bigger feedback + text",11,"high",-18
"SUPPRF86350",4,65,37,78,24,53,54,60,"Pilot 9","Pilot 9: bigger feedback + text",11,"high",18
"SUPPRF86350",5,48,44,20,0,29,20,33,"Pilot 9","Pilot 9: bigger feedback + text",11,"high",-13
"SUPPRF86350",6,30,51,22,-15,36,37,50,"Pilot 9","Pilot 9: bigger feedback + text",11,"high",-28
"SUPPRF86350",7,58,47,71,0,71,71,83,"Pilot 9","Pilot 9: bigger feedback + text",11,"high",-12
"SUPPRF86350",8,27,12,8,-12,64,20,62,"Pilot 9","Pilot 9: bigger feedback + text",11,"high",-54
"SUPPRF86350",9,53,42,62,-1,41,63,63,"Pilot 9","Pilot 9: bigger feedback + text",11,"high",-1
"SUPPRF86350",10,65,51,16,-13,43,29,30,"Pilot 9","Pilot 9: bigger feedback + text",11,"high",-14
"SUPPRF86350",11,99,21,100,20,18,80,37,"Pilot 9","Pilot 9: bigger feedback + text",11,"high",63
"SUPPRF86350",12,55,60,58,12,54,46,46,"Pilot 9","Pilot 9: bigger feedback + text",11,"high",12
"SUPPRF86350",13,51,23,88,25,9,63,58,"Pilot 9","Pilot 9: bigger feedback + text",11,"high",30
"SUPPRF86350",14,76,25,81,1,67,80,77,"Pilot 9","Pilot 9: bigger feedback + text",11,"high",4
"SUPPRF86350",15,50,30,41,-13,67,54,64,"Pilot 9","Pilot 9: bigger feedback + text",11,"high",-23
"SUPPRF86350",16,50,50,34,-12,32,46,55,"Pilot 9","Pilot 9: bigger feedback + text",11,"high",-21
"SUPPRF86350",17,76,50,77,14,15,63,50,"Pilot 9","Pilot 9: bigger feedback + text",11,"high",27
"SUPPRF86350",18,30,42,70,-1,75,71,76,"Pilot 9","Pilot 9: bigger feedback + text",11,"high",-6
"SUPPRF86350",19,51,53,46,17,16,29,27,"Pilot 9","Pilot 9: bigger feedback + text",11,"high",19
"SUPPRF86350",20,52,56,46,0,66,46,34,"Pilot 9","Pilot 9: bigger feedback + text",11,"high",12
"SUPPRF86350",21,53,50,50,-13,65,63,56,"Pilot 9","Pilot 9: bigger feedback + text",11,"high",-6
"SUPPRF86350",22,21,58,6,-14,58,20,29,"Pilot 9","Pilot 9: bigger feedback + text",11,"high",-23
"SUPPRF86350",23,48,57,49,12,30,37,32,"Pilot 9","Pilot 9: bigger feedback + text",11,"high",17
"SUPPRF86350",24,46,48,54,0,53,54,62,"Pilot 9","Pilot 9: bigger feedback + text",11,"high",-8
"SUPPRF86350",25,51,50,38,1,54,37,37,"Pilot 9","Pilot 9: bigger feedback + text",11,"high",1
"SUPPRF86350",26,3,93,15,-14,32,29,35,"Pilot 9","Pilot 9: bigger feedback + text",11,"high",-20
"SUPPRF86350",27,12,54,75,29,31,46,46,"Pilot 9","Pilot 9: bigger feedback + text",11,"high",29
"SUPPRF86350",28,43,37,56,-15,61,71,74,"Pilot 9","Pilot 9: bigger feedback + text",11,"high",-18
"SUPPRF86350",29,49,37,37,0,50,37,45,"Pilot 9","Pilot 9: bigger feedback + text",11,"high",-8
"SUPPRF86350",30,39,54,29,0,48,29,48,"Pilot 9","Pilot 9: bigger feedback + text",11,"high",-19
"SUPPRF86350",31,46,46,83,12,53,71,66,"Pilot 9","Pilot 9: bigger feedback + text",11,"high",17
"SUPPRF86350",32,50,46,68,-12,53,80,54,"Pilot 9","Pilot 9: bigger feedback + text",11,"high",14
"SUPPRF86350",33,49,45,47,27,51,20,49,"Pilot 9","Pilot 9: bigger feedback + text",11,"high",-2
"SUPPRF86350",34,46,51,24,-13,59,37,56,"Pilot 9","Pilot 9: bigger feedback + text",11,"high",-32
"SUPPRF86350",35,53,47,67,-13,66,80,72,"Pilot 9","Pilot 9: bigger feedback + text",11,"high",-5
"SUPPRF86350",36,47,52,35,15,49,20,54,"Pilot 9","Pilot 9: bigger feedback + text",11,"high",-19
"SUPPRF86350",37,53,50,28,-1,50,29,57,"Pilot 9","Pilot 9: bigger feedback + text",11,"high",-29
"SUPPRF86350",38,49,54,38,-16,59,54,48,"Pilot 9","Pilot 9: bigger feedback + text",11,"high",-10
"SUPPRF86350",39,53,49,47,-16,28,63,47,"Pilot 9","Pilot 9: bigger feedback + text",11,"high",0
"SUPPRF86350",40,1,50,33,-13,43,46,47,"Pilot 9","Pilot 9: bigger feedback + text",11,"high",-14
"SUPPRF86350",41,80,50,80,0,47,80,51,"Pilot 9","Pilot 9: bigger feedback + text",11,"high",29
"SUPPRF86350",42,97,52,96,16,50,80,62,"Pilot 9","Pilot 9: bigger feedback + text",11,"high",34
"SUPPRF86350",43,64,68,19,-1,70,20,71,"Pilot 9","Pilot 9: bigger feedback + text",11,"high",-52
"SUPPRF86350",44,59,64,63,0,64,63,61,"Pilot 9","Pilot 9: bigger feedback + text",11,"high",2
"SUPPRF86350",45,59,60,58,29,46,29,43,"Pilot 9","Pilot 9: bigger feedback + text",11,"high",15
"SUPPRF86350",46,54,65,45,-1,66,46,50,"Pilot 9","Pilot 9: bigger feedback + text",11,"high",-5
"SUPPRF86350",47,55,61,55,1,48,54,51,"Pilot 9","Pilot 9: bigger feedback + text",11,"high",4
"SUPPRF86350",48,61,66,66,12,78,54,46,"Pilot 9","Pilot 9: bigger feedback + text",11,"high",20
"SUPPRF86378",1,67,12,66,12,82,54,30,"Pilot 9","Pilot 9: bigger feedback + text",3,"low",36
"SUPPRF86378",2,83,19,61,24,76,37,43,"Pilot 9","Pilot 9: bigger feedback + text",3,"low",18
"SUPPRF86378",3,55,16,20,0,72,20,62,"Pilot 9","Pilot 9: bigger feedback + text",3,"low",-42
"SUPPRF86378",4,51,15,37,0,68,37,51,"Pilot 9","Pilot 9: bigger feedback + text",3,"low",-14
"SUPPRF86378",5,53,20,34,-12,63,46,45,"Pilot 9","Pilot 9: bigger feedback + text",3,"low",-11
"SUPPRF86378",6,51,35,35,15,57,20,14,"Pilot 9","Pilot 9: bigger feedback + text",3,"low",21
"SUPPRF86378",7,63,23,19,-1,60,20,27,"Pilot 9","Pilot 9: bigger feedback + text",3,"low",-8
"SUPPRF86378",8,73,17,71,0,32,71,33,"Pilot 9","Pilot 9: bigger feedback + text",3,"low",38
"SUPPRF86378",9,92,6,100,20,53,80,51,"Pilot 9","Pilot 9: bigger feedback + text",3,"low",49
"SUPPRF86378",10,77,12,41,-13,61,54,43,"Pilot 9","Pilot 9: bigger feedback + text",3,"low",-2
"SUPPRF86378",11,80,11,83,12,76,71,69,"Pilot 9","Pilot 9: bigger feedback + text",3,"low",14
"SUPPRF86378",12,72,14,28,-1,62,29,23,"Pilot 9","Pilot 9: bigger feedback + text",3,"low",5
"SUPPRF86378",13,83,10,81,1,72,80,68,"Pilot 9","Pilot 9: bigger feedback + text",3,"low",13
"SUPPRF86378",14,84,15,54,0,60,54,41,"Pilot 9","Pilot 9: bigger feedback + text",3,"low",13
"SUPPRF86378",15,90,10,38,1,54,37,53,"Pilot 9","Pilot 9: bigger feedback + text",3,"low",-15
"SUPPRF86378",16,84,8,75,29,50,46,33,"Pilot 9","Pilot 9: bigger feedback + text",3,"low",42
"SUPPRF86378",17,91,10,38,-16,70,54,45,"Pilot 9","Pilot 9: bigger feedback + text",3,"low",-7
"SUPPRF86378",18,91,13,47,27,78,20,19,"Pilot 9","Pilot 9: bigger feedback + text",3,"low",28
"SUPPRF86378",19,87,12,67,-13,86,80,78,"Pilot 9","Pilot 9: bigger feedback + text",3,"low",-11
"SUPPRF86378",20,83,12,50,-13,42,63,48,"Pilot 9","Pilot 9: bigger feedback + text",3,"low",2
"SUPPRF86378",21,85,10,77,14,83,63,47,"Pilot 9","Pilot 9: bigger feedback + text",3,"low",30
"SUPPRF86378",22,83,20,56,-15,66,71,74,"Pilot 9","Pilot 9: bigger feedback + text",3,"low",-18
"SUPPRF86378",23,85,16,55,1,29,54,46,"Pilot 9","Pilot 9: bigger feedback + text",3,"low",9
"SUPPRF86378",24,85,12,29,0,50,29,19,"Pilot 9","Pilot 9: bigger feedback + text",3,"low",10
"SUPPRF86378",25,84,10,62,-1,71,63,36,"Pilot 9","Pilot 9: bigger feedback + text",3,"low",26
"SUPPRF86378",26,84,20,22,-15,33,37,50,"Pilot 9","Pilot 9: bigger feedback + text",3,"low",-28
"SUPPRF86378",27,79,15,47,-16,55,63,33,"Pilot 9","Pilot 9: bigger feedback + text",3,"low",14
"SUPPRF86378",28,18,22,33,-13,61,46,40,"Pilot 9","Pilot 9: bigger feedback + text",3,"low",-7
"SUPPRF86378",29,70,11,80,0,73,80,75,"Pilot 9","Pilot 9: bigger feedback + text",3,"low",5
"SUPPRF86378",30,79,23,6,-14,73,20,20,"Pilot 9","Pilot 9: bigger feedback + text",3,"low",-14
"SUPPRF86378",31,80,13,45,-1,58,46,43,"Pilot 9","Pilot 9: bigger feedback + text",3,"low",2
"SUPPRF86378",32,79,14,63,0,77,63,58,"Pilot 9","Pilot 9: bigger feedback + text",3,"low",5
"SUPPRF86378",33,75,19,58,12,66,46,57,"Pilot 9","Pilot 9: bigger feedback + text",3,"low",1
"SUPPRF86378",34,82,23,96,16,66,80,65,"Pilot 9","Pilot 9: bigger feedback + text",3,"low",31
"SUPPRF86378",35,85,20,68,-12,78,80,16,"Pilot 9","Pilot 9: bigger feedback + text",3,"low",52
"SUPPRF86378",36,81,4,55,-16,89,71,65,"Pilot 9","Pilot 9: bigger feedback + text",3,"low",-10
"SUPPRF86378",37,67,15,94,23,65,71,70,"Pilot 9","Pilot 9: bigger feedback + text",3,"low",24
"SUPPRF86378",38,79,22,46,0,47,46,52,"Pilot 9","Pilot 9: bigger feedback + text",3,"low",-6
"SUPPRF86378",39,75,32,78,24,69,54,44,"Pilot 9","Pilot 9: bigger feedback + text",3,"low",34
"SUPPRF86378",40,78,22,8,-12,65,20,16,"Pilot 9","Pilot 9: bigger feedback + text",3,"low",-8
"SUPPRF86378",41,82,11,16,-13,56,29,32,"Pilot 9","Pilot 9: bigger feedback + text",3,"low",-16
"SUPPRF86378",42,82,22,58,29,38,29,27,"Pilot 9","Pilot 9: bigger feedback + text",3,"low",31
"SUPPRF86378",43,72,21,15,-14,42,29,27,"Pilot 9","Pilot 9: bigger feedback + text",3,"low",-12
"SUPPRF86378",44,86,14,88,25,50,63,41,"Pilot 9","Pilot 9: bigger feedback + text",3,"low",47
"SUPPRF86378",45,84,24,49,12,57,37,36,"Pilot 9","Pilot 9: bigger feedback + text",3,"low",13
"SUPPRF86378",46,76,12,70,-1,82,71,75,"Pilot 9","Pilot 9: bigger feedback + text",3,"low",-5
"SUPPRF86378",47,83,24,24,-13,48,37,34,"Pilot 9","Pilot 9: bigger feedback + text",3,"low",-10
"SUPPRF86378",48,92,25,46,17,41,29,21,"Pilot 9","Pilot 9: bigger feedback + text",3,"low",25
"SUPPRF86502",1,57,17,63,0,53,63,69,"Pilot 10","Pilot 10: bigger feedback + video",2,"low",-6
"SUPPRF86502",2,61,14,58,29,73,29,29,"Pilot 10","Pilot 10: bigger feedback + video",2,"low",29
"SUPPRF86502",3,63,27,83,12,17,71,57,"Pilot 10","Pilot 10: bigger feedback + video",2,"low",26
"SUPPRF86502",4,62,4,70,-1,36,71,59,"Pilot 10","Pilot 10: bigger feedback + video",2,"low",11
"SUPPRF86502",5,71,19,47,-16,13,63,59,"Pilot 10","Pilot 10: bigger feedback + video",2,"low",-12
"SUPPRF86502",6,65,16,78,24,31,54,57,"Pilot 10","Pilot 10: bigger feedback + video",2,"low",21
"SUPPRF86502",7,61,23,41,-13,50,54,57,"Pilot 10","Pilot 10: bigger feedback + video",2,"low",-16
"SUPPRF86502",8,74,23,67,-13,20,80,69,"Pilot 10","Pilot 10: bigger feedback + video",2,"low",-2
"SUPPRF86502",9,72,20,16,-13,59,29,54,"Pilot 10","Pilot 10: bigger feedback + video",2,"low",-38
"SUPPRF86502",10,67,9,81,1,66,80,79,"Pilot 10","Pilot 10: bigger feedback + video",2,"low",2
"SUPPRF86502",11,79,12,46,0,28,46,39,"Pilot 10","Pilot 10: bigger feedback + video",2,"low",7
"SUPPRF86502",12,73,17,58,12,29,46,46,"Pilot 10","Pilot 10: bigger feedback + video",2,"low",12
"SUPPRF86502",13,84,16,45,-1,78,46,56,"Pilot 10","Pilot 10: bigger feedback + video",2,"low",-11
"SUPPRF86502",14,47,19,61,24,55,37,33,"Pilot 10","Pilot 10: bigger feedback + video",2,"low",28
"SUPPRF86502",15,72,13,38,1,74,37,29,"Pilot 10","Pilot 10: bigger feedback + video",2,"low",9
"SUPPRF86502",16,62,12,94,23,59,71,43,"Pilot 10","Pilot 10: bigger feedback + video",2,"low",51
"SUPPRF86502",17,54,24,37,0,85,37,36,"Pilot 10","Pilot 10: bigger feedback + video",2,"low",1
"SUPPRF86502",18,59,16,29,0,37,29,31,"Pilot 10","Pilot 10: bigger feedback + video",2,"low",-2
"SUPPRF86502",19,13,10,56,-15,36,71,34,"Pilot 10","Pilot 10: bigger feedback + video",2,"low",22
"SUPPRF86502",20,21,18,66,12,37,54,43,"Pilot 10","Pilot 10: bigger feedback + video",2,"low",23
"SUPPRF86502",21,73,25,38,-16,11,54,51,"Pilot 10","Pilot 10: bigger feedback + video",2,"low",-13
"SUPPRF86502",22,8,16,33,-13,39,46,46,"Pilot 10","Pilot 10: bigger feedback + video",2,"low",-13
"SUPPRF86502",23,1,57,100,20,32,80,50,"Pilot 10","Pilot 10: bigger feedback + video",2,"low",50
"SUPPRF86502",24,0,5,24,-13,24,37,26,"Pilot 10","Pilot 10: bigger feedback + video",2,"low",-2
"SUPPRF86502",25,0,10,8,-12,24,20,49,"Pilot 10","Pilot 10: bigger feedback + video",2,"low",-41
"SUPPRF86502",26,0,94,71,0,16,71,37,"Pilot 10","Pilot 10: bigger feedback + video",2,"low",34
"SUPPRF86502",27,0,15,55,1,14,54,54,"Pilot 10","Pilot 10: bigger feedback + video",2,"low",1
"SUPPRF86502",28,0,12,75,29,38,46,39,"Pilot 10","Pilot 10: bigger feedback + video",2,"low",36
"SUPPRF86502",29,1,7,62,-1,62,63,66,"Pilot 10","Pilot 10: bigger feedback + video",2,"low",-4
"SUPPRF86502",30,0,5,6,-14,19,20,27,"Pilot 10","Pilot 10: bigger feedback + video",2,"low",-21
"SUPPRF86502",31,0,8,22,-15,56,37,24,"Pilot 10","Pilot 10: bigger feedback + video",2,"low",-2
"SUPPRF86502",32,1,5,28,-1,19,29,31,"Pilot 10","Pilot 10: bigger feedback + video",2,"low",-3
"SUPPRF86502",33,0,7,19,-1,22,20,30,"Pilot 10","Pilot 10: bigger feedback + video",2,"low",-11
"SUPPRF86502",34,0,7,55,-16,12,71,32,"Pilot 10","Pilot 10: bigger feedback + video",2,"low",23
"SUPPRF86502",35,13,4,34,-12,11,46,32,"Pilot 10","Pilot 10: bigger feedback + video",2,"low",2
"SUPPRF86502",36,1,4,49,12,17,37,32,"Pilot 10","Pilot 10: bigger feedback + video",2,"low",17
"SUPPRF86502",37,0,4,68,-12,9,80,34,"Pilot 10","Pilot 10: bigger feedback + video",2,"low",34
"SUPPRF86502",38,1,5,35,15,22,20,20,"Pilot 10","Pilot 10: bigger feedback + video",2,"low",15
"SUPPRF86502",39,7,5,50,-13,4,63,56,"Pilot 10","Pilot 10: bigger feedback + video",2,"low",-6
"SUPPRF86502",40,0,6,46,17,9,29,19,"Pilot 10","Pilot 10: bigger feedback + video",2,"low",27
"SUPPRF86502",41,12,6,47,27,32,20,47,"Pilot 10","Pilot 10: bigger feedback + video",2,"low",0
"SUPPRF86502",42,8,6,15,-14,11,29,29,"Pilot 10","Pilot 10: bigger feedback + video",2,"low",-14
"SUPPRF86502",43,0,6,20,0,15,20,30,"Pilot 10","Pilot 10: bigger feedback + video",2,"low",-10
"SUPPRF86502",44,9,9,54,0,28,54,29,"Pilot 10","Pilot 10: bigger feedback + video",2,"low",25
"SUPPRF86502",45,3,4,96,16,9,80,28,"Pilot 10","Pilot 10: bigger feedback + video",2,"low",68
"SUPPRF86502",46,3,0,88,25,6,63,36,"Pilot 10","Pilot 10: bigger feedback + video",2,"low",52
"SUPPRF86502",47,0,3,77,14,5,63,23,"Pilot 10","Pilot 10: bigger feedback + video",2,"low",54
"SUPPRF86502",48,1,3,80,0,8,80,17,"Pilot 10","Pilot 10: bigger feedback + video",2,"low",63
"SUPPRF87016",1,21,92,19,-1,78,20,21,"Pilot 9","Pilot 9: bigger feedback + text",8,"high",-2
"SUPPRF87016",2,68,75,61,24,76,37,43,"Pilot 9","Pilot 9: bigger feedback + text",8,"high",18
"SUPPRF87016",3,22,66,56,-15,72,71,70,"Pilot 9","Pilot 9: bigger feedback + text",8,"high",-14
"SUPPRF87016",4,25,68,22,-15,68,37,40,"Pilot 9","Pilot 9: bigger feedback + text",8,"high",-18
"SUPPRF87016",5,88,70,88,25,34,63,50,"Pilot 9","Pilot 9: bigger feedback + text",8,"high",38
"SUPPRF87016",6,56,63,28,-1,50,29,25,"Pilot 9","Pilot 9: bigger feedback + text",8,"high",3
"SUPPRF87016",7,89,35,58,29,67,29,24,"Pilot 9","Pilot 9: bigger feedback + text",8,"high",34
"SUPPRF87016",8,94,22,96,16,63,80,70,"Pilot 9","Pilot 9: bigger feedback + text",8,"high",26
"SUPPRF87016",9,81,27,83,12,75,71,62,"Pilot 9","Pilot 9: bigger feedback + text",8,"high",21
"SUPPRF87016",10,82,32,100,20,67,80,70,"Pilot 9","Pilot 9: bigger feedback + text",8,"high",30
"SUPPRF87016",11,89,26,34,-12,76,46,25,"Pilot 9","Pilot 9: bigger feedback + text",8,"high",9
"SUPPRF87016",12,70,15,54,0,64,54,60,"Pilot 9","Pilot 9: bigger feedback + text",8,"high",-6
"SUPPRF87016",13,78,22,29,0,67,29,24,"Pilot 9","Pilot 9: bigger feedback + text",8,"high",5
"SUPPRF87016",14,78,19,66,12,78,54,66,"Pilot 9","Pilot 9: bigger feedback + text",8,"high",0
"SUPPRF87016",15,82,13,38,1,75,37,38,"Pilot 9","Pilot 9: bigger feedback + text",8,"high",0
"SUPPRF87016",16,71,16,55,1,77,54,62,"Pilot 9","Pilot 9: bigger feedback + text",8,"high",-7
"SUPPRF87016",17,84,18,70,-1,76,71,72,"Pilot 9","Pilot 9: bigger feedback + text",8,"high",-2
"SUPPRF87016",18,75,13,71,0,67,71,69,"Pilot 9","Pilot 9: bigger feedback + text",8,"high",2
"SUPPRF87016",19,82,18,68,-12,39,80,38,"Pilot 9","Pilot 9: bigger feedback + text",8,"high",30
"SUPPRF87016",20,73,18,67,-13,69,80,67,"Pilot 9","Pilot 9: bigger feedback + text",8,"high",0
"SUPPRF87016",21,81,19,58,12,81,46,42,"Pilot 9","Pilot 9: bigger feedback + text",8,"high",16
"SUPPRF87016",22,71,20,35,15,74,20,30,"Pilot 9","Pilot 9: bigger feedback + text",8,"high",5
"SUPPRF87016",23,77,23,50,-13,75,63,41,"Pilot 9","Pilot 9: bigger feedback + text",8,"high",9
"SUPPRF87016",24,86,17,75,29,71,46,27,"Pilot 9","Pilot 9: bigger feedback + text",8,"high",48
"SUPPRF87016",25,85,14,80,0,81,80,82,"Pilot 9","Pilot 9: bigger feedback + text",8,"high",-2
"SUPPRF87016",26,71,21,45,-1,86,46,43,"Pilot 9","Pilot 9: bigger feedback + text",8,"high",2
"SUPPRF87016",27,83,24,94,23,81,71,75,"Pilot 9","Pilot 9: bigger feedback + text",8,"high",19
"SUPPRF87016",28,67,23,38,-16,76,54,75,"Pilot 9","Pilot 9: bigger feedback + text",8,"high",-37
"SUPPRF87016",29,79,21,62,-1,73,63,37,"Pilot 9","Pilot 9: bigger feedback + text",8,"high",25
"SUPPRF87016",30,80,27,46,17,76,29,30,"Pilot 9","Pilot 9: bigger feedback + text",8,"high",16
"SUPPRF87016",31,56,24,8,-12,75,20,31,"Pilot 9","Pilot 9: bigger feedback + text",8,"high",-23
"SUPPRF87016",32,59,35,15,-14,79,29,16,"Pilot 9","Pilot 9: bigger feedback + text",8,"high",-1
"SUPPRF87016",33,69,28,20,0,79,20,22,"Pilot 9","Pilot 9: bigger feedback + text",8,"high",-2
"SUPPRF87016",34,78,26,46,0,67,46,38,"Pilot 9","Pilot 9: bigger feedback + text",8,"high",8
"SUPPRF87016",35,61,27,77,14,72,63,64,"Pilot 9","Pilot 9: bigger feedback + text",8,"high",13
"SUPPRF87016",36,64,36,47,-16,36,63,52,"Pilot 9","Pilot 9: bigger feedback + text",8,"high",-5
"SUPPRF87016",37,65,31,33,-13,30,46,49,"Pilot 9","Pilot 9: bigger feedback + text",8,"high",-16
"SUPPRF87016",38,61,36,81,1,76,80,78,"Pilot 9","Pilot 9: bigger feedback + text",8,"high",3
"SUPPRF87016",39,61,33,63,0,71,63,67,"Pilot 9","Pilot 9: bigger feedback + text",8,"high",-4
"SUPPRF87016",40,53,42,16,-13,58,29,32,"Pilot 9","Pilot 9: bigger feedback + text",8,"high",-16
"SUPPRF87016",41,46,42,37,0,38,37,58,"Pilot 9","Pilot 9: bigger feedback + text",8,"high",-21
"SUPPRF87016",42,55,42,24,-13,68,37,27,"Pilot 9","Pilot 9: bigger feedback + text",8,"high",-3
"SUPPRF87016",43,55,43,78,24,65,54,45,"Pilot 9","Pilot 9: bigger feedback + text",8,"high",33
"SUPPRF87016",44,58,46,41,-13,72,54,72,"Pilot 9","Pilot 9: bigger feedback + text",8,"high",-31
"SUPPRF87016",45,44,38,47,27,38,20,22,"Pilot 9","Pilot 9: bigger feedback + text",8,"high",25
"SUPPRF87016",46,42,53,49,12,39,37,40,"Pilot 9","Pilot 9: bigger feedback + text",8,"high",9
"SUPPRF87016",47,45,53,6,-14,36,20,29,"Pilot 9","Pilot 9: bigger feedback + text",8,"high",-23
"SUPPRF87016",48,50,55,55,-16,80,71,77,"Pilot 9","Pilot 9: bigger feedback + text",8,"high",-22
"SUPPRF87060",1,99,0,80,0,93,80,80,"Pilot 8","Pilot 8: max feedback + text",1,"low",0
"SUPPRF87060",2,91,3,94,23,61,71,60,"Pilot 8","Pilot 8: max feedback + text",1,"low",34
"SUPPRF87060",3,92,1,71,0,89,71,78,"Pilot 8","Pilot 8: max feedback + text",1,"low",-7
"SUPPRF87060",4,82,5,56,-15,87,71,95,"Pilot 8","Pilot 8: max feedback + text",1,"low",-39
"SUPPRF87060",5,98,0,58,12,91,46,30,"Pilot 8","Pilot 8: max feedback + text",1,"low",28
"SUPPRF87060",6,97,0,68,-12,1,80,64,"Pilot 8","Pilot 8: max feedback + text",1,"low",4
"SUPPRF87060",7,95,3,75,29,31,46,26,"Pilot 8","Pilot 8: max feedback + text",1,"low",49
"SUPPRF87060",8,95,3,67,-13,26,80,89,"Pilot 8","Pilot 8: max feedback + text",1,"low",-22
"SUPPRF87060",9,99,1,100,20,76,80,86,"Pilot 8","Pilot 8: max feedback + text",1,"low",14
"SUPPRF87060",10,98,2,62,-1,95,63,55,"Pilot 8","Pilot 8: max feedback + text",1,"low",7
"SUPPRF87060",11,98,0,81,1,83,80,86,"Pilot 8","Pilot 8: max feedback + text",1,"low",-5
"SUPPRF87060",12,63,0,20,0,99,20,0,"Pilot 8","Pilot 8: max feedback + text",1,"low",20
"SUPPRF87060",13,98,1,96,16,20,80,94,"Pilot 8","Pilot 8: max feedback + text",1,"low",2
"SUPPRF87060",14,97,3,47,-16,76,63,70,"Pilot 8","Pilot 8: max feedback + text",1,"low",-23
"SUPPRF87060",15,97,1,88,25,15,63,62,"Pilot 8","Pilot 8: max feedback + text",1,"low",26
"SUPPRF87060",16,71,0,35,15,86,20,20,"Pilot 8","Pilot 8: max feedback + text",1,"low",15
"SUPPRF87060",17,71,2,61,24,5,37,38,"Pilot 8","Pilot 8: max feedback + text",1,"low",23
"SUPPRF87060",18,45,12,22,-15,1,37,36,"Pilot 8","Pilot 8: max feedback + text",1,"low",-14
"SUPPRF87060",19,31,8,16,-13,84,29,24,"Pilot 8","Pilot 8: max feedback + text",1,"low",-8
"SUPPRF87060",20,25,3,55,-16,12,71,58,"Pilot 8","Pilot 8: max feedback + text",1,"low",-3
"SUPPRF87060",21,16,18,38,-16,0,54,51,"Pilot 8","Pilot 8: max feedback + text",1,"low",-13
"SUPPRF87060",22,25,16,29,0,3,29,43,"Pilot 8","Pilot 8: max feedback + text",1,"low",-14
"SUPPRF87060",23,67,12,19,-1,86,20,16,"Pilot 8","Pilot 8: max feedback + text",1,"low",3
"SUPPRF87060",24,81,2,46,17,94,29,19,"Pilot 8","Pilot 8: max feedback + text",1,"low",27
"SUPPRF87060",25,85,2,28,-1,1,29,34,"Pilot 8","Pilot 8: max feedback + text",1,"low",-6
"SUPPRF87060",26,91,1,54,0,72,54,48,"Pilot 8","Pilot 8: max feedback + text",1,"low",6
"SUPPRF87060",27,79,3,15,-14,2,29,31,"Pilot 8","Pilot 8: max feedback + text",1,"low",-16
"SUPPRF87060",28,80,3,58,29,0,29,24,"Pilot 8","Pilot 8: max feedback + text",1,"low",34
"SUPPRF87060",29,0,2,38,1,37,37,36,"Pilot 8","Pilot 8: max feedback + text",1,"low",2
"SUPPRF87060",30,59,3,24,-13,19,37,32,"Pilot 8","Pilot 8: max feedback + text",1,"low",-8
"SUPPRF87060",31,51,0,66,12,79,54,57,"Pilot 8","Pilot 8: max feedback + text",1,"low",9
"SUPPRF87060",32,38,1,47,27,80,20,5,"Pilot 8","Pilot 8: max feedback + text",1,"low",42
"SUPPRF87060",33,33,1,77,14,28,63,62,"Pilot 8","Pilot 8: max feedback + text",1,"low",15
"SUPPRF87060",34,26,2,49,12,64,37,28,"Pilot 8","Pilot 8: max feedback + text",1,"low",21
"SUPPRF87060",35,0,0,63,0,1,63,14,"Pilot 8","Pilot 8: max feedback + text",1,"low",49
"SUPPRF87060",36,2,1,8,-12,86,20,12,"Pilot 8","Pilot 8: max feedback + text",1,"low",-4
"SUPPRF87060",37,65,1,70,-1,22,71,82,"Pilot 8","Pilot 8: max feedback + text",1,"low",-12
"SUPPRF87060",38,18,3,37,0,52,37,31,"Pilot 8","Pilot 8: max feedback + text",1,"low",6
"SUPPRF87060",39,0,1,33,-13,1,46,13,"Pilot 8","Pilot 8: max feedback + text",1,"low",20
"SUPPRF87060",40,9,2,45,-1,17,46,34,"Pilot 8","Pilot 8: max feedback + text",1,"low",11
"SUPPRF87060",41,0,1,6,-14,94,20,14,"Pilot 8","Pilot 8: max feedback + text",1,"low",-8
"SUPPRF87060",42,7,1,46,0,0,46,51,"Pilot 8","Pilot 8: max feedback + text",1,"low",-5
"SUPPRF87060",43,2,2,83,12,7,71,91,"Pilot 8","Pilot 8: max feedback + text",1,"low",-8
"SUPPRF87060",44,0,0,78,24,6,54,44,"Pilot 8","Pilot 8: max feedback + text",1,"low",34
"SUPPRF87060",45,1,1,34,-12,0,46,34,"Pilot 8","Pilot 8: max feedback + text",1,"low",0
"SUPPRF87060",46,0,1,41,-13,1,54,1,"Pilot 8","Pilot 8: max feedback + text",1,"low",40
"SUPPRF87060",47,0,1,50,-13,6,63,61,"Pilot 8","Pilot 8: max feedback + text",1,"low",-11
"SUPPRF87563",1,32,64,24,-13,40,37,24,"Pilot 10","Pilot 10: bigger feedback + video",11,"high",0
"SUPPRF87563",2,27,75,35,15,65,20,20,"Pilot 10","Pilot 10: bigger feedback + video",11,"high",15
"SUPPRF87563",3,25,69,20,0,65,20,30,"Pilot 10","Pilot 10: bigger feedback + video",11,"high",-10
"SUPPRF87563",4,59,60,75,29,60,46,35,"Pilot 10","Pilot 10: bigger feedback + video",11,"high",40
"SUPPRF87563",5,42,50,54,0,69,54,30,"Pilot 10","Pilot 10: bigger feedback + video",11,"high",24
"SUPPRF87563",6,29,66,33,-13,60,46,40,"Pilot 10","Pilot 10: bigger feedback + video",11,"high",-7
"SUPPRF87563",7,26,73,68,-12,66,80,23,"Pilot 10","Pilot 10: bigger feedback + video",11,"high",45
"SUPPRF87563",8,30,54,47,27,63,20,24,"Pilot 10","Pilot 10: bigger feedback + video",11,"high",23
"SUPPRF87563",9,50,44,81,1,65,80,44,"Pilot 10","Pilot 10: bigger feedback + video",11,"high",37
"SUPPRF87563",10,49,47,66,12,66,54,34,"Pilot 10","Pilot 10: bigger feedback + video",11,"high",32
"SUPPRF87563",11,46,47,78,24,73,54,39,"Pilot 10","Pilot 10: bigger feedback + video",11,"high",39
"SUPPRF87563",12,52,50,6,-14,71,20,41,"Pilot 10","Pilot 10: bigger feedback + video",11,"high",-35
"SUPPRF87563",13,49,49,41,-13,63,54,46,"Pilot 10","Pilot 10: bigger feedback + video",11,"high",-5
"SUPPRF87563",14,48,48,38,-16,61,54,25,"Pilot 10","Pilot 10: bigger feedback + video",11,"high",13
"SUPPRF87563",15,49,49,62,-1,64,63,32,"Pilot 10","Pilot 10: bigger feedback + video",11,"high",30
"SUPPRF87563",16,49,50,94,23,60,71,40,"Pilot 10","Pilot 10: bigger feedback + video",11,"high",54
"SUPPRF87563",17,50,50,46,17,68,29,37,"Pilot 10","Pilot 10: bigger feedback + video",11,"high",9
"SUPPRF87563",18,100,48,100,20,67,80,48,"Pilot 10","Pilot 10: bigger feedback + video",11,"high",52
"SUPPRF87563",19,44,43,56,-15,69,71,47,"Pilot 10","Pilot 10: bigger feedback + video",11,"high",9
"SUPPRF87563",20,48,50,55,-16,76,71,61,"Pilot 10","Pilot 10: bigger feedback + video",11,"high",-6
"SUPPRF87563",21,50,47,46,0,47,46,49,"Pilot 10","Pilot 10: bigger feedback + video",11,"high",-3
"SUPPRF87563",22,53,47,45,-1,50,46,34,"Pilot 10","Pilot 10: bigger feedback + video",11,"high",11
"SUPPRF87563",23,52,49,22,-15,44,37,40,"Pilot 10","Pilot 10: bigger feedback + video",11,"high",-18
"SUPPRF87563",24,48,46,15,-14,43,29,51,"Pilot 10","Pilot 10: bigger feedback + video",11,"high",-36
"SUPPRF87563",25,46,50,67,-13,65,80,75,"Pilot 10","Pilot 10: bigger feedback + video",11,"high",-8
"SUPPRF87563",26,49,48,34,-12,58,46,45,"Pilot 10","Pilot 10: bigger feedback + video",11,"high",-11
"SUPPRF87563",27,49,48,77,14,65,63,26,"Pilot 10","Pilot 10: bigger feedback + video",11,"high",51
"SUPPRF87563",28,51,49,47,-16,65,63,53,"Pilot 10","Pilot 10: bigger feedback + video",11,"high",-6
"SUPPRF87563",29,49,49,19,-1,92,20,18,"Pilot 10","Pilot 10: bigger feedback + video",11,"high",1
"SUPPRF87563",30,100,53,88,25,79,63,53,"Pilot 10","Pilot 10: bigger feedback + video",11,"high",35
"SUPPRF87563",31,35,53,50,-13,83,63,64,"Pilot 10","Pilot 10: bigger feedback + video",11,"high",-14
"SUPPRF87563",32,51,50,55,1,85,54,48,"Pilot 10","Pilot 10: bigger feedback + video",11,"high",7
"SUPPRF87563",33,34,52,38,1,75,37,41,"Pilot 10","Pilot 10: bigger feedback + video",11,"high",-3
"SUPPRF87563",34,79,53,96,16,37,80,57,"Pilot 10","Pilot 10: bigger feedback + video",11,"high",39
"SUPPRF87563",35,69,35,63,0,76,63,43,"Pilot 10","Pilot 10: bigger feedback + video",11,"high",20
"SUPPRF87563",36,73,29,8,-12,57,20,17,"Pilot 10","Pilot 10: bigger feedback + video",11,"high",-9
"SUPPRF87563",37,64,31,49,12,63,37,34,"Pilot 10","Pilot 10: bigger feedback + video",11,"high",15
"SUPPRF87563",38,64,38,16,-13,49,29,57,"Pilot 10","Pilot 10: bigger feedback + video",11,"high",-41
"SUPPRF87563",39,70,30,61,24,56,37,35,"Pilot 10","Pilot 10: bigger feedback + video",11,"high",26
"SUPPRF87563",40,77,28,80,0,76,80,81,"Pilot 10","Pilot 10: bigger feedback + video",11,"high",-1
"SUPPRF87563",41,67,62,70,-1,86,71,10,"Pilot 10","Pilot 10: bigger feedback + video",11,"high",60
"SUPPRF87563",42,63,24,58,29,86,29,44,"Pilot 10","Pilot 10: bigger feedback + video",11,"high",14
"SUPPRF87563",43,63,18,29,0,64,29,45,"Pilot 10","Pilot 10: bigger feedback + video",11,"high",-16
"SUPPRF87563",44,65,27,58,12,57,46,42,"Pilot 10","Pilot 10: bigger feedback + video",11,"high",16
"SUPPRF87563",45,72,30,83,12,69,71,63,"Pilot 10","Pilot 10: bigger feedback + video",11,"high",20
"SUPPRF87563",46,69,27,71,0,70,71,58,"Pilot 10","Pilot 10: bigger feedback + video",11,"high",13
"SUPPRF87563",47,64,18,28,-1,69,29,39,"Pilot 10","Pilot 10: bigger feedback + video",11,"high",-11
"SUPPRF87563",48,68,15,37,0,77,37,53,"Pilot 10","Pilot 10: bigger feedback + video",11,"high",-16
"SUPPRF87860",1,50,49,20,0,29,20,67,"Pilot 8","Pilot 8: max feedback + text",7,"high",-47
"SUPPRF87860",2,48,50,62,-1,61,63,62,"Pilot 8","Pilot 8: max feedback + text",7,"high",0
"SUPPRF87860",3,49,53,67,-13,56,80,60,"Pilot 8","Pilot 8: max feedback + text",7,"high",7
"SUPPRF87860",4,48,49,33,-13,36,46,69,"Pilot 8","Pilot 8: max feedback + text",7,"high",-36
"SUPPRF87860",5,51,50,54,0,61,54,72,"Pilot 8","Pilot 8: max feedback + text",7,"high",-18
"SUPPRF87860",6,50,51,38,-16,45,54,26,"Pilot 8","Pilot 8: max feedback + text",7,"high",12
"SUPPRF87860",7,51,50,78,24,53,54,43,"Pilot 8","Pilot 8: max feedback + text",7,"high",35
"SUPPRF87860",8,50,52,8,-12,50,20,42,"Pilot 8","Pilot 8: max feedback + text",7,"high",-34
"SUPPRF87860",9,49,51,37,0,51,37,50,"Pilot 8","Pilot 8: max feedback + text",7,"high",-13
"SUPPRF87860",10,48,46,77,14,50,63,48,"Pilot 8","Pilot 8: max feedback + text",7,"high",29
"SUPPRF87860",11,50,49,94,23,60,71,52,"Pilot 8","Pilot 8: max feedback + text",7,"high",42
"SUPPRF87860",12,51,50,61,24,69,37,67,"Pilot 8","Pilot 8: max feedback + text",7,"high",-6
"SUPPRF87860",13,50,50,56,-15,52,71,46,"Pilot 8","Pilot 8: max feedback + text",7,"high",10
"SUPPRF87860",14,49,48,24,-13,59,37,30,"Pilot 8","Pilot 8: max feedback + text",7,"high",-6
"SUPPRF87860",15,49,52,6,-14,24,20,40,"Pilot 8","Pilot 8: max feedback + text",7,"high",-34
"SUPPRF87860",16,49,47,58,29,5,29,6,"Pilot 8","Pilot 8: max feedback + text",7,"high",52
"SUPPRF87860",17,53,45,49,12,44,37,11,"Pilot 8","Pilot 8: max feedback + text",7,"high",38
"SUPPRF87860",18,51,49,16,-13,46,29,21,"Pilot 8","Pilot 8: max feedback + text",7,"high",-5
"SUPPRF87860",19,54,44,83,12,51,71,51,"Pilot 8","Pilot 8: max feedback + text",7,"high",32
"SUPPRF87860",20,50,49,70,-1,66,71,77,"Pilot 8","Pilot 8: max feedback + text",7,"high",-7
"SUPPRF87860",21,50,51,46,17,50,29,34,"Pilot 8","Pilot 8: max feedback + text",7,"high",12
"SUPPRF87860",22,49,49,50,-13,48,63,50,"Pilot 8","Pilot 8: max feedback + text",7,"high",0
"SUPPRF87860",23,49,53,71,0,51,71,34,"Pilot 8","Pilot 8: max feedback + text",7,"high",37
"SUPPRF87860",24,51,51,68,-12,31,80,27,"Pilot 8","Pilot 8: max feedback + text",7,"high",41
"SUPPRF87860",25,51,52,19,-1,57,20,33,"Pilot 8","Pilot 8: max feedback + text",7,"high",-14
"SUPPRF87860",26,49,50,63,0,50,63,48,"Pilot 8","Pilot 8: max feedback + text",7,"high",15
"SUPPRF87860",27,49,50,96,16,52,80,13,"Pilot 8","Pilot 8: max feedback + text",7,"high",83
"SUPPRF87860",28,48,54,35,15,19,20,8,"Pilot 8","Pilot 8: max feedback + text",7,"high",27
"SUPPRF87860",29,48,49,46,0,49,46,49,"Pilot 8","Pilot 8: max feedback + text",7,"high",-3
"SUPPRF87860",30,50,50,41,-13,47,54,30,"Pilot 8","Pilot 8: max feedback + text",7,"high",11
"SUPPRF87860",31,49,50,45,-1,47,46,48,"Pilot 8","Pilot 8: max feedback + text",7,"high",-3
"SUPPRF87860",32,53,48,100,20,59,80,42,"Pilot 8","Pilot 8: max feedback + text",7,"high",58
"SUPPRF87860",33,50,46,47,27,32,20,6,"Pilot 8","Pilot 8: max feedback + text",7,"high",41
"SUPPRF87860",34,48,49,88,25,49,63,49,"Pilot 8","Pilot 8: max feedback + text",7,"high",39
"SUPPRF87860",35,50,51,81,1,72,80,58,"Pilot 8","Pilot 8: max feedback + text",7,"high",23
"SUPPRF87860",36,51,48,75,29,49,46,26,"Pilot 8","Pilot 8: max feedback + text",7,"high",49
"SUPPRF87860",37,50,50,22,-15,51,37,50,"Pilot 8","Pilot 8: max feedback + text",7,"high",-28
"SUPPRF87860",38,50,48,80,0,52,80,47,"Pilot 8","Pilot 8: max feedback + text",7,"high",33
"SUPPRF87860",39,50,49,47,-16,50,63,21,"Pilot 8","Pilot 8: max feedback + text",7,"high",26
"SUPPRF87860",40,48,50,66,12,49,54,50,"Pilot 8","Pilot 8: max feedback + text",7,"high",16
"SUPPRF87860",41,51,49,55,-16,46,71,41,"Pilot 8","Pilot 8: max feedback + text",7,"high",14
"SUPPRF87860",42,49,50,15,-14,49,29,33,"Pilot 8","Pilot 8: max feedback + text",7,"high",-18
"SUPPRF87860",43,48,49,38,1,99,37,0,"Pilot 8","Pilot 8: max feedback + text",7,"high",38
"SUPPRF87860",44,52,50,55,1,49,54,41,"Pilot 8","Pilot 8: max feedback + text",7,"high",14
"SUPPRF87860",45,50,51,58,12,50,46,49,"Pilot 8","Pilot 8: max feedback + text",7,"high",9
"SUPPRF87860",46,51,50,28,-1,47,29,31,"Pilot 8","Pilot 8: max feedback + text",7,"high",-3
"SUPPRF87860",47,50,50,29,0,51,29,43,"Pilot 8","Pilot 8: max feedback + text",7,"high",-14
"SUPPRF87860",48,51,48,34,-12,50,46,27,"Pilot 8","Pilot 8: max feedback + text",7,"high",7
"SUPPRF88012",1,36,35,66,12,3,54,23,"Pilot 8","Pilot 8: max feedback + text",7,"high",43
"SUPPRF88012",2,38,38,46,0,1,46,33,"Pilot 8","Pilot 8: max feedback + text",7,"high",13
"SUPPRF88012",3,37,38,77,14,1,63,47,"Pilot 8","Pilot 8: max feedback + text",7,"high",30
"SUPPRF88012",4,36,35,56,-15,2,71,63,"Pilot 8","Pilot 8: max feedback + text",7,"high",-7
"SUPPRF88012",5,35,33,24,-13,2,37,29,"Pilot 8","Pilot 8: max feedback + text",7,"high",-5
"SUPPRF88012",6,31,34,78,24,2,54,42,"Pilot 8","Pilot 8: max feedback + text",7,"high",36
"SUPPRF88012",7,38,33,96,16,1,80,51,"Pilot 8","Pilot 8: max feedback + text",7,"high",45
"SUPPRF88012",8,34,35,33,-13,1,46,39,"Pilot 8","Pilot 8: max feedback + text",7,"high",-6
"SUPPRF88012",9,36,35,68,-12,43,80,42,"Pilot 8","Pilot 8: max feedback + text",7,"high",26
"SUPPRF88012",10,38,37,50,-13,47,63,39,"Pilot 8","Pilot 8: max feedback + text",7,"high",11
"SUPPRF88012",11,37,34,61,24,36,37,40,"Pilot 8","Pilot 8: max feedback + text",7,"high",21
"SUPPRF88012",12,37,38,49,12,36,37,39,"Pilot 8","Pilot 8: max feedback + text",7,"high",10
"SUPPRF88012",13,35,32,58,12,31,46,35,"Pilot 8","Pilot 8: max feedback + text",7,"high",23
"SUPPRF88012",14,35,26,15,-14,28,29,31,"Pilot 8","Pilot 8: max feedback + text",7,"high",-16
"SUPPRF88012",15,26,28,81,1,20,80,24,"Pilot 8","Pilot 8: max feedback + text",7,"high",57
"SUPPRF88012",16,30,29,62,-1,31,63,34,"Pilot 8","Pilot 8: max feedback + text",7,"high",28
"SUPPRF88012",17,27,22,55,-16,25,71,26,"Pilot 8","Pilot 8: max feedback + text",7,"high",29
"SUPPRF88012",18,28,26,70,-1,25,71,35,"Pilot 8","Pilot 8: max feedback + text",7,"high",35
"SUPPRF88012",19,27,27,55,1,23,54,24,"Pilot 8","Pilot 8: max feedback + text",7,"high",31
"SUPPRF88012",20,28,26,6,-14,21,20,16,"Pilot 8","Pilot 8: max feedback + text",7,"high",-10
"SUPPRF88012",21,39,34,54,0,3,54,40,"Pilot 8","Pilot 8: max feedback + text",7,"high",14
"SUPPRF88012",22,30,30,22,-15,2,37,32,"Pilot 8","Pilot 8: max feedback + text",7,"high",-10
"SUPPRF88012",23,32,27,100,20,2,80,2,"Pilot 8","Pilot 8: max feedback + text",7,"high",98
"SUPPRF88012",24,28,28,37,0,2,37,29,"Pilot 8","Pilot 8: max feedback + text",7,"high",8
"SUPPRF88012",25,29,29,29,0,20,29,26,"Pilot 8","Pilot 8: max feedback + text",7,"high",3
"SUPPRF88012",26,29,39,46,17,26,29,26,"Pilot 8","Pilot 8: max feedback + text",7,"high",20
"SUPPRF88012",27,79,71,8,-12,45,20,43,"Pilot 8","Pilot 8: max feedback + text",7,"high",-35
"SUPPRF88012",28,47,49,83,12,45,71,45,"Pilot 8","Pilot 8: max feedback + text",7,"high",38
"SUPPRF88012",29,45,45,75,29,47,46,46,"Pilot 8","Pilot 8: max feedback + text",7,"high",29
"SUPPRF88012",30,47,45,45,-1,46,46,36,"Pilot 8","Pilot 8: max feedback + text",7,"high",9
"SUPPRF88012",31,49,48,35,15,45,20,49,"Pilot 8","Pilot 8: max feedback + text",7,"high",-14
"SUPPRF88012",32,46,47,20,0,9,20,11,"Pilot 8","Pilot 8: max feedback + text",7,"high",9
"SUPPRF88012",33,47,49,38,1,48,37,47,"Pilot 8","Pilot 8: max feedback + text",7,"high",-9
"SUPPRF88012",34,46,46,47,-16,48,63,36,"Pilot 8","Pilot 8: max feedback + text",7,"high",11
"SUPPRF88012",35,45,47,47,27,1,20,51,"Pilot 8","Pilot 8: max feedback + text",7,"high",-4
"SUPPRF88012",36,49,46,34,-12,0,46,23,"Pilot 8","Pilot 8: max feedback + text",7,"high",11
"SUPPRF88012",37,51,49,80,0,99,80,99,"Pilot 8","Pilot 8: max feedback + text",7,"high",-19
"SUPPRF88012",38,48,48,41,-13,47,54,48,"Pilot 8","Pilot 8: max feedback + text",7,"high",-7
"SUPPRF88012",39,49,46,67,-13,52,80,81,"Pilot 8","Pilot 8: max feedback + text",7,"high",-14
"SUPPRF88012",40,48,49,19,-1,9,20,7,"Pilot 8","Pilot 8: max feedback + text",7,"high",12
"SUPPRF88012",41,49,48,58,29,50,29,50,"Pilot 8","Pilot 8: max feedback + text",7,"high",8
"SUPPRF88012",42,48,47,88,25,48,63,48,"Pilot 8","Pilot 8: max feedback + text",7,"high",40
"SUPPRF88012",43,50,50,63,0,47,63,50,"Pilot 8","Pilot 8: max feedback + text",7,"high",13
"SUPPRF88012",44,50,51,38,-16,36,54,33,"Pilot 8","Pilot 8: max feedback + text",7,"high",5
"SUPPRF88012",45,49,46,28,-1,14,29,10,"Pilot 8","Pilot 8: max feedback + text",7,"high",18
"SUPPRF88012",46,29,49,16,-13,21,29,23,"Pilot 8","Pilot 8: max feedback + text",7,"high",-7
"SUPPRF88012",47,49,51,94,23,49,71,47,"Pilot 8","Pilot 8: max feedback + text",7,"high",47
"SUPPRF88012",48,49,49,71,0,48,71,48,"Pilot 8","Pilot 8: max feedback + text",7,"high",23
"SUPPRF88145",1,51,100,38,-16,70,54,50,"Pilot 11","Pilot 11: bigger feedback + video + socially anxious",12,"high",-12
"SUPPRF88145",2,80,100,47,27,95,20,1,"Pilot 11","Pilot 11: bigger feedback + video + socially anxious",12,"high",46
"SUPPRF88145",3,64,100,38,1,80,37,80,"Pilot 11","Pilot 11: bigger feedback + video + socially anxious",12,"high",-42
"SUPPRF88145",4,77,100,62,-1,80,63,70,"Pilot 11","Pilot 11: bigger feedback + video + socially anxious",12,"high",-8
"SUPPRF88145",5,84,96,83,12,80,71,60,"Pilot 11","Pilot 11: bigger feedback + video + socially anxious",12,"high",23
"SUPPRF88145",6,80,100,61,24,80,37,30,"Pilot 11","Pilot 11: bigger feedback + video + socially anxious",12,"high",31
"SUPPRF88145",7,43,100,15,-14,0,29,20,"Pilot 11","Pilot 11: bigger feedback + video + socially anxious",12,"high",-5
"SUPPRF88145",8,100,100,58,12,0,46,60,"Pilot 11","Pilot 11: bigger feedback + video + socially anxious",12,"high",-2
"SUPPRF88145",9,0,100,6,-14,0,20,30,"Pilot 11","Pilot 11: bigger feedback + video + socially anxious",12,"high",-24
"SUPPRF88145",10,96,90,88,25,95,63,80,"Pilot 11","Pilot 11: bigger feedback + video + socially anxious",12,"high",8
"SUPPRF88145",11,72,24,70,-1,0,71,60,"Pilot 11","Pilot 11: bigger feedback + video + socially anxious",12,"high",10
"SUPPRF88145",12,39,100,78,24,0,54,20,"Pilot 11","Pilot 11: bigger feedback + video + socially anxious",12,"high",58
"SUPPRF88145",13,75,100,24,-13,80,37,80,"Pilot 11","Pilot 11: bigger feedback + video + socially anxious",12,"high",-56
"SUPPRF88145",14,69,13,66,12,80,54,80,"Pilot 11","Pilot 11: bigger feedback + video + socially anxious",12,"high",-14
"SUPPRF88145",15,88,56,45,-1,100,46,35,"Pilot 11","Pilot 11: bigger feedback + video + socially anxious",12,"high",10
"SUPPRF88145",16,77,0,100,20,0,80,60,"Pilot 11","Pilot 11: bigger feedback + video + socially anxious",12,"high",40
"SUPPRF88145",17,0,78,67,-13,0,80,80,"Pilot 11","Pilot 11: bigger feedback + video + socially anxious",12,"high",-13
"SUPPRF88145",18,76,80,54,0,45,54,75,"Pilot 11","Pilot 11: bigger feedback + video + socially anxious",12,"high",-21
"SUPPRF88145",19,100,15,56,-15,100,71,100,"Pilot 11","Pilot 11: bigger feedback + video + socially anxious",12,"high",-44
"SUPPRF88145",20,100,4,94,23,100,71,75,"Pilot 11","Pilot 11: bigger feedback + video + socially anxious",12,"high",19
"SUPPRF88145",21,88,51,80,0,100,80,35,"Pilot 11","Pilot 11: bigger feedback + video + socially anxious",12,"high",45
"SUPPRF88145",22,51,82,37,0,15,37,50,"Pilot 11","Pilot 11: bigger feedback + video + socially anxious",12,"high",-13
"SUPPRF88145",23,69,25,63,0,100,63,100,"Pilot 11","Pilot 11: bigger feedback + video + socially anxious",12,"high",-37
"SUPPRF88145",24,63,73,77,14,0,63,45,"Pilot 11","Pilot 11: bigger feedback + video + socially anxious",12,"high",32
"SUPPRF88145",25,86,52,50,-13,0,63,90,"Pilot 11","Pilot 11: bigger feedback + video + socially anxious",12,"high",-40
"SUPPRF88145",26,59,100,34,-12,10,46,55,"Pilot 11","Pilot 11: bigger feedback + video + socially anxious",12,"high",-21
"SUPPRF88145",27,100,0,81,1,65,80,70,"Pilot 11","Pilot 11: bigger feedback + video + socially anxious",12,"high",11
"SUPPRF88145",28,0,100,22,-15,100,37,45,"Pilot 11","Pilot 11: bigger feedback + video + socially anxious",12,"high",-23
"SUPPRF88145",29,0,100,41,-13,80,54,75,"Pilot 11","Pilot 11: bigger feedback + video + socially anxious",12,"high",-34
"SUPPRF88145",30,100,84,46,0,40,46,45,"Pilot 11","Pilot 11: bigger feedback + video + socially anxious",12,"high",1
"SUPPRF88145",31,64,4,28,-1,100,29,25,"Pilot 11","Pilot 11: bigger feedback + video + socially anxious",12,"high",3
"SUPPRF88145",32,100,0,71,0,0,71,30,"Pilot 11","Pilot 11: bigger feedback + video + socially anxious",12,"high",41
"SUPPRF88145",33,2,0,8,-12,90,20,40,"Pilot 11","Pilot 11: bigger feedback + video + socially anxious",12,"high",-32
"SUPPRF88145",34,0,95,16,-13,85,29,80,"Pilot 11","Pilot 11: bigger feedback + video + socially anxious",12,"high",-64
"SUPPRF88145",35,57,43,55,1,20,54,60,"Pilot 11","Pilot 11: bigger feedback + video + socially anxious",12,"high",-5
"SUPPRF88145",36,96,3,96,16,95,80,100,"Pilot 11","Pilot 11: bigger feedback + video + socially anxious",12,"high",-4
"SUPPRF88145",37,100,0,75,29,0,46,65,"Pilot 11","Pilot 11: bigger feedback + video + socially anxious",12,"high",10
"SUPPRF88145",38,81,14,47,-16,25,63,60,"Pilot 11","Pilot 11: bigger feedback + video + socially anxious",12,"high",-13
"SUPPRF88145",39,66,71,19,-1,0,20,10,"Pilot 11","Pilot 11: bigger feedback + video + socially anxious",12,"high",9
"SUPPRF88145",40,66,30,46,17,85,29,70,"Pilot 11","Pilot 11: bigger feedback + video + socially anxious",12,"high",-24
"SUPPRF88145",41,89,4,58,29,80,29,20,"Pilot 11","Pilot 11: bigger feedback + video + socially anxious",12,"high",38
"SUPPRF88145",42,35,8,29,0,100,29,70,"Pilot 11","Pilot 11: bigger feedback + video + socially anxious",12,"high",-41
"SUPPRF88145",43,99,6,49,12,100,37,50,"Pilot 11","Pilot 11: bigger feedback + video + socially anxious",12,"high",-1
"SUPPRF88145",44,73,1,20,0,40,20,70,"Pilot 11","Pilot 11: bigger feedback + video + socially anxious",12,"high",-50
"SUPPRF88145",45,72,3,35,15,0,20,40,"Pilot 11","Pilot 11: bigger feedback + video + socially anxious",12,"high",-5
"SUPPRF88145",46,85,12,33,-13,60,46,20,"Pilot 11","Pilot 11: bigger feedback + video + socially anxious",12,"high",13
"SUPPRF88145",47,100,1,68,-12,90,80,80,"Pilot 11","Pilot 11: bigger feedback + video + socially anxious",12,"high",-12
"SUPPRF88145",48,97,1,55,-16,1,71,40,"Pilot 11","Pilot 11: bigger feedback + video + socially anxious",12,"high",15
"SUPPRF88148",1,51,2,94,23,26,71,41,"Pilot 9","Pilot 9: bigger feedback + text",9,"high",53
"SUPPRF88148",2,55,0,100,20,14,80,44,"Pilot 9","Pilot 9: bigger feedback + text",9,"high",56
"SUPPRF88148",3,49,2,77,14,58,63,51,"Pilot 9","Pilot 9: bigger feedback + text",9,"high",26
"SUPPRF88148",4,39,1,16,-13,15,29,52,"Pilot 9","Pilot 9: bigger feedback + text",9,"high",-36
"SUPPRF88148",5,53,2,70,-1,60,71,57,"Pilot 9","Pilot 9: bigger feedback + text",9,"high",13
"SUPPRF88148",6,47,1,29,0,63,29,18,"Pilot 9","Pilot 9: bigger feedback + text",9,"high",11
"SUPPRF88148",7,45,1,41,-13,73,54,48,"Pilot 9","Pilot 9: bigger feedback + text",9,"high",-7
"SUPPRF88148",8,65,1,45,-1,74,46,11,"Pilot 9","Pilot 9: bigger feedback + text",9,"high",34
"SUPPRF88148",9,57,3,56,-15,70,71,60,"Pilot 9","Pilot 9: bigger feedback + text",9,"high",-4
"SUPPRF88148",10,52,1,28,-1,50,29,27,"Pilot 9","Pilot 9: bigger feedback + text",9,"high",1
"SUPPRF88148",11,50,1,46,0,33,46,22,"Pilot 9","Pilot 9: bigger feedback + text",9,"high",24
"SUPPRF88148",12,54,3,71,0,61,71,62,"Pilot 9","Pilot 9: bigger feedback + text",9,"high",9
"SUPPRF88148",13,47,5,47,27,35,20,24,"Pilot 9","Pilot 9: bigger feedback + text",9,"high",23
"SUPPRF88148",14,60,1,58,29,60,29,18,"Pilot 9","Pilot 9: bigger feedback + text",9,"high",40
"SUPPRF88148",15,49,2,35,15,61,20,16,"Pilot 9","Pilot 9: bigger feedback + text",9,"high",19
"SUPPRF88148",16,53,2,81,1,53,80,64,"Pilot 9","Pilot 9: bigger feedback + text",9,"high",17
"SUPPRF88148",17,61,1,54,0,47,54,39,"Pilot 9","Pilot 9: bigger feedback + text",9,"high",15
"SUPPRF88148",18,45,0,49,12,60,37,29,"Pilot 9","Pilot 9: bigger feedback + text",9,"high",20
"SUPPRF88148",19,50,0,22,-15,60,37,35,"Pilot 9","Pilot 9: bigger feedback + text",9,"high",-13
"SUPPRF88148",20,53,1,55,-16,51,71,47,"Pilot 9","Pilot 9: bigger feedback + text",9,"high",8
"SUPPRF88148",21,44,2,38,1,14,37,29,"Pilot 9","Pilot 9: bigger feedback + text",9,"high",9
"SUPPRF88148",22,45,5,50,-13,67,63,29,"Pilot 9","Pilot 9: bigger feedback + text",9,"high",21
"SUPPRF88148",23,45,0,61,24,14,37,22,"Pilot 9","Pilot 9: bigger feedback + text",9,"high",39
"SUPPRF88148",24,43,0,38,-16,44,54,35,"Pilot 9","Pilot 9: bigger feedback + text",9,"high",3
"SUPPRF88148",25,44,1,47,-16,52,63,29,"Pilot 9","Pilot 9: bigger feedback + text",9,"high",18
"SUPPRF88148",26,52,1,80,0,73,80,50,"Pilot 9","Pilot 9: bigger feedback + text",9,"high",30
"SUPPRF88148",27,41,0,83,12,53,71,52,"Pilot 9","Pilot 9: bigger feedback + text",9,"high",31
"SUPPRF88148",28,29,1,62,-1,67,63,31,"Pilot 9","Pilot 9: bigger feedback + text",9,"high",31
"SUPPRF88148",29,45,2,67,-13,67,80,79,"Pilot 9","Pilot 9: bigger feedback + text",9,"high",-12
"SUPPRF88148",30,31,53,37,0,52,37,31,"Pilot 9","Pilot 9: bigger feedback + text",9,"high",6
"SUPPRF88148",31,57,8,78,24,68,54,19,"Pilot 9","Pilot 9: bigger feedback + text",9,"high",59
"SUPPRF88148",32,52,0,15,-14,86,29,20,"Pilot 9","Pilot 9: bigger feedback + text",9,"high",-5
"SUPPRF88148",33,35,0,88,25,79,63,26,"Pilot 9","Pilot 9: bigger feedback + text",9,"high",62
"SUPPRF88148",34,32,19,20,0,76,20,24,"Pilot 9","Pilot 9: bigger feedback + text",9,"high",-4
"SUPPRF88148",35,30,5,46,17,85,29,15,"Pilot 9","Pilot 9: bigger feedback + text",9,"high",31
"SUPPRF88148",36,25,1,33,-13,55,46,34,"Pilot 9","Pilot 9: bigger feedback + text",9,"high",-1
"SUPPRF88148",37,26,4,96,16,20,80,38,"Pilot 9","Pilot 9: bigger feedback + text",9,"high",58
"SUPPRF88148",38,26,0,19,-1,63,20,16,"Pilot 9","Pilot 9: bigger feedback + text",9,"high",3
"SUPPRF88148",39,28,2,68,-12,82,80,6,"Pilot 9","Pilot 9: bigger feedback + text",9,"high",62
"SUPPRF88148",40,29,3,55,1,70,54,18,"Pilot 9","Pilot 9: bigger feedback + text",9,"high",37
"SUPPRF88148",41,7,7,66,12,88,54,13,"Pilot 9","Pilot 9: bigger feedback + text",9,"high",53
"SUPPRF88148",42,33,7,34,-12,62,46,49,"Pilot 9","Pilot 9: bigger feedback + text",9,"high",-15
"SUPPRF88148",43,32,10,24,-13,20,37,24,"Pilot 9","Pilot 9: bigger feedback + text",9,"high",0
"SUPPRF88148",44,12,6,8,-12,20,20,16,"Pilot 9","Pilot 9: bigger feedback + text",9,"high",-8
"SUPPRF88148",45,72,1,75,29,26,46,32,"Pilot 9","Pilot 9: bigger feedback + text",9,"high",43
"SUPPRF88148",46,35,6,63,0,69,63,64,"Pilot 9","Pilot 9: bigger feedback + text",9,"high",-1
"SUPPRF88148",47,15,2,6,-14,69,20,13,"Pilot 9","Pilot 9: bigger feedback + text",9,"high",-7
"SUPPRF88148",48,21,2,58,12,11,46,38,"Pilot 9","Pilot 9: bigger feedback + text",9,"high",20
"SUPPRF89348",1,60,39,55,-16,76,71,61,"Pilot 10","Pilot 10: bigger feedback + video",3,"low",-6
"SUPPRF89348",2,27,14,47,27,80,20,82,"Pilot 10","Pilot 10: bigger feedback + video",3,"low",-35
"SUPPRF89348",3,16,26,29,0,62,29,32,"Pilot 10","Pilot 10: bigger feedback + video",3,"low",-3
"SUPPRF89348",4,34,23,94,23,19,71,40,"Pilot 10","Pilot 10: bigger feedback + video",3,"low",54
"SUPPRF89348",5,47,16,78,24,7,54,90,"Pilot 10","Pilot 10: bigger feedback + video",3,"low",-12
"SUPPRF89348",6,49,11,50,-13,2,63,90,"Pilot 10","Pilot 10: bigger feedback + video",3,"low",-40
"SUPPRF89348",7,57,21,70,-1,3,71,78,"Pilot 10","Pilot 10: bigger feedback + video",3,"low",-8
"SUPPRF89348",8,43,13,67,-13,1,80,45,"Pilot 10","Pilot 10: bigger feedback + video",3,"low",22
"SUPPRF89348",9,42,26,55,1,4,54,90,"Pilot 10","Pilot 10: bigger feedback + video",3,"low",-35
"SUPPRF89348",10,33,18,37,0,1,37,87,"Pilot 10","Pilot 10: bigger feedback + video",3,"low",-50
"SUPPRF89348",11,14,19,38,1,13,37,75,"Pilot 10","Pilot 10: bigger feedback + video",3,"low",-37
"SUPPRF89348",12,34,11,34,-12,5,46,64,"Pilot 10","Pilot 10: bigger feedback + video",3,"low",-30
"SUPPRF89348",13,39,41,62,-1,9,63,44,"Pilot 10","Pilot 10: bigger feedback + video",3,"low",18
"SUPPRF89348",14,26,9,20,0,5,20,48,"Pilot 10","Pilot 10: bigger feedback + video",3,"low",-28
"SUPPRF89348",15,54,22,81,1,4,80,17,"Pilot 10","Pilot 10: bigger feedback + video",3,"low",64
"SUPPRF89348",16,28,13,22,-15,7,37,43,"Pilot 10","Pilot 10: bigger feedback + video",3,"low",-21
"SUPPRF89348",17,46,8,58,12,1,46,52,"Pilot 10","Pilot 10: bigger feedback + video",3,"low",6
"SUPPRF89348",18,66,30,88,25,2,63,61,"Pilot 10","Pilot 10: bigger feedback + video",3,"low",27
"SUPPRF89348",19,6,10,6,-14,11,20,47,"Pilot 10","Pilot 10: bigger feedback + video",3,"low",-41
"SUPPRF89348",20,48,8,66,12,3,54,78,"Pilot 10","Pilot 10: bigger feedback + video",3,"low",-12
"SUPPRF89348",21,45,16,46,0,6,46,78,"Pilot 10","Pilot 10: bigger feedback + video",3,"low",-32
"SUPPRF89348",22,54,18,83,12,9,71,32,"Pilot 10","Pilot 10: bigger feedback + video",3,"low",51
"SUPPRF89348",23,39,12,15,-14,15,29,16,"Pilot 10","Pilot 10: bigger feedback + video",3,"low",-1
"SUPPRF89348",24,48,13,75,29,5,46,7,"Pilot 10","Pilot 10: bigger feedback + video",3,"low",68
"SUPPRF89348",25,47,11,35,15,5,20,91,"Pilot 10","Pilot 10: bigger feedback + video",3,"low",-56
"SUPPRF89348",26,46,9,33,-13,6,46,41,"Pilot 10","Pilot 10: bigger feedback + video",3,"low",-8
"SUPPRF89348",27,46,47,46,17,4,29,47,"Pilot 10","Pilot 10: bigger feedback + video",3,"low",-1
"SUPPRF89348",28,21,16,16,-13,6,29,70,"Pilot 10","Pilot 10: bigger feedback + video",3,"low",-54
"SUPPRF89348",29,37,70,54,0,12,54,80,"Pilot 10","Pilot 10: bigger feedback + video",3,"low",-26
"SUPPRF89348",30,44,8,45,-1,8,46,87,"Pilot 10","Pilot 10: bigger feedback + video",3,"low",-42
"SUPPRF89348",31,13,12,24,-13,7,37,89,"Pilot 10","Pilot 10: bigger feedback + video",3,"low",-65
"SUPPRF89348",32,6,10,8,-12,10,20,62,"Pilot 10","Pilot 10: bigger feedback + video",3,"low",-54
"SUPPRF89348",33,66,28,100,20,16,80,71,"Pilot 10","Pilot 10: bigger feedback + video",3,"low",29
"SUPPRF89348",34,54,17,47,-16,7,63,57,"Pilot 10","Pilot 10: bigger feedback + video",3,"low",-10
"SUPPRF89348",35,61,18,71,0,10,71,77,"Pilot 10","Pilot 10: bigger feedback + video",3,"low",-6
"SUPPRF89348",36,47,28,56,-15,4,71,47,"Pilot 10","Pilot 10: bigger feedback + video",3,"low",9
"SUPPRF89348",37,70,25,77,14,4,63,22,"Pilot 10","Pilot 10: bigger feedback + video",3,"low",55
"SUPPRF89348",38,44,15,19,-1,8,20,45,"Pilot 10","Pilot 10: bigger feedback + video",3,"low",-26
"SUPPRF89348",39,80,14,80,0,3,80,55,"Pilot 10","Pilot 10: bigger feedback + video",3,"low",25
"SUPPRF89348",40,41,16,68,-12,3,80,78,"Pilot 10","Pilot 10: bigger feedback + video",3,"low",-10
"SUPPRF89348",41,25,34,61,24,6,37,20,"Pilot 10","Pilot 10: bigger feedback + video",3,"low",41
"SUPPRF89348",42,20,21,28,-1,4,29,42,"Pilot 10","Pilot 10: bigger feedback + video",3,"low",-14
"SUPPRF89348",43,45,39,38,-16,2,54,54,"Pilot 10","Pilot 10: bigger feedback + video",3,"low",-16
"SUPPRF89348",44,39,22,58,29,4,29,23,"Pilot 10","Pilot 10: bigger feedback + video",3,"low",35
"SUPPRF89348",45,47,46,49,12,2,37,63,"Pilot 10","Pilot 10: bigger feedback + video",3,"low",-14
"SUPPRF89348",46,87,18,96,16,3,80,88,"Pilot 10","Pilot 10: bigger feedback + video",3,"low",8
"SUPPRF89348",47,41,46,41,-13,6,54,47,"Pilot 10","Pilot 10: bigger feedback + video",3,"low",-6
"SUPPRF89348",48,55,25,63,0,3,63,44,"Pilot 10","Pilot 10: bigger feedback + video",3,"low",19
"SUPPRF89542",1,87,12,55,-16,84,71,75,"Pilot 10","Pilot 10: bigger feedback + video",1,"low",-20
"SUPPRF89542",2,81,16,46,17,48,29,66,"Pilot 10","Pilot 10: bigger feedback + video",1,"low",-20
"SUPPRF89542",3,95,6,88,25,66,63,64,"Pilot 10","Pilot 10: bigger feedback + video",1,"low",24
"SUPPRF89542",4,82,16,68,-12,76,80,85,"Pilot 10","Pilot 10: bigger feedback + video",1,"low",-17
"SUPPRF89542",5,78,26,38,1,25,37,67,"Pilot 10","Pilot 10: bigger feedback + video",1,"low",-29
"SUPPRF89542",6,92,13,75,29,41,46,77,"Pilot 10","Pilot 10: bigger feedback + video",1,"low",-2
"SUPPRF89542",7,76,24,28,-1,0,29,55,"Pilot 10","Pilot 10: bigger feedback + video",1,"low",-27
"SUPPRF89542",8,35,20,16,-13,25,29,63,"Pilot 10","Pilot 10: bigger feedback + video",1,"low",-47
"SUPPRF89542",9,37,52,8,-12,42,20,73,"Pilot 10","Pilot 10: bigger feedback + video",1,"low",-65
"SUPPRF89542",10,72,43,67,-13,62,80,74,"Pilot 10","Pilot 10: bigger feedback + video",1,"low",-7
"SUPPRF89542",11,52,35,22,-15,53,37,76,"Pilot 10","Pilot 10: bigger feedback + video",1,"low",-54
"SUPPRF89542",12,64,44,15,-14,27,29,66,"Pilot 10","Pilot 10: bigger feedback + video",1,"low",-51
"SUPPRF89542",13,90,13,94,23,41,71,70,"Pilot 10","Pilot 10: bigger feedback + video",1,"low",24
"SUPPRF89542",14,32,61,29,0,40,29,70,"Pilot 10","Pilot 10: bigger feedback + video",1,"low",-41
"SUPPRF89542",15,75,21,50,-13,62,63,74,"Pilot 10","Pilot 10: bigger feedback + video",1,"low",-24
"SUPPRF89542",16,78,14,71,0,56,71,71,"Pilot 10","Pilot 10: bigger feedback + video",1,"low",0
"SUPPRF89542",17,72,23,61,24,55,37,68,"Pilot 10","Pilot 10: bigger feedback + video",1,"low",-7
"SUPPRF89542",18,79,10,83,12,63,71,76,"Pilot 10","Pilot 10: bigger feedback + video",1,"low",7
"SUPPRF89542",19,94,9,100,20,10,80,19,"Pilot 10","Pilot 10: bigger feedback + video",1,"low",81
"SUPPRF89542",20,60,33,35,15,53,20,80,"Pilot 10","Pilot 10: bigger feedback + video",1,"low",-45
"SUPPRF89542",21,82,15,70,-1,35,71,73,"Pilot 10","Pilot 10: bigger feedback + video",1,"low",-3
"SUPPRF89542",22,65,22,54,0,75,54,47,"Pilot 10","Pilot 10: bigger feedback + video",1,"low",7
"SUPPRF89542",23,60,16,56,-15,43,71,81,"Pilot 10","Pilot 10: bigger feedback + video",1,"low",-25
"SUPPRF89542",24,75,26,49,12,22,37,51,"Pilot 10","Pilot 10: bigger feedback + video",1,"low",-2
"SUPPRF89542",25,31,13,6,-14,82,20,68,"Pilot 10","Pilot 10: bigger feedback + video",1,"low",-62
"SUPPRF89542",26,45,32,38,-16,69,54,81,"Pilot 10","Pilot 10: bigger feedback + video",1,"low",-43
"SUPPRF89542",27,90,17,96,16,58,80,72,"Pilot 10","Pilot 10: bigger feedback + video",1,"low",24
"SUPPRF89542",28,67,24,58,29,72,29,79,"Pilot 10","Pilot 10: bigger feedback + video",1,"low",-21
"SUPPRF89542",29,86,10,81,1,55,80,79,"Pilot 10","Pilot 10: bigger feedback + video",1,"low",2
"SUPPRF89542",30,37,61,63,0,59,63,74,"Pilot 10","Pilot 10: bigger feedback + video",1,"low",-11
"SUPPRF89542",31,70,32,24,-13,48,37,64,"Pilot 10","Pilot 10: bigger feedback + video",1,"low",-40
"SUPPRF89542",32,81,25,33,-13,58,46,79,"Pilot 10","Pilot 10: bigger feedback + video",1,"low",-46
"SUPPRF89542",33,74,32,47,27,63,20,68,"Pilot 10","Pilot 10: bigger feedback + video",1,"low",-21
"SUPPRF89542",34,83,26,46,0,26,46,49,"Pilot 10","Pilot 10: bigger feedback + video",1,"low",-3
"SUPPRF89542",35,79,25,34,-12,52,46,72,"Pilot 10","Pilot 10: bigger feedback + video",1,"low",-38
"SUPPRF89542",36,77,28,19,-1,67,20,79,"Pilot 10","Pilot 10: bigger feedback + video",1,"low",-60
"SUPPRF89542",37,70,24,80,0,57,80,73,"Pilot 10","Pilot 10: bigger feedback + video",1,"low",7
"SUPPRF89542",38,83,35,62,-1,54,63,68,"Pilot 10","Pilot 10: bigger feedback + video",1,"low",-6
"SUPPRF89542",39,67,19,55,1,11,54,42,"Pilot 10","Pilot 10: bigger feedback + video",1,"low",13
"SUPPRF89542",40,81,11,47,-16,34,63,76,"Pilot 10","Pilot 10: bigger feedback + video",1,"low",-29
"SUPPRF89542",41,57,21,41,-13,37,54,70,"Pilot 10","Pilot 10: bigger feedback + video",1,"low",-29
"SUPPRF89542",42,81,54,58,12,26,46,52,"Pilot 10","Pilot 10: bigger feedback + video",1,"low",6
"SUPPRF89542",43,72,37,45,-1,50,46,66,"Pilot 10","Pilot 10: bigger feedback + video",1,"low",-21
"SUPPRF89542",44,81,44,77,14,61,63,72,"Pilot 10","Pilot 10: bigger feedback + video",1,"low",5
"SUPPRF89542",45,72,34,66,12,45,54,67,"Pilot 10","Pilot 10: bigger feedback + video",1,"low",-1
"SUPPRF89542",46,28,63,20,0,65,20,92,"Pilot 10","Pilot 10: bigger feedback + video",1,"low",-72
"SUPPRF89542",47,72,15,78,24,66,54,76,"Pilot 10","Pilot 10: bigger feedback + video",1,"low",2
"SUPPRF89542",48,76,56,37,0,60,37,79,"Pilot 10","Pilot 10: bigger feedback + video",1,"low",-42
"SUPPRF90079",1,71,28,16,-13,88,29,27,"Pilot 9","Pilot 9: bigger feedback + text",9,"high",-11
"SUPPRF90079",2,89,6,35,15,96,20,9,"Pilot 9","Pilot 9: bigger feedback + text",9,"high",26
"SUPPRF90079",3,79,12,50,-13,71,63,75,"Pilot 9","Pilot 9: bigger feedback + text",9,"high",-25
"SUPPRF90079",4,88,12,47,27,63,20,44,"Pilot 9","Pilot 9: bigger feedback + text",9,"high",3
"SUPPRF90079",5,90,12,61,24,73,37,51,"Pilot 9","Pilot 9: bigger feedback + text",9,"high",10
"SUPPRF90079",6,84,12,19,-1,63,20,65,"Pilot 9","Pilot 9: bigger feedback + text",9,"high",-46
"SUPPRF90079",7,80,8,20,0,31,20,63,"Pilot 9","Pilot 9: bigger feedback + text",9,"high",-43
"SUPPRF90079",8,89,6,71,0,25,71,62,"Pilot 9","Pilot 9: bigger feedback + text",9,"high",9
"SUPPRF90079",9,86,10,46,17,25,29,50,"Pilot 9","Pilot 9: bigger feedback + text",9,"high",-4
"SUPPRF90079",10,89,8,8,-12,14,20,79,"Pilot 9","Pilot 9: bigger feedback + text",9,"high",-71
"SUPPRF90079",11,94,7,15,-14,22,29,100,"Pilot 9","Pilot 9: bigger feedback + text",9,"high",-85
"SUPPRF90079",12,87,7,58,12,59,46,56,"Pilot 9","Pilot 9: bigger feedback + text",9,"high",2
"SUPPRF90079",13,88,9,67,-13,10,80,59,"Pilot 9","Pilot 9: bigger feedback + text",9,"high",8
"SUPPRF90079",14,87,10,38,1,73,37,56,"Pilot 9","Pilot 9: bigger feedback + text",9,"high",-18
"SUPPRF90079",15,87,7,29,0,22,29,70,"Pilot 9","Pilot 9: bigger feedback + text",9,"high",-41
"SUPPRF90079",16,87,12,38,-16,12,54,61,"Pilot 9","Pilot 9: bigger feedback + text",9,"high",-23
"SUPPRF90079",17,87,5,24,-13,15,37,67,"Pilot 9","Pilot 9: bigger feedback + text",9,"high",-43
"SUPPRF90079",18,97,5,63,0,18,63,80,"Pilot 9","Pilot 9: bigger feedback + text",9,"high",-17
"SUPPRF90079",19,90,7,100,20,19,80,73,"Pilot 9","Pilot 9: bigger feedback + text",9,"high",27
"SUPPRF90079",20,88,7,41,-13,16,54,79,"Pilot 9","Pilot 9: bigger feedback + text",9,"high",-38
"SUPPRF90079",21,86,9,33,-13,29,46,42,"Pilot 9","Pilot 9: bigger feedback + text",9,"high",-9
"SUPPRF90079",22,85,10,55,-16,14,71,70,"Pilot 9","Pilot 9: bigger feedback + text",9,"high",-15
"SUPPRF90079",23,100,0,37,0,60,37,89,"Pilot 9","Pilot 9: bigger feedback + text",9,"high",-52
"SUPPRF90079",24,100,2,58,29,22,29,73,"Pilot 9","Pilot 9: bigger feedback + text",9,"high",-15
"SUPPRF90079",25,86,10,68,-12,11,80,90,"Pilot 9","Pilot 9: bigger feedback + text",9,"high",-22
"SUPPRF90079",26,83,8,34,-12,75,46,66,"Pilot 9","Pilot 9: bigger feedback + text",9,"high",-32
"SUPPRF90079",27,83,18,47,-16,16,63,72,"Pilot 9","Pilot 9: bigger feedback + text",9,"high",-25
"SUPPRF90079",28,86,11,80,0,15,80,72,"Pilot 9","Pilot 9: bigger feedback + text",9,"high",8
"SUPPRF90079",29,91,9,83,12,18,71,69,"Pilot 9","Pilot 9: bigger feedback + text",9,"high",14
"SUPPRF90079",30,80,11,49,12,12,37,66,"Pilot 9","Pilot 9: bigger feedback + text",9,"high",-17
"SUPPRF90079",31,87,14,94,23,18,71,75,"Pilot 9","Pilot 9: bigger feedback + text",9,"high",19
"SUPPRF90079",32,91,5,96,16,69,80,66,"Pilot 9","Pilot 9: bigger feedback + text",9,"high",30
"SUPPRF90079",33,91,11,78,24,19,54,71,"Pilot 9","Pilot 9: bigger feedback + text",9,"high",7
"SUPPRF90079",34,85,13,45,-1,19,46,75,"Pilot 9","Pilot 9: bigger feedback + text",9,"high",-30
"SUPPRF90079",35,81,13,22,-15,11,37,76,"Pilot 9","Pilot 9: bigger feedback + text",9,"high",-54
"SUPPRF90079",36,95,9,62,-1,20,63,66,"Pilot 9","Pilot 9: bigger feedback + text",9,"high",-4
"SUPPRF90079",37,91,8,75,29,12,46,15,"Pilot 9","Pilot 9: bigger feedback + text",9,"high",60
"SUPPRF90079",38,92,7,81,1,15,80,68,"Pilot 9","Pilot 9: bigger feedback + text",9,"high",13
"SUPPRF90079",39,89,11,54,0,14,54,52,"Pilot 9","Pilot 9: bigger feedback + text",9,"high",2
"SUPPRF90079",40,88,14,88,25,20,63,49,"Pilot 9","Pilot 9: bigger feedback + text",9,"high",39
"SUPPRF90079",41,89,12,55,1,24,54,51,"Pilot 9","Pilot 9: bigger feedback + text",9,"high",4
"SUPPRF90079",42,84,13,77,14,74,63,31,"Pilot 9","Pilot 9: bigger feedback + text",9,"high",46
"SUPPRF90079",43,87,10,70,-1,22,71,59,"Pilot 9","Pilot 9: bigger feedback + text",9,"high",11
"SUPPRF90079",44,69,17,66,12,22,54,28,"Pilot 9","Pilot 9: bigger feedback + text",9,"high",38
"SUPPRF90079",45,85,13,28,-1,16,29,61,"Pilot 9","Pilot 9: bigger feedback + text",9,"high",-33
"SUPPRF90079",46,80,19,46,0,20,46,35,"Pilot 9","Pilot 9: bigger feedback + text",9,"high",11
"SUPPRF90079",47,81,11,56,-15,76,71,49,"Pilot 9","Pilot 9: bigger feedback + text",9,"high",7
"SUPPRF90079",48,84,11,6,-14,24,20,77,"Pilot 9","Pilot 9: bigger feedback + text",9,"high",-71
"SUPPRF90136",1,79,69,80,0,37,80,60,"Pilot 8","Pilot 8: max feedback + text",4,"low",20
"SUPPRF90136",2,73,66,15,-14,76,29,43,"Pilot 8","Pilot 8: max feedback + text",4,"low",-28
"SUPPRF90136",3,87,43,77,14,74,63,70,"Pilot 8","Pilot 8: max feedback + text",4,"low",7
"SUPPRF90136",4,79,42,61,24,77,37,32,"Pilot 8","Pilot 8: max feedback + text",4,"low",29
"SUPPRF90136",5,75,48,50,-13,79,63,62,"Pilot 8","Pilot 8: max feedback + text",4,"low",-12
"SUPPRF90136",6,67,58,38,1,44,37,37,"Pilot 8","Pilot 8: max feedback + text",4,"low",1
"SUPPRF90136",7,53,53,62,-1,60,63,68,"Pilot 8","Pilot 8: max feedback + text",4,"low",-6
"SUPPRF90136",8,49,57,37,0,72,37,41,"Pilot 8","Pilot 8: max feedback + text",4,"low",-4
"SUPPRF90136",9,45,60,24,-13,36,37,50,"Pilot 8","Pilot 8: max feedback + text",4,"low",-26
"SUPPRF90136",10,46,61,75,29,80,46,58,"Pilot 8","Pilot 8: max feedback + text",4,"low",17
"SUPPRF90136",11,53,66,78,24,72,54,62,"Pilot 8","Pilot 8: max feedback + text",4,"low",16
"SUPPRF90136",12,42,64,63,0,46,63,67,"Pilot 8","Pilot 8: max feedback + text",4,"low",-4
"SUPPRF90136",13,42,68,88,25,52,63,65,"Pilot 8","Pilot 8: max feedback + text",4,"low",23
"SUPPRF90136",14,38,64,67,-13,31,80,72,"Pilot 8","Pilot 8: max feedback + text",4,"low",-5
"SUPPRF90136",15,37,73,38,-16,55,54,58,"Pilot 8","Pilot 8: max feedback + text",4,"low",-20
"SUPPRF90136",16,26,62,33,-13,40,46,23,"Pilot 8","Pilot 8: max feedback + text",4,"low",10
"SUPPRF90136",17,18,67,34,-12,33,46,58,"Pilot 8","Pilot 8: max feedback + text",4,"low",-24
"SUPPRF90136",18,31,63,46,17,24,29,55,"Pilot 8","Pilot 8: max feedback + text",4,"low",-9
"SUPPRF90136",19,25,60,58,12,21,46,49,"Pilot 8","Pilot 8: max feedback + text",4,"low",9
"SUPPRF90136",20,29,65,68,-12,67,80,81,"Pilot 8","Pilot 8: max feedback + text",4,"low",-13
"SUPPRF90136",21,41,62,55,1,38,54,54,"Pilot 8","Pilot 8: max feedback + text",4,"low",1
"SUPPRF90136",22,47,60,20,0,84,20,19,"Pilot 8","Pilot 8: max feedback + text",4,"low",1
"SUPPRF90136",23,52,53,70,-1,62,71,78,"Pilot 8","Pilot 8: max feedback + text",4,"low",-8
"SUPPRF90136",24,53,61,100,20,48,80,55,"Pilot 8","Pilot 8: max feedback + text",4,"low",45
"SUPPRF90136",25,50,63,16,-13,82,29,34,"Pilot 8","Pilot 8: max feedback + text",4,"low",-18
"SUPPRF90136",26,46,51,56,-15,82,71,60,"Pilot 8","Pilot 8: max feedback + text",4,"low",-4
"SUPPRF90136",27,42,62,29,0,59,29,71,"Pilot 8","Pilot 8: max feedback + text",4,"low",-42
"SUPPRF90136",28,36,63,8,-12,15,20,7,"Pilot 8","Pilot 8: max feedback + text",4,"low",1
"SUPPRF90136",29,45,72,71,0,70,71,69,"Pilot 8","Pilot 8: max feedback + text",4,"low",2
"SUPPRF90136",30,30,60,41,-13,69,54,61,"Pilot 8","Pilot 8: max feedback + text",4,"low",-20
"SUPPRF90136",31,45,49,47,27,86,20,11,"Pilot 8","Pilot 8: max feedback + text",4,"low",36
"SUPPRF90136",32,39,57,28,-1,83,29,24,"Pilot 8","Pilot 8: max feedback + text",4,"low",4
"SUPPRF90136",33,39,51,81,1,50,80,73,"Pilot 8","Pilot 8: max feedback + text",4,"low",8
"SUPPRF90136",34,41,59,96,16,42,80,69,"Pilot 8","Pilot 8: max feedback + text",4,"low",27
"SUPPRF90136",35,42,54,45,-1,64,46,38,"Pilot 8","Pilot 8: max feedback + text",4,"low",7
"SUPPRF90136",36,34,51,94,23,57,71,61,"Pilot 8","Pilot 8: max feedback + text",4,"low",33
"SUPPRF90136",37,34,63,58,29,70,29,30,"Pilot 8","Pilot 8: max feedback + text",4,"low",28
"SUPPRF90136",38,21,77,6,-14,9,20,34,"Pilot 8","Pilot 8: max feedback + text",4,"low",-28
"SUPPRF90136",39,9,77,83,12,27,71,59,"Pilot 8","Pilot 8: max feedback + text",4,"low",24
"SUPPRF90136",40,15,73,66,12,27,54,47,"Pilot 8","Pilot 8: max feedback + text",4,"low",19
"SUPPRF90136",41,13,71,35,15,23,20,22,"Pilot 8","Pilot 8: max feedback + text",4,"low",13
"SUPPRF90136",42,19,74,55,-16,47,71,70,"Pilot 8","Pilot 8: max feedback + text",4,"low",-15
"SUPPRF90136",43,19,72,19,-1,44,20,33,"Pilot 8","Pilot 8: max feedback + text",4,"low",-14
"SUPPRF90136",44,35,73,54,0,61,54,59,"Pilot 8","Pilot 8: max feedback + text",4,"low",-5
"SUPPRF90136",45,49,65,22,-15,72,37,25,"Pilot 8","Pilot 8: max feedback + text",4,"low",-3
"SUPPRF90136",46,26,70,49,12,90,37,23,"Pilot 8","Pilot 8: max feedback + text",4,"low",26
"SUPPRF90136",47,33,76,46,0,78,46,48,"Pilot 8","Pilot 8: max feedback + text",4,"low",-2
"SUPPRF90136",48,25,62,47,-16,64,63,58,"Pilot 8","Pilot 8: max feedback + text",4,"low",-11
"SUPPRF91978",1,53,53,38,-16,53,54,44,"Pilot 9","Pilot 9: bigger feedback + text",0,"low",-6
"SUPPRF91978",2,68,28,63,0,70,63,72,"Pilot 9","Pilot 9: bigger feedback + text",0,"low",-9
"SUPPRF91978",3,50,48,6,-14,29,20,26,"Pilot 9","Pilot 9: bigger feedback + text",0,"low",-20
"SUPPRF91978",4,77,65,61,24,96,37,35,"Pilot 9","Pilot 9: bigger feedback + text",0,"low",26
"SUPPRF91978",5,97,8,75,29,97,46,60,"Pilot 9","Pilot 9: bigger feedback + text",0,"low",15
"SUPPRF91978",6,50,49,55,-16,100,71,80,"Pilot 9","Pilot 9: bigger feedback + text",0,"low",-25
"SUPPRF91978",7,52,52,33,-13,1,46,52,"Pilot 9","Pilot 9: bigger feedback + text",0,"low",-19
"SUPPRF91978",8,48,66,29,0,74,29,41,"Pilot 9","Pilot 9: bigger feedback + text",0,"low",-12
"SUPPRF91978",9,59,56,41,-13,87,54,45,"Pilot 9","Pilot 9: bigger feedback + text",0,"low",-4
"SUPPRF91978",10,73,27,88,25,94,63,97,"Pilot 9","Pilot 9: bigger feedback + text",0,"low",-9
"SUPPRF91978",11,53,57,16,-13,98,29,37,"Pilot 9","Pilot 9: bigger feedback + text",0,"low",-21
"SUPPRF91978",12,74,11,54,0,2,54,51,"Pilot 9","Pilot 9: bigger feedback + text",0,"low",3
"SUPPRF91978",13,73,49,70,-1,1,71,44,"Pilot 9","Pilot 9: bigger feedback + text",0,"low",26
"SUPPRF91978",14,68,8,71,0,91,71,78,"Pilot 9","Pilot 9: bigger feedback + text",0,"low",-7
"SUPPRF91978",15,69,25,46,0,47,46,45,"Pilot 9","Pilot 9: bigger feedback + text",0,"low",1
"SUPPRF91978",16,48,57,77,14,1,63,50,"Pilot 9","Pilot 9: bigger feedback + text",0,"low",27
"SUPPRF91978",17,31,37,24,-13,78,37,81,"Pilot 9","Pilot 9: bigger feedback + text",0,"low",-57
"SUPPRF91978",18,68,61,68,-12,86,80,73,"Pilot 9","Pilot 9: bigger feedback + text",0,"low",-5
"SUPPRF91978",19,50,48,37,0,66,37,37,"Pilot 9","Pilot 9: bigger feedback + text",0,"low",0
"SUPPRF91978",20,53,51,47,27,70,20,20,"Pilot 9","Pilot 9: bigger feedback + text",0,"low",27
"SUPPRF91978",21,50,50,47,-16,3,63,35,"Pilot 9","Pilot 9: bigger feedback + text",0,"low",12
"SUPPRF91978",22,35,37,15,-14,18,29,87,"Pilot 9","Pilot 9: bigger feedback + text",0,"low",-72
"SUPPRF91978",23,47,1,38,1,2,37,54,"Pilot 9","Pilot 9: bigger feedback + text",0,"low",-16
"SUPPRF91978",24,31,38,62,-1,2,63,53,"Pilot 9","Pilot 9: bigger feedback + text",0,"low",9
"SUPPRF91978",25,45,50,22,-15,0,37,45,"Pilot 9","Pilot 9: bigger feedback + text",0,"low",-23
"SUPPRF91978",26,49,47,55,1,1,54,50,"Pilot 9","Pilot 9: bigger feedback + text",0,"low",5
"SUPPRF91978",27,51,55,45,-1,0,46,70,"Pilot 9","Pilot 9: bigger feedback + text",0,"low",-25
"SUPPRF91978",28,49,51,46,17,48,29,60,"Pilot 9","Pilot 9: bigger feedback + text",0,"low",-14
"SUPPRF91978",29,47,49,56,-15,2,71,55,"Pilot 9","Pilot 9: bigger feedback + text",0,"low",1
"SUPPRF91978",30,57,29,35,15,83,20,17,"Pilot 9","Pilot 9: bigger feedback + text",0,"low",18
"SUPPRF91978",31,56,51,66,12,48,54,51,"Pilot 9","Pilot 9: bigger feedback + text",0,"low",15
"SUPPRF91978",32,17,94,34,-12,23,46,32,"Pilot 9","Pilot 9: bigger feedback + text",0,"low",2
"SUPPRF91978",33,21,72,19,-1,9,20,12,"Pilot 9","Pilot 9: bigger feedback + text",0,"low",7
"SUPPRF91978",34,1,99,58,12,14,46,39,"Pilot 9","Pilot 9: bigger feedback + text",0,"low",19
"SUPPRF91978",35,0,100,96,16,10,80,89,"Pilot 9","Pilot 9: bigger feedback + text",0,"low",7
"SUPPRF91978",36,1,99,58,29,8,29,55,"Pilot 9","Pilot 9: bigger feedback + text",0,"low",3
"SUPPRF91978",37,12,47,94,23,3,71,33,"Pilot 9","Pilot 9: bigger feedback + text",0,"low",61
"SUPPRF91978",38,24,73,8,-12,69,20,31,"Pilot 9","Pilot 9: bigger feedback + text",0,"low",-23
"SUPPRF91978",39,16,84,80,0,41,80,81,"Pilot 9","Pilot 9: bigger feedback + text",0,"low",-1
"SUPPRF91978",40,25,77,81,1,9,80,73,"Pilot 9","Pilot 9: bigger feedback + text",0,"low",8
"SUPPRF91978",41,52,65,49,12,2,37,58,"Pilot 9","Pilot 9: bigger feedback + text",0,"low",-9
"SUPPRF91978",42,19,72,67,-13,75,80,84,"Pilot 9","Pilot 9: bigger feedback + text",0,"low",-17
"SUPPRF91978",43,30,79,100,20,2,80,72,"Pilot 9","Pilot 9: bigger feedback + text",0,"low",28
"SUPPRF91978",44,51,49,28,-1,2,29,42,"Pilot 9","Pilot 9: bigger feedback + text",0,"low",-14
"SUPPRF91978",45,53,55,50,-13,80,63,96,"Pilot 9","Pilot 9: bigger feedback + text",0,"low",-46
"SUPPRF91978",46,51,55,78,24,71,54,65,"Pilot 9","Pilot 9: bigger feedback + text",0,"low",13
"SUPPRF91978",47,47,47,83,12,0,71,50,"Pilot 9","Pilot 9: bigger feedback + text",0,"low",33
"SUPPRF91978",48,49,49,20,0,76,20,13,"Pilot 9","Pilot 9: bigger feedback + text",0,"low",7
"SUPPRF93027",1,51,12,8,-12,29,20,26,"Pilot 7","Pilot 7: bigger feedback + text",6,"high",-18
"SUPPRF93027",2,58,14,46,17,25,29,31,"Pilot 7","Pilot 7: bigger feedback + text",6,"high",15
"SUPPRF93027",3,64,12,38,1,13,37,33,"Pilot 7","Pilot 7: bigger feedback + text",6,"high",5
"SUPPRF93027",4,14,61,15,-14,20,29,51,"Pilot 7","Pilot 7: bigger feedback + text",6,"high",-36
"SUPPRF93027",5,63,7,22,-15,26,37,39,"Pilot 7","Pilot 7: bigger feedback + text",6,"high",-17
"SUPPRF93027",6,66,11,28,-1,15,29,38,"Pilot 7","Pilot 7: bigger feedback + text",6,"high",-10
"SUPPRF93027",7,62,11,70,-1,10,71,73,"Pilot 7","Pilot 7: bigger feedback + text",6,"high",-3
"SUPPRF93027",8,64,7,83,12,9,71,67,"Pilot 7","Pilot 7: bigger feedback + text",6,"high",16
"SUPPRF93027",9,61,10,54,0,12,54,46,"Pilot 7","Pilot 7: bigger feedback + text",6,"high",8
"SUPPRF93027",10,61,8,47,-16,17,63,55,"Pilot 7","Pilot 7: bigger feedback + text",6,"high",-8
"SUPPRF93027",11,69,8,66,12,8,54,49,"Pilot 7","Pilot 7: bigger feedback + text",6,"high",17
"SUPPRF93027",12,60,21,80,0,10,80,48,"Pilot 7","Pilot 7: bigger feedback + text",6,"high",32
"SUPPRF93027",13,65,22,84,13,25,71,80,"Pilot 7","Pilot 7: bigger feedback + text",6,"high",4
"SUPPRF93027",14,59,20,45,-1,26,46,48,"Pilot 7","Pilot 7: bigger feedback + text",6,"high",-3
"SUPPRF93027",15,61,20,16,-13,27,29,28,"Pilot 7","Pilot 7: bigger feedback + text",6,"high",-12
"SUPPRF93027",16,66,21,77,14,30,63,63,"Pilot 7","Pilot 7: bigger feedback + text",6,"high",14
"SUPPRF93027",17,68,25,29,0,23,29,36,"Pilot 7","Pilot 7: bigger feedback + text",6,"high",-7
"SUPPRF93027",18,62,25,33,-13,23,46,33,"Pilot 7","Pilot 7: bigger feedback + text",6,"high",0
"SUPPRF93027",19,60,25,49,12,19,37,31,"Pilot 7","Pilot 7: bigger feedback + text",6,"high",18
"SUPPRF93027",20,66,21,78,15,20,63,66,"Pilot 7","Pilot 7: bigger feedback + text",6,"high",12
"SUPPRF93027",21,52,21,55,-16,14,71,68,"Pilot 7","Pilot 7: bigger feedback + text",6,"high",-13
"SUPPRF93027",22,62,28,71,0,32,71,64,"Pilot 7","Pilot 7: bigger feedback + text",6,"high",7
"SUPPRF93027",23,65,35,65,19,27,46,44,"Pilot 7","Pilot 7: bigger feedback + text",6,"high",21
"SUPPRF93027",24,65,24,68,14,38,54,56,"Pilot 7","Pilot 7: bigger feedback + text",6,"high",12
"SUPPRF93027",25,65,20,81,1,22,80,83,"Pilot 7","Pilot 7: bigger feedback + text",6,"high",-2
"SUPPRF93027",26,68,22,63,0,27,63,63,"Pilot 7","Pilot 7: bigger feedback + text",6,"high",0
"SUPPRF93027",27,63,24,37,0,23,37,46,"Pilot 7","Pilot 7: bigger feedback + text",6,"high",-9
"SUPPRF93027",28,61,37,96,16,20,80,78,"Pilot 7","Pilot 7: bigger feedback + text",6,"high",18
"SUPPRF93027",29,57,27,24,-13,18,37,37,"Pilot 7","Pilot 7: bigger feedback + text",6,"high",-13
"SUPPRF93027",30,60,35,48,19,15,29,26,"Pilot 7","Pilot 7: bigger feedback + text",6,"high",22
"SUPPRF93027",31,68,23,20,0,11,20,25,"Pilot 7","Pilot 7: bigger feedback + text",6,"high",-5
"SUPPRF93027",32,69,26,97,17,21,80,79,"Pilot 7","Pilot 7: bigger feedback + text",6,"high",18
"SUPPRF93027",33,56,23,50,-13,18,63,61,"Pilot 7","Pilot 7: bigger feedback + text",6,"high",-11
"SUPPRF93027",34,58,36,38,-16,25,54,60,"Pilot 7","Pilot 7: bigger feedback + text",6,"high",-22
"SUPPRF93027",35,67,26,46,0,18,46,48,"Pilot 7","Pilot 7: bigger feedback + text",6,"high",-2
"SUPPRF93027",36,62,29,58,12,17,46,47,"Pilot 7","Pilot 7: bigger feedback + text",6,"high",11
"SUPPRF93027",37,54,29,67,-13,22,80,89,"Pilot 7","Pilot 7: bigger feedback + text",6,"high",-22
"SUPPRF93027",38,57,21,68,-12,28,80,79,"Pilot 7","Pilot 7: bigger feedback + text",6,"high",-11
"SUPPRF93027",39,62,26,35,15,16,20,26,"Pilot 7","Pilot 7: bigger feedback + text",6,"high",9
"SUPPRF93027",40,66,21,51,14,21,37,42,"Pilot 7","Pilot 7: bigger feedback + text",6,"high",9
"SUPPRF93027",41,61,22,34,-12,19,46,49,"Pilot 7","Pilot 7: bigger feedback + text",6,"high",-15
"SUPPRF93027",42,67,22,37,17,20,20,25,"Pilot 7","Pilot 7: bigger feedback + text",6,"high",12
"SUPPRF93027",43,66,30,62,-1,20,63,57,"Pilot 7","Pilot 7: bigger feedback + text",6,"high",5
"SUPPRF93027",44,61,31,55,1,12,54,52,"Pilot 7","Pilot 7: bigger feedback + text",6,"high",3
"SUPPRF93027",45,61,26,56,-15,28,71,62,"Pilot 7","Pilot 7: bigger feedback + text",6,"high",-6
"SUPPRF93027",46,63,26,6,-14,17,20,27,"Pilot 7","Pilot 7: bigger feedback + text",6,"high",-21
"SUPPRF93027",47,70,23,41,-13,12,54,49,"Pilot 7","Pilot 7: bigger feedback + text",6,"high",-8
"SUPPRF93027",48,59,17,19,-1,13,20,16,"Pilot 7","Pilot 7: bigger feedback + text",6,"high",3
"SUPPRF93485",1,62,2,71,0,86,71,81,"Pilot 9","Pilot 9: bigger feedback + text",8,"high",-10
"SUPPRF93485",2,46,3,50,-13,71,63,56,"Pilot 9","Pilot 9: bigger feedback + text",8,"high",-6
"SUPPRF93485",3,57,17,96,16,53,80,38,"Pilot 9","Pilot 9: bigger feedback + text",8,"high",58
"SUPPRF93485",4,23,0,28,-1,77,29,51,"Pilot 9","Pilot 9: bigger feedback + text",8,"high",-23
"SUPPRF93485",5,26,7,16,-13,45,29,62,"Pilot 9","Pilot 9: bigger feedback + text",8,"high",-46
"SUPPRF93485",6,30,7,6,-14,78,20,16,"Pilot 9","Pilot 9: bigger feedback + text",8,"high",-10
"SUPPRF93485",7,34,21,47,-16,73,63,71,"Pilot 9","Pilot 9: bigger feedback + text",8,"high",-24
"SUPPRF93485",8,34,22,38,1,78,37,31,"Pilot 9","Pilot 9: bigger feedback + text",8,"high",7
"SUPPRF93485",9,69,3,63,0,45,63,55,"Pilot 9","Pilot 9: bigger feedback + text",8,"high",8
"SUPPRF93485",10,48,4,45,-1,45,46,24,"Pilot 9","Pilot 9: bigger feedback + text",8,"high",21
"SUPPRF93485",11,76,28,46,17,58,29,49,"Pilot 9","Pilot 9: bigger feedback + text",8,"high",-3
"SUPPRF93485",12,62,17,19,-1,43,20,58,"Pilot 9","Pilot 9: bigger feedback + text",8,"high",-39
"SUPPRF93485",13,46,47,34,-12,43,46,60,"Pilot 9","Pilot 9: bigger feedback + text",8,"high",-26
"SUPPRF93485",14,57,51,49,12,26,37,67,"Pilot 9","Pilot 9: bigger feedback + text",8,"high",-18
"SUPPRF93485",15,100,9,100,20,60,80,86,"Pilot 9","Pilot 9: bigger feedback + text",8,"high",14
"SUPPRF93485",16,41,48,22,-15,39,37,54,"Pilot 9","Pilot 9: bigger feedback + text",8,"high",-32
"SUPPRF93485",17,34,5,67,-13,44,80,43,"Pilot 9","Pilot 9: bigger feedback + text",8,"high",24
"SUPPRF93485",18,64,0,68,-12,68,80,62,"Pilot 9","Pilot 9: bigger feedback + text",8,"high",6
"SUPPRF93485",19,70,7,56,-15,35,71,52,"Pilot 9","Pilot 9: bigger feedback + text",8,"high",4
"SUPPRF93485",20,41,66,66,12,39,54,59,"Pilot 9","Pilot 9: bigger feedback + text",8,"high",7
"SUPPRF93485",21,68,39,54,0,52,54,24,"Pilot 9","Pilot 9: bigger feedback + text",8,"high",30
"SUPPRF93485",22,45,16,58,29,29,29,48,"Pilot 9","Pilot 9: bigger feedback + text",8,"high",10
"SUPPRF93485",23,64,48,55,-16,39,71,49,"Pilot 9","Pilot 9: bigger feedback + text",8,"high",6
"SUPPRF93485",24,70,11,94,23,14,71,63,"Pilot 9","Pilot 9: bigger feedback + text",8,"high",31
"SUPPRF93485",25,78,4,78,24,30,54,49,"Pilot 9","Pilot 9: bigger feedback + text",8,"high",29
"SUPPRF93485",26,80,15,38,-16,21,54,63,"Pilot 9","Pilot 9: bigger feedback + text",8,"high",-25
"SUPPRF93485",27,70,51,20,0,58,20,64,"Pilot 9","Pilot 9: bigger feedback + text",8,"high",-44
"SUPPRF93485",28,77,48,77,14,57,63,39,"Pilot 9","Pilot 9: bigger feedback + text",8,"high",38
"SUPPRF93485",29,75,54,46,0,47,46,30,"Pilot 9","Pilot 9: bigger feedback + text",8,"high",16
"SUPPRF93485",30,77,20,80,0,81,80,85,"Pilot 9","Pilot 9: bigger feedback + text",8,"high",-5
"SUPPRF93485",31,69,16,15,-14,51,29,31,"Pilot 9","Pilot 9: bigger feedback + text",8,"high",-16
"SUPPRF93485",32,61,37,29,0,22,29,26,"Pilot 9","Pilot 9: bigger feedback + text",8,"high",3
"SUPPRF93485",33,36,11,33,-13,25,46,54,"Pilot 9","Pilot 9: bigger feedback + text",8,"high",-21
"SUPPRF93485",34,56,13,61,24,38,37,27,"Pilot 9","Pilot 9: bigger feedback + text",8,"high",34
"SUPPRF93485",35,71,11,47,27,41,20,58,"Pilot 9","Pilot 9: bigger feedback + text",8,"high",-11
"SUPPRF93485",36,81,53,83,12,47,71,50,"Pilot 9","Pilot 9: bigger feedback + text",8,"high",33
"SUPPRF93485",37,75,10,35,15,45,20,13,"Pilot 9","Pilot 9: bigger feedback + text",8,"high",22
"SUPPRF93485",38,80,0,55,1,73,54,50,"Pilot 9","Pilot 9: bigger feedback + text",8,"high",5
"SUPPRF93485",39,77,0,41,-13,62,54,48,"Pilot 9","Pilot 9: bigger feedback + text",8,"high",-7
"SUPPRF93485",40,74,25,62,-1,65,63,47,"Pilot 9","Pilot 9: bigger feedback + text",8,"high",15
"SUPPRF93485",41,73,21,37,0,63,37,30,"Pilot 9","Pilot 9: bigger feedback + text",8,"high",7
"SUPPRF93485",42,78,17,75,29,75,46,58,"Pilot 9","Pilot 9: bigger feedback + text",8,"high",17
"SUPPRF93485",43,73,16,58,12,58,46,30,"Pilot 9","Pilot 9: bigger feedback + text",8,"high",28
"SUPPRF93485",44,78,19,88,25,53,63,67,"Pilot 9","Pilot 9: bigger feedback + text",8,"high",21
"SUPPRF93485",45,75,0,24,-13,61,37,20,"Pilot 9","Pilot 9: bigger feedback + text",8,"high",4
"SUPPRF93485",46,83,11,8,-12,76,20,16,"Pilot 9","Pilot 9: bigger feedback + text",8,"high",-8
"SUPPRF93485",47,81,5,81,1,12,80,43,"Pilot 9","Pilot 9: bigger feedback + text",8,"high",38
"SUPPRF93485",48,80,5,70,-1,87,71,72,"Pilot 9","Pilot 9: bigger feedback + text",8,"high",-2
"SUPPRF93511",1,71,31,55,-16,65,71,57,"Pilot 9","Pilot 9: bigger feedback + text",5,"low",-2
"SUPPRF93511",2,72,25,56,-15,72,71,63,"Pilot 9","Pilot 9: bigger feedback + text",5,"low",-7
"SUPPRF93511",3,2,11,8,-12,69,20,66,"Pilot 9","Pilot 9: bigger feedback + text",5,"low",-58
"SUPPRF93511",4,32,27,22,-15,43,37,43,"Pilot 9","Pilot 9: bigger feedback + text",5,"low",-21
"SUPPRF93511",5,66,24,66,12,52,54,51,"Pilot 9","Pilot 9: bigger feedback + text",5,"low",15
"SUPPRF93511",6,62,14,58,29,61,29,17,"Pilot 9","Pilot 9: bigger feedback + text",5,"low",41
"SUPPRF93511",7,72,21,88,25,68,63,51,"Pilot 9","Pilot 9: bigger feedback + text",5,"low",37
"SUPPRF93511",8,86,29,75,29,75,46,68,"Pilot 9","Pilot 9: bigger feedback + text",5,"low",7
"SUPPRF93511",9,74,20,46,0,65,46,72,"Pilot 9","Pilot 9: bigger feedback + text",5,"low",-26
"SUPPRF93511",10,70,17,68,-12,33,80,74,"Pilot 9","Pilot 9: bigger feedback + text",5,"low",-6
"SUPPRF93511",11,19,74,70,-1,42,71,84,"Pilot 9","Pilot 9: bigger feedback + text",5,"low",-14
"SUPPRF93511",12,39,8,29,0,30,29,61,"Pilot 9","Pilot 9: bigger feedback + text",5,"low",-32
"SUPPRF93511",13,78,13,58,12,19,46,48,"Pilot 9","Pilot 9: bigger feedback + text",5,"low",10
"SUPPRF93511",14,64,16,83,12,29,71,77,"Pilot 9","Pilot 9: bigger feedback + text",5,"low",6
"SUPPRF93511",15,0,0,28,-1,70,29,82,"Pilot 9","Pilot 9: bigger feedback + text",5,"low",-54
"SUPPRF93511",16,0,0,45,-1,23,46,88,"Pilot 9","Pilot 9: bigger feedback + text",5,"low",-43
"SUPPRF93511",17,75,11,6,-14,16,20,42,"Pilot 9","Pilot 9: bigger feedback + text",5,"low",-36
"SUPPRF93511",18,71,6,49,12,7,37,63,"Pilot 9","Pilot 9: bigger feedback + text",5,"low",-14
"SUPPRF93511",19,71,1,67,-13,16,80,52,"Pilot 9","Pilot 9: bigger feedback + text",5,"low",15
"SUPPRF93511",20,68,4,38,1,10,37,50,"Pilot 9","Pilot 9: bigger feedback + text",5,"low",-12
"SUPPRF93511",21,70,2,38,-16,11,54,73,"Pilot 9","Pilot 9: bigger feedback + text",5,"low",-35
"SUPPRF93511",22,74,0,62,-1,0,63,73,"Pilot 9","Pilot 9: bigger feedback + text",5,"low",-11
"SUPPRF93511",23,73,0,47,-16,12,63,66,"Pilot 9","Pilot 9: bigger feedback + text",5,"low",-19
"SUPPRF93511",24,73,0,37,0,9,37,57,"Pilot 9","Pilot 9: bigger feedback + text",5,"low",-20
"SUPPRF93511",25,50,0,94,23,15,71,47,"Pilot 9","Pilot 9: bigger feedback + text",5,"low",47
"SUPPRF93511",26,50,1,78,24,4,54,60,"Pilot 9","Pilot 9: bigger feedback + text",5,"low",18
"SUPPRF93511",27,50,0,61,24,0,37,54,"Pilot 9","Pilot 9: bigger feedback + text",5,"low",7
"SUPPRF93511",28,51,16,50,-13,0,63,57,"Pilot 9","Pilot 9: bigger feedback + text",5,"low",-7
"SUPPRF93511",29,51,18,77,14,8,63,70,"Pilot 9","Pilot 9: bigger feedback + text",5,"low",7
"SUPPRF93511",30,51,12,41,-13,5,54,61,"Pilot 9","Pilot 9: bigger feedback + text",5,"low",-20
"SUPPRF93511",31,51,13,35,15,5,20,37,"Pilot 9","Pilot 9: bigger feedback + text",5,"low",-2
"SUPPRF93511",32,50,15,71,0,17,71,53,"Pilot 9","Pilot 9: bigger feedback + text",5,"low",18
"SUPPRF93511",33,36,28,34,-12,10,46,51,"Pilot 9","Pilot 9: bigger feedback + text",5,"low",-17
"SUPPRF93511",34,38,25,20,0,17,20,56,"Pilot 9","Pilot 9: bigger feedback + text",5,"low",-36
"SUPPRF93511",35,39,35,81,1,14,80,50,"Pilot 9","Pilot 9: bigger feedback + text",5,"low",31
"SUPPRF93511",36,38,35,24,-13,18,37,64,"Pilot 9","Pilot 9: bigger feedback + text",5,"low",-40
"SUPPRF93511",37,35,35,15,-14,21,29,62,"Pilot 9","Pilot 9: bigger feedback + text",5,"low",-47
"SUPPRF93511",38,17,30,46,17,0,29,25,"Pilot 9","Pilot 9: bigger feedback + text",5,"low",21
"SUPPRF93511",39,14,26,55,1,0,54,55,"Pilot 9","Pilot 9: bigger feedback + text",5,"low",0
"SUPPRF93511",40,16,22,80,0,0,80,50,"Pilot 9","Pilot 9: bigger feedback + text",5,"low",30
"SUPPRF93511",41,16,31,33,-13,0,46,37,"Pilot 9","Pilot 9: bigger feedback + text",5,"low",-4
"SUPPRF93511",42,22,16,19,-1,0,20,59,"Pilot 9","Pilot 9: bigger feedback + text",5,"low",-40
"SUPPRF93511",43,10,51,16,-13,6,29,55,"Pilot 9","Pilot 9: bigger feedback + text",5,"low",-39
"SUPPRF93511",44,23,15,47,27,0,20,55,"Pilot 9","Pilot 9: bigger feedback + text",5,"low",-8
"SUPPRF93511",45,7,43,100,20,4,80,44,"Pilot 9","Pilot 9: bigger feedback + text",5,"low",56
"SUPPRF93511",46,11,40,54,0,6,54,62,"Pilot 9","Pilot 9: bigger feedback + text",5,"low",-8
"SUPPRF93511",47,13,19,96,16,7,80,49,"Pilot 9","Pilot 9: bigger feedback + text",5,"low",47
"SUPPRF93511",48,10,29,63,0,3,63,43,"Pilot 9","Pilot 9: bigger feedback + text",5,"low",20
"SUPPRF93936",1,32,98,29,0,60,29,32,"Pilot 11","Pilot 11: bigger feedback + video + socially anxious",12,"high",-3
"SUPPRF93936",2,32,98,38,-16,83,54,48,"Pilot 11","Pilot 11: bigger feedback + video + socially anxious",12,"high",-10
"SUPPRF93936",3,29,98,22,-15,55,37,43,"Pilot 11","Pilot 11: bigger feedback + video + socially anxious",12,"high",-21
"SUPPRF93936",4,26,98,20,0,99,20,1,"Pilot 11","Pilot 11: bigger feedback + video + socially anxious",12,"high",19
"SUPPRF93936",5,24,98,16,-13,98,29,24,"Pilot 11","Pilot 11: bigger feedback + video + socially anxious",12,"high",-8
"SUPPRF93936",6,42,90,83,12,84,71,39,"Pilot 11","Pilot 11: bigger feedback + video + socially anxious",12,"high",44
"SUPPRF93936",7,32,99,77,14,79,63,25,"Pilot 11","Pilot 11: bigger feedback + video + socially anxious",12,"high",52
"SUPPRF93936",8,66,86,100,20,31,80,38,"Pilot 11","Pilot 11: bigger feedback + video + socially anxious",12,"high",62
"SUPPRF93936",9,45,75,55,1,52,54,39,"Pilot 11","Pilot 11: bigger feedback + video + socially anxious",12,"high",16
"SUPPRF93936",10,25,81,63,0,50,63,41,"Pilot 11","Pilot 11: bigger feedback + video + socially anxious",12,"high",22
"SUPPRF93936",11,27,88,71,0,49,71,34,"Pilot 11","Pilot 11: bigger feedback + video + socially anxious",12,"high",37
"SUPPRF93936",12,27,94,58,12,45,46,36,"Pilot 11","Pilot 11: bigger feedback + video + socially anxious",12,"high",22
"SUPPRF93936",13,26,93,47,-16,47,63,47,"Pilot 11","Pilot 11: bigger feedback + video + socially anxious",12,"high",0
"SUPPRF93936",14,30,93,50,-13,51,63,41,"Pilot 11","Pilot 11: bigger feedback + video + socially anxious",12,"high",9
"SUPPRF93936",15,23,92,8,-12,67,20,11,"Pilot 11","Pilot 11: bigger feedback + video + socially anxious",12,"high",-3
"SUPPRF93936",16,28,94,38,1,84,37,24,"Pilot 11","Pilot 11: bigger feedback + video + socially anxious",12,"high",14
"SUPPRF93936",17,33,88,47,27,86,20,8,"Pilot 11","Pilot 11: bigger feedback + video + socially anxious",12,"high",39
"SUPPRF93936",18,39,92,35,15,72,20,23,"Pilot 11","Pilot 11: bigger feedback + video + socially anxious",12,"high",12
"SUPPRF93936",19,40,75,54,0,59,54,41,"Pilot 11","Pilot 11: bigger feedback + video + socially anxious",12,"high",13
"SUPPRF93936",20,49,71,46,0,52,46,37,"Pilot 11","Pilot 11: bigger feedback + video + socially anxious",12,"high",9
"SUPPRF93936",21,49,75,66,12,38,54,32,"Pilot 11","Pilot 11: bigger feedback + video + socially anxious",12,"high",34
"SUPPRF93936",22,48,72,41,-13,78,54,21,"Pilot 11","Pilot 11: bigger feedback + video + socially anxious",12,"high",20
"SUPPRF93936",23,50,72,28,-1,68,29,17,"Pilot 11","Pilot 11: bigger feedback + video + socially anxious",12,"high",11
"SUPPRF93936",24,50,74,15,-14,75,29,27,"Pilot 11","Pilot 11: bigger feedback + video + socially anxious",12,"high",-12
"SUPPRF93936",25,49,74,55,-16,74,71,21,"Pilot 11","Pilot 11: bigger feedback + video + socially anxious",12,"high",34
"SUPPRF93936",26,47,67,19,-1,67,20,21,"Pilot 11","Pilot 11: bigger feedback + video + socially anxious",12,"high",-2
"SUPPRF93936",27,50,79,34,-12,49,46,29,"Pilot 11","Pilot 11: bigger feedback + video + socially anxious",12,"high",5
"SUPPRF93936",28,48,62,94,23,69,71,49,"Pilot 11","Pilot 11: bigger feedback + video + socially anxious",12,"high",45
"SUPPRF93936",29,50,67,96,16,27,80,43,"Pilot 11","Pilot 11: bigger feedback + video + socially anxious",12,"high",53
"SUPPRF93936",30,50,81,67,-13,28,80,42,"Pilot 11","Pilot 11: bigger feedback + video + socially anxious",12,"high",25
"SUPPRF93936",31,50,78,78,24,61,54,40,"Pilot 11","Pilot 11: bigger feedback + video + socially anxious",12,"high",38
"SUPPRF93936",32,49,45,56,-15,70,71,70,"Pilot 11","Pilot 11: bigger feedback + video + socially anxious",12,"high",-14
"SUPPRF93936",33,49,66,88,25,39,63,31,"Pilot 11","Pilot 11: bigger feedback + video + socially anxious",12,"high",57
"SUPPRF93936",34,51,83,6,-14,78,20,16,"Pilot 11","Pilot 11: bigger feedback + video + socially anxious",12,"high",-10
"SUPPRF93936",35,45,65,68,-12,30,80,30,"Pilot 11","Pilot 11: bigger feedback + video + socially anxious",12,"high",38
"SUPPRF93936",36,48,87,58,29,49,29,25,"Pilot 11","Pilot 11: bigger feedback + video + socially anxious",12,"high",33
"SUPPRF93936",37,46,70,45,-1,43,46,31,"Pilot 11","Pilot 11: bigger feedback + video + socially anxious",12,"high",14
"SUPPRF93936",38,42,71,80,0,62,80,50,"Pilot 11","Pilot 11: bigger feedback + video + socially anxious",12,"high",30
"SUPPRF93936",39,48,73,70,-1,30,71,39,"Pilot 11","Pilot 11: bigger feedback + video + socially anxious",12,"high",31
"SUPPRF93936",40,44,69,37,0,34,37,40,"Pilot 11","Pilot 11: bigger feedback + video + socially anxious",12,"high",-3
"SUPPRF93936",41,45,68,62,-1,51,63,42,"Pilot 11","Pilot 11: bigger feedback + video + socially anxious",12,"high",20
"SUPPRF93936",42,48,74,46,17,70,29,32,"Pilot 11","Pilot 11: bigger feedback + video + socially anxious",12,"high",14
"SUPPRF93936",43,41,67,33,-13,38,46,43,"Pilot 11","Pilot 11: bigger feedback + video + socially anxious",12,"high",-10
"SUPPRF93936",44,48,66,61,24,27,37,34,"Pilot 11","Pilot 11: bigger feedback + video + socially anxious",12,"high",27
"SUPPRF93936",45,42,54,81,1,29,80,23,"Pilot 11","Pilot 11: bigger feedback + video + socially anxious",12,"high",58
"SUPPRF93936",46,48,51,75,29,42,46,34,"Pilot 11","Pilot 11: bigger feedback + video + socially anxious",12,"high",41
"SUPPRF93936",47,50,51,24,-13,67,37,29,"Pilot 11","Pilot 11: bigger feedback + video + socially anxious",12,"high",-5
"SUPPRF93936",48,48,53,49,12,47,37,20,"Pilot 11","Pilot 11: bigger feedback + video + socially anxious",12,"high",29
"SUPPRF94218",1,25,64,20,0,88,20,24,"Pilot 6","Pilot 6: feedback + text",6,"high",-4
"SUPPRF94218",2,23,70,56,-15,72,71,65,"Pilot 6","Pilot 6: feedback + text",6,"high",-9
"SUPPRF94218",3,50,20,83,12,63,71,63,"Pilot 6","Pilot 6: feedback + text",6,"high",20
"SUPPRF94218",4,16,66,46,17,78,29,18,"Pilot 6","Pilot 6: feedback + text",6,"high",28
"SUPPRF94218",5,22,62,37,0,50,37,27,"Pilot 6","Pilot 6: feedback + text",6,"high",10
"SUPPRF94218",6,25,54,24,-13,79,37,36,"Pilot 6","Pilot 6: feedback + text",6,"high",-12
"SUPPRF94218",7,22,70,68,-12,56,80,55,"Pilot 6","Pilot 6: feedback + text",6,"high",13
"SUPPRF94218",8,26,74,62,-1,31,63,42,"Pilot 6","Pilot 6: feedback + text",6,"high",20
"SUPPRF94218",9,19,75,8,-12,28,20,31,"Pilot 6","Pilot 6: feedback + text",6,"high",-23
"SUPPRF94218",10,31,66,58,12,83,46,31,"Pilot 6","Pilot 6: feedback + text",6,"high",27
"SUPPRF94218",11,26,68,55,1,67,54,56,"Pilot 6","Pilot 6: feedback + text",6,"high",-1
"SUPPRF94218",12,26,63,41,-13,79,54,45,"Pilot 6","Pilot 6: feedback + text",6,"high",-4
"SUPPRF94218",13,20,74,34,-12,84,46,13,"Pilot 6","Pilot 6: feedback + text",6,"high",21
"SUPPRF94218",14,31,62,84,13,76,71,60,"Pilot 6","Pilot 6: feedback + text",6,"high",24
"SUPPRF94218",15,27,55,16,-13,44,29,52,"Pilot 6","Pilot 6: feedback + text",6,"high",-36
"SUPPRF94218",16,25,58,19,-1,76,20,29,"Pilot 6","Pilot 6: feedback + text",6,"high",-10
"SUPPRF94218",17,25,67,80,0,38,80,23,"Pilot 6","Pilot 6: feedback + text",6,"high",57
"SUPPRF94218",18,27,66,29,0,56,29,42,"Pilot 6","Pilot 6: feedback + text",6,"high",-13
"SUPPRF94218",19,27,60,46,0,51,46,39,"Pilot 6","Pilot 6: feedback + text",6,"high",7
"SUPPRF94218",20,29,70,51,14,41,37,34,"Pilot 6","Pilot 6: feedback + text",6,"high",17
"SUPPRF94218",21,26,69,6,-14,78,20,21,"Pilot 6","Pilot 6: feedback + text",6,"high",-15
"SUPPRF94218",22,22,72,35,15,76,20,20,"Pilot 6","Pilot 6: feedback + text",6,"high",15
"SUPPRF94218",23,25,65,22,-15,65,37,30,"Pilot 6","Pilot 6: feedback + text",6,"high",-8
"SUPPRF94218",24,25,70,47,-16,46,63,30,"Pilot 6","Pilot 6: feedback + text",6,"high",17
"SUPPRF94218",25,29,64,96,16,63,80,63,"Pilot 6","Pilot 6: feedback + text",6,"high",33
"SUPPRF94218",26,40,64,77,14,47,63,48,"Pilot 6","Pilot 6: feedback + text",6,"high",29
"SUPPRF94218",27,26,70,49,12,8,37,49,"Pilot 6","Pilot 6: feedback + text",6,"high",0
"SUPPRF94218",28,27,64,45,-1,32,46,39,"Pilot 6","Pilot 6: feedback + text",6,"high",6
"SUPPRF94218",29,33,63,71,0,74,71,57,"Pilot 6","Pilot 6: feedback + text",6,"high",14
"SUPPRF94218",30,30,69,67,-13,70,80,77,"Pilot 6","Pilot 6: feedback + text",6,"high",-10
"SUPPRF94218",31,41,65,50,-13,55,63,42,"Pilot 6","Pilot 6: feedback + text",6,"high",8
"SUPPRF94218",32,34,53,33,-13,28,46,56,"Pilot 6","Pilot 6: feedback + text",6,"high",-23
"SUPPRF94218",33,36,60,68,14,19,54,55,"Pilot 6","Pilot 6: feedback + text",6,"high",13
"SUPPRF94218",34,58,56,78,15,25,63,45,"Pilot 6","Pilot 6: feedback + text",6,"high",33
"SUPPRF94218",35,35,53,15,-14,64,29,25,"Pilot 6","Pilot 6: feedback + text",6,"high",-10
"SUPPRF94218",36,38,53,66,12,48,54,39,"Pilot 6","Pilot 6: feedback + text",6,"high",27
"SUPPRF94218",37,32,56,28,-1,62,29,17,"Pilot 6","Pilot 6: feedback + text",6,"high",11
"SUPPRF94218",38,43,56,70,-1,36,71,51,"Pilot 6","Pilot 6: feedback + text",6,"high",19
"SUPPRF94218",39,34,55,97,17,67,80,55,"Pilot 6","Pilot 6: feedback + text",6,"high",42
"SUPPRF94218",40,36,53,38,-16,53,54,57,"Pilot 6","Pilot 6: feedback + text",6,"high",-19
"SUPPRF94218",41,32,56,48,19,79,29,13,"Pilot 6","Pilot 6: feedback + text",6,"high",35
"SUPPRF94218",42,34,57,63,0,61,63,49,"Pilot 6","Pilot 6: feedback + text",6,"high",14
"SUPPRF94218",43,40,63,81,1,85,80,82,"Pilot 6","Pilot 6: feedback + text",6,"high",-1
"SUPPRF94218",44,30,58,38,1,32,37,29,"Pilot 6","Pilot 6: feedback + text",6,"high",9
"SUPPRF94218",45,36,58,65,19,15,46,27,"Pilot 6","Pilot 6: feedback + text",6,"high",38
"SUPPRF94218",46,33,56,55,-16,52,71,46,"Pilot 6","Pilot 6: feedback + text",6,"high",9
"SUPPRF94218",47,28,52,37,17,71,20,23,"Pilot 6","Pilot 6: feedback + text",6,"high",14
"SUPPRF94218",48,33,52,54,0,57,54,37,"Pilot 6","Pilot 6: feedback + text",6,"high",17
"SUPPRF94460",1,49,2,50,-13,23,63,44,"Pilot 7","Pilot 7: bigger feedback + text",3,"low",6
"SUPPRF94460",2,50,5,37,17,6,20,13,"Pilot 7","Pilot 7: bigger feedback + text",3,"low",24
"SUPPRF94460",3,51,4,6,-14,14,20,11,"Pilot 7","Pilot 7: bigger feedback + text",3,"low",-5
"SUPPRF94460",4,48,7,29,0,61,29,31,"Pilot 7","Pilot 7: bigger feedback + text",3,"low",-2
"SUPPRF94460",5,51,7,58,12,49,46,48,"Pilot 7","Pilot 7: bigger feedback + text",3,"low",10
"SUPPRF94460",6,40,10,66,12,46,54,48,"Pilot 7","Pilot 7: bigger feedback + text",3,"low",18
"SUPPRF94460",7,52,8,81,1,86,80,82,"Pilot 7","Pilot 7: bigger feedback + text",3,"low",-1
"SUPPRF94460",8,50,10,65,19,56,46,53,"Pilot 7","Pilot 7: bigger feedback + text",3,"low",12
"SUPPRF94460",9,39,14,22,-15,28,37,22,"Pilot 7","Pilot 7: bigger feedback + text",3,"low",0
"SUPPRF94460",10,44,12,68,14,54,54,54,"Pilot 7","Pilot 7: bigger feedback + text",3,"low",14
"SUPPRF94460",11,44,12,34,-12,27,46,28,"Pilot 7","Pilot 7: bigger feedback + text",3,"low",6
"SUPPRF94460",12,45,14,33,-13,29,46,30,"Pilot 7","Pilot 7: bigger feedback + text",3,"low",3
"SUPPRF94460",13,46,7,41,-13,42,54,50,"Pilot 7","Pilot 7: bigger feedback + text",3,"low",-9
"SUPPRF94460",14,45,7,83,12,60,71,67,"Pilot 7","Pilot 7: bigger feedback + text",3,"low",16
"SUPPRF94460",15,45,6,71,0,65,71,78,"Pilot 7","Pilot 7: bigger feedback + text",3,"low",-7
"SUPPRF94460",16,43,12,38,1,24,37,39,"Pilot 7","Pilot 7: bigger feedback + text",3,"low",-1
"SUPPRF94460",17,46,16,68,-12,55,80,76,"Pilot 7","Pilot 7: bigger feedback + text",3,"low",-8
"SUPPRF94460",18,45,10,45,-1,41,46,38,"Pilot 7","Pilot 7: bigger feedback + text",3,"low",7
"SUPPRF94460",19,46,17,84,13,50,71,55,"Pilot 7","Pilot 7: bigger feedback + text",3,"low",29
"SUPPRF94460",20,24,47,46,0,63,46,31,"Pilot 7","Pilot 7: bigger feedback + text",3,"low",15
"SUPPRF94460",21,41,17,20,0,38,20,13,"Pilot 7","Pilot 7: bigger feedback + text",3,"low",7
"SUPPRF94460",22,39,25,56,-15,56,71,46,"Pilot 7","Pilot 7: bigger feedback + text",3,"low",10
"SUPPRF94460",23,41,25,55,-16,51,71,57,"Pilot 7","Pilot 7: bigger feedback + text",3,"low",-2
"SUPPRF94460",24,35,25,16,-13,28,29,32,"Pilot 7","Pilot 7: bigger feedback + text",3,"low",-16
"SUPPRF94460",25,38,25,37,0,27,37,24,"Pilot 7","Pilot 7: bigger feedback + text",3,"low",13
"SUPPRF94460",26,33,25,38,-16,37,54,44,"Pilot 7","Pilot 7: bigger feedback + text",3,"low",-6
"SUPPRF94460",27,43,27,67,-13,45,80,63,"Pilot 7","Pilot 7: bigger feedback + text",3,"low",4
"SUPPRF94460",28,50,28,80,0,24,80,59,"Pilot 7","Pilot 7: bigger feedback + text",3,"low",21
"SUPPRF94460",29,38,33,15,-14,34,29,19,"Pilot 7","Pilot 7: bigger feedback + text",3,"low",-4
"SUPPRF94460",30,40,18,46,17,66,29,16,"Pilot 7","Pilot 7: bigger feedback + text",3,"low",30
"SUPPRF94460",31,37,27,48,19,34,29,23,"Pilot 7","Pilot 7: bigger feedback + text",3,"low",25
"SUPPRF94460",32,13,32,54,0,56,54,59,"Pilot 7","Pilot 7: bigger feedback + text",3,"low",-5
"SUPPRF94460",33,19,59,19,-1,32,20,13,"Pilot 7","Pilot 7: bigger feedback + text",3,"low",6
"SUPPRF94460",34,32,76,97,17,51,80,67,"Pilot 7","Pilot 7: bigger feedback + text",3,"low",30
"SUPPRF94460",35,54,67,96,16,64,80,77,"Pilot 7","Pilot 7: bigger feedback + text",3,"low",19
"SUPPRF94460",36,29,72,77,14,53,63,57,"Pilot 7","Pilot 7: bigger feedback + text",3,"low",20
"SUPPRF94460",37,30,85,35,15,33,20,12,"Pilot 7","Pilot 7: bigger feedback + text",3,"low",23
"SUPPRF94460",38,23,77,8,-12,35,20,42,"Pilot 7","Pilot 7: bigger feedback + text",3,"low",-34
"SUPPRF94460",39,30,80,47,-16,43,63,42,"Pilot 7","Pilot 7: bigger feedback + text",3,"low",5
"SUPPRF94460",40,29,85,78,15,49,63,56,"Pilot 7","Pilot 7: bigger feedback + text",3,"low",22
"SUPPRF94460",41,26,86,55,1,48,54,51,"Pilot 7","Pilot 7: bigger feedback + text",3,"low",4
"SUPPRF94460",42,19,85,70,-1,63,71,65,"Pilot 7","Pilot 7: bigger feedback + text",3,"low",5
"SUPPRF94460",43,26,93,28,-1,24,29,18,"Pilot 7","Pilot 7: bigger feedback + text",3,"low",10
"SUPPRF94460",44,5,97,62,-1,45,63,45,"Pilot 7","Pilot 7: bigger feedback + text",3,"low",17
"SUPPRF94460",45,8,97,49,12,43,37,43,"Pilot 7","Pilot 7: bigger feedback + text",3,"low",6
"SUPPRF94460",46,1,100,24,-13,50,37,45,"Pilot 7","Pilot 7: bigger feedback + text",3,"low",-21
"SUPPRF94460",47,1,99,51,14,24,37,30,"Pilot 7","Pilot 7: bigger feedback + text",3,"low",21
"SUPPRF94460",48,1,100,63,0,42,63,9,"Pilot 7","Pilot 7: bigger feedback + text",3,"low",54
"SUPPRF94497",1,69,17,55,1,86,54,60,"Pilot 9","Pilot 9: bigger feedback + text",3,"low",-5
"SUPPRF94497",2,59,21,67,-13,95,80,80,"Pilot 9","Pilot 9: bigger feedback + text",3,"low",-13
"SUPPRF94497",3,70,17,19,-1,86,20,20,"Pilot 9","Pilot 9: bigger feedback + text",3,"low",-1
"SUPPRF94497",4,71,21,56,-15,75,71,80,"Pilot 9","Pilot 9: bigger feedback + text",3,"low",-24
"SUPPRF94497",5,60,14,47,-16,90,63,65,"Pilot 9","Pilot 9: bigger feedback + text",3,"low",-18
"SUPPRF94497",6,62,11,68,-12,60,80,70,"Pilot 9","Pilot 9: bigger feedback + text",3,"low",-2
"SUPPRF94497",7,68,19,38,-16,62,54,45,"Pilot 9","Pilot 9: bigger feedback + text",3,"low",-7
"SUPPRF94497",8,61,10,20,0,81,20,13,"Pilot 9","Pilot 9: bigger feedback + text",3,"low",7
"SUPPRF94497",9,59,10,88,25,87,63,60,"Pilot 9","Pilot 9: bigger feedback + text",3,"low",28
"SUPPRF94497",10,59,13,58,29,28,29,60,"Pilot 9","Pilot 9: bigger feedback + text",3,"low",-2
"SUPPRF94497",11,62,14,8,-12,82,20,10,"Pilot 9","Pilot 9: bigger feedback + text",3,"low",-2
"SUPPRF94497",12,66,8,78,24,26,54,48,"Pilot 9","Pilot 9: bigger feedback + text",3,"low",30
"SUPPRF94497",13,64,11,46,0,80,46,30,"Pilot 9","Pilot 9: bigger feedback + text",3,"low",16
"SUPPRF94497",14,64,7,77,14,71,63,57,"Pilot 9","Pilot 9: bigger feedback + text",3,"low",20
"SUPPRF94497",15,66,5,80,0,80,80,69,"Pilot 9","Pilot 9: bigger feedback + text",3,"low",11
"SUPPRF94497",16,87,0,96,16,59,80,67,"Pilot 9","Pilot 9: bigger feedback + text",3,"low",29
"SUPPRF94497",17,83,3,34,-12,70,46,51,"Pilot 9","Pilot 9: bigger feedback + text",3,"low",-17
"SUPPRF94497",18,76,7,54,0,79,54,50,"Pilot 9","Pilot 9: bigger feedback + text",3,"low",4
"SUPPRF94497",19,80,3,49,12,85,37,50,"Pilot 9","Pilot 9: bigger feedback + text",3,"low",-1
"SUPPRF94497",20,59,4,16,-13,81,29,35,"Pilot 9","Pilot 9: bigger feedback + text",3,"low",-19
"SUPPRF94497",21,74,4,58,12,79,46,50,"Pilot 9","Pilot 9: bigger feedback + text",3,"low",8
"SUPPRF94497",22,73,6,41,-13,73,54,40,"Pilot 9","Pilot 9: bigger feedback + text",3,"low",1
"SUPPRF94497",23,72,4,70,-1,62,71,58,"Pilot 9","Pilot 9: bigger feedback + text",3,"low",12
"SUPPRF94497",24,72,0,46,17,73,29,55,"Pilot 9","Pilot 9: bigger feedback + text",3,"low",-9
"SUPPRF94497",25,76,0,63,0,18,63,58,"Pilot 9","Pilot 9: bigger feedback + text",3,"low",5
"SUPPRF94497",26,89,0,94,23,91,71,70,"Pilot 9","Pilot 9: bigger feedback + text",3,"low",24
"SUPPRF94497",27,75,0,50,-13,83,63,52,"Pilot 9","Pilot 9: bigger feedback + text",3,"low",-2
"SUPPRF94497",28,74,0,45,-1,79,46,48,"Pilot 9","Pilot 9: bigger feedback + text",3,"low",-3
"SUPPRF94497",29,80,0,83,12,65,71,54,"Pilot 9","Pilot 9: bigger feedback + text",3,"low",29
"SUPPRF94497",30,77,0,22,-15,83,37,30,"Pilot 9","Pilot 9: bigger feedback + text",3,"low",-8
"SUPPRF94497",31,78,1,33,-13,80,46,41,"Pilot 9","Pilot 9: bigger feedback + text",3,"low",-8
"SUPPRF94497",32,81,0,24,-13,32,37,48,"Pilot 9","Pilot 9: bigger feedback + text",3,"low",-24
"SUPPRF94497",33,53,8,81,1,100,80,100,"Pilot 9","Pilot 9: bigger feedback + text",3,"low",-19
"SUPPRF94497",34,65,0,71,0,61,71,74,"Pilot 9","Pilot 9: bigger feedback + text",3,"low",-3
"SUPPRF94497",35,68,0,37,0,60,37,42,"Pilot 9","Pilot 9: bigger feedback + text",3,"low",-5
"SUPPRF94497",36,81,6,66,12,82,54,62,"Pilot 9","Pilot 9: bigger feedback + text",3,"low",4
"SUPPRF94497",37,76,0,55,-16,54,71,63,"Pilot 9","Pilot 9: bigger feedback + text",3,"low",-8
"SUPPRF94497",38,81,0,75,29,91,46,43,"Pilot 9","Pilot 9: bigger feedback + text",3,"low",32
"SUPPRF94497",39,13,0,6,-14,84,20,25,"Pilot 9","Pilot 9: bigger feedback + text",3,"low",-19
"SUPPRF94497",40,91,2,47,27,90,20,20,"Pilot 9","Pilot 9: bigger feedback + text",3,"low",27
"SUPPRF94497",41,100,0,100,20,59,80,73,"Pilot 9","Pilot 9: bigger feedback + text",3,"low",27
"SUPPRF94497",42,84,0,35,15,89,20,19,"Pilot 9","Pilot 9: bigger feedback + text",3,"low",16
"SUPPRF94497",43,100,0,38,1,88,37,45,"Pilot 9","Pilot 9: bigger feedback + text",3,"low",-7
"SUPPRF94497",44,81,0,62,-1,81,63,49,"Pilot 9","Pilot 9: bigger feedback + text",3,"low",13
"SUPPRF94497",45,90,0,61,24,63,37,33,"Pilot 9","Pilot 9: bigger feedback + text",3,"low",28
"SUPPRF94497",46,57,0,15,-14,84,29,35,"Pilot 9","Pilot 9: bigger feedback + text",3,"low",-20
"SUPPRF94497",47,75,0,28,-1,85,29,24,"Pilot 9","Pilot 9: bigger feedback + text",3,"low",4
"SUPPRF94497",48,80,0,29,0,84,29,24,"Pilot 9","Pilot 9: bigger feedback + text",3,"low",5
"SUPPRF94776",1,62,18,54,0,36,54,48,"Pilot 8","Pilot 8: max feedback + text",5,"low",6
"SUPPRF94776",2,60,8,47,27,51,20,44,"Pilot 8","Pilot 8: max feedback + text",5,"low",3
"SUPPRF94776",3,52,8,24,-13,38,37,56,"Pilot 8","Pilot 8: max feedback + text",5,"low",-32
"SUPPRF94776",4,47,6,94,23,82,71,73,"Pilot 8","Pilot 8: max feedback + text",5,"low",21
"SUPPRF94776",5,62,8,35,15,70,20,18,"Pilot 8","Pilot 8: max feedback + text",5,"low",17
"SUPPRF94776",6,48,7,67,-13,58,80,79,"Pilot 8","Pilot 8: max feedback + text",5,"low",-12
"SUPPRF94776",7,68,8,77,14,43,63,63,"Pilot 8","Pilot 8: max feedback + text",5,"low",14
"SUPPRF94776",8,50,5,70,-1,50,71,66,"Pilot 8","Pilot 8: max feedback + text",5,"low",4
"SUPPRF94776",9,67,6,75,29,35,46,39,"Pilot 8","Pilot 8: max feedback + text",5,"low",36
"SUPPRF94776",10,66,4,96,16,63,80,50,"Pilot 8","Pilot 8: max feedback + text",5,"low",46
"SUPPRF94776",11,50,7,41,-13,58,54,37,"Pilot 8","Pilot 8: max feedback + text",5,"low",4
"SUPPRF94776",12,51,5,38,-16,34,54,49,"Pilot 8","Pilot 8: max feedback + text",5,"low",-11
"SUPPRF94776",13,59,6,49,12,57,37,26,"Pilot 8","Pilot 8: max feedback + text",5,"low",23
"SUPPRF94776",14,75,4,19,-1,80,20,19,"Pilot 8","Pilot 8: max feedback + text",5,"low",0
"SUPPRF94776",15,50,6,8,-12,9,20,72,"Pilot 8","Pilot 8: max feedback + text",5,"low",-64
"SUPPRF94776",16,51,6,38,1,71,37,40,"Pilot 8","Pilot 8: max feedback + text",5,"low",-2
"SUPPRF94776",17,64,5,58,12,7,46,14,"Pilot 8","Pilot 8: max feedback + text",5,"low",44
"SUPPRF94776",18,51,7,22,-15,30,37,34,"Pilot 8","Pilot 8: max feedback + text",5,"low",-12
"SUPPRF94776",19,67,6,46,17,86,29,12,"Pilot 8","Pilot 8: max feedback + text",5,"low",34
"SUPPRF94776",20,78,73,80,0,73,80,73,"Pilot 8","Pilot 8: max feedback + text",5,"low",7
"SUPPRF94776",21,66,8,55,-16,21,71,51,"Pilot 8","Pilot 8: max feedback + text",5,"low",4
"SUPPRF94776",22,68,7,55,1,63,54,35,"Pilot 8","Pilot 8: max feedback + text",5,"low",20
"SUPPRF94776",23,51,6,45,-1,29,46,38,"Pilot 8","Pilot 8: max feedback + text",5,"low",7
"SUPPRF94776",24,49,5,47,-16,12,63,72,"Pilot 8","Pilot 8: max feedback + text",5,"low",-25
"SUPPRF94776",25,50,6,16,-13,13,29,27,"Pilot 8","Pilot 8: max feedback + text",5,"low",-11
"SUPPRF94776",26,77,6,100,20,58,80,13,"Pilot 8","Pilot 8: max feedback + text",5,"low",87
"SUPPRF94776",27,50,5,56,-15,59,71,81,"Pilot 8","Pilot 8: max feedback + text",5,"low",-25
"SUPPRF94776",28,58,4,46,0,34,46,48,"Pilot 8","Pilot 8: max feedback + text",5,"low",-2
"SUPPRF94776",29,59,4,71,0,29,71,55,"Pilot 8","Pilot 8: max feedback + text",5,"low",16
"SUPPRF94776",30,59,6,68,-12,19,80,59,"Pilot 8","Pilot 8: max feedback + text",5,"low",9
"SUPPRF94776",31,49,6,33,-13,30,46,47,"Pilot 8","Pilot 8: max feedback + text",5,"low",-14
"SUPPRF94776",32,51,51,37,0,17,37,17,"Pilot 8","Pilot 8: max feedback + text",5,"low",20
"SUPPRF94776",33,50,49,28,-1,56,29,33,"Pilot 8","Pilot 8: max feedback + text",5,"low",-5
"SUPPRF94776",34,52,5,6,-14,55,20,40,"Pilot 8","Pilot 8: max feedback + text",5,"low",-34
"SUPPRF94776",35,50,5,50,-13,20,63,45,"Pilot 8","Pilot 8: max feedback + text",5,"low",5
"SUPPRF94776",36,58,10,66,12,41,54,53,"Pilot 8","Pilot 8: max feedback + text",5,"low",13
"SUPPRF94776",37,62,7,61,24,37,37,49,"Pilot 8","Pilot 8: max feedback + text",5,"low",12
"SUPPRF94776",38,70,5,78,24,65,54,36,"Pilot 8","Pilot 8: max feedback + text",5,"low",42
"SUPPRF94776",39,48,5,58,29,85,29,22,"Pilot 8","Pilot 8: max feedback + text",5,"low",36
"SUPPRF94776",40,52,5,81,1,57,80,65,"Pilot 8","Pilot 8: max feedback + text",5,"low",16
"SUPPRF94776",41,54,9,20,0,74,20,7,"Pilot 8","Pilot 8: max feedback + text",5,"low",13
"SUPPRF94776",42,68,4,88,25,10,63,50,"Pilot 8","Pilot 8: max feedback + text",5,"low",38
"SUPPRF94776",43,52,4,83,12,46,71,75,"Pilot 8","Pilot 8: max feedback + text",5,"low",8
"SUPPRF94776",44,50,6,63,0,29,63,46,"Pilot 8","Pilot 8: max feedback + text",5,"low",17
"SUPPRF94776",45,55,5,62,-1,50,63,61,"Pilot 8","Pilot 8: max feedback + text",5,"low",1
"SUPPRF94776",46,50,9,29,0,40,29,19,"Pilot 8","Pilot 8: max feedback + text",5,"low",10
"SUPPRF94776",47,51,32,34,-12,0,46,50,"Pilot 8","Pilot 8: max feedback + text",5,"low",-16
"SUPPRF94776",48,50,6,15,-14,55,29,13,"Pilot 8","Pilot 8: max feedback + text",5,"low",2
"SUPPRF94864",1,30,83,28,-1,59,29,31,"Pilot 8","Pilot 8: max feedback + text",10,"high",-3
"SUPPRF94864",2,27,75,47,-16,29,63,60,"Pilot 8","Pilot 8: max feedback + text",10,"high",-13
"SUPPRF94864",3,22,72,41,-13,70,54,40,"Pilot 8","Pilot 8: max feedback + text",10,"high",1
"SUPPRF94864",4,19,77,45,-1,23,46,49,"Pilot 8","Pilot 8: max feedback + text",10,"high",-4
"SUPPRF94864",5,16,73,67,-13,80,80,74,"Pilot 8","Pilot 8: max feedback + text",10,"high",-7
"SUPPRF94864",6,17,76,94,23,55,71,76,"Pilot 8","Pilot 8: max feedback + text",10,"high",18
"SUPPRF94864",7,20,81,37,0,68,37,30,"Pilot 8","Pilot 8: max feedback + text",10,"high",7
"SUPPRF94864",8,23,84,29,0,78,29,30,"Pilot 8","Pilot 8: max feedback + text",10,"high",-1
"SUPPRF94864",9,11,70,61,24,73,37,17,"Pilot 8","Pilot 8: max feedback + text",10,"high",44
"SUPPRF94864",10,35,72,77,14,76,63,40,"Pilot 8","Pilot 8: max feedback + text",10,"high",37
"SUPPRF94864",11,31,67,66,12,71,54,51,"Pilot 8","Pilot 8: max feedback + text",10,"high",15
"SUPPRF94864",12,41,64,100,20,47,80,64,"Pilot 8","Pilot 8: max feedback + text",10,"high",36
"SUPPRF94864",13,37,68,38,1,74,37,39,"Pilot 8","Pilot 8: max feedback + text",10,"high",-1
"SUPPRF94864",14,35,77,56,-15,55,71,34,"Pilot 8","Pilot 8: max feedback + text",10,"high",22
"SUPPRF94864",15,22,79,75,29,33,46,39,"Pilot 8","Pilot 8: max feedback + text",10,"high",36
"SUPPRF94864",16,25,64,38,-16,80,54,59,"Pilot 8","Pilot 8: max feedback + text",10,"high",-21
"SUPPRF94864",17,34,69,46,17,29,29,36,"Pilot 8","Pilot 8: max feedback + text",10,"high",10
"SUPPRF94864",18,37,62,71,0,60,71,61,"Pilot 8","Pilot 8: max feedback + text",10,"high",10
"SUPPRF94864",19,22,71,35,15,50,20,31,"Pilot 8","Pilot 8: max feedback + text",10,"high",4
"SUPPRF94864",20,27,69,15,-14,87,29,33,"Pilot 8","Pilot 8: max feedback + text",10,"high",-18
"SUPPRF94864",21,26,76,46,0,76,46,51,"Pilot 8","Pilot 8: max feedback + text",10,"high",-5
"SUPPRF94864",22,26,61,54,0,66,54,27,"Pilot 8","Pilot 8: max feedback + text",10,"high",27
"SUPPRF94864",23,33,66,78,24,55,54,64,"Pilot 8","Pilot 8: max feedback + text",10,"high",14
"SUPPRF94864",24,29,62,20,0,29,20,27,"Pilot 8","Pilot 8: max feedback + text",10,"high",-7
"SUPPRF94864",25,36,67,62,-1,48,63,50,"Pilot 8","Pilot 8: max feedback + text",10,"high",12
"SUPPRF94864",26,33,64,50,-13,49,63,51,"Pilot 8","Pilot 8: max feedback + text",10,"high",-1
"SUPPRF94864",27,33,63,33,-13,91,46,24,"Pilot 8","Pilot 8: max feedback + text",10,"high",9
"SUPPRF94864",28,34,72,55,1,36,54,59,"Pilot 8","Pilot 8: max feedback + text",10,"high",-4
"SUPPRF94864",29,30,68,81,1,53,80,70,"Pilot 8","Pilot 8: max feedback + text",10,"high",11
"SUPPRF94864",30,35,61,70,-1,89,71,65,"Pilot 8","Pilot 8: max feedback + text",10,"high",5
"SUPPRF94864",31,38,66,58,12,80,46,54,"Pilot 8","Pilot 8: max feedback + text",10,"high",4
"SUPPRF94864",32,46,56,55,-16,39,71,72,"Pilot 8","Pilot 8: max feedback + text",10,"high",-17
"SUPPRF94864",33,41,55,49,12,72,37,51,"Pilot 8","Pilot 8: max feedback + text",10,"high",-2
"SUPPRF94864",34,50,50,88,25,70,63,35,"Pilot 8","Pilot 8: max feedback + text",10,"high",53
"SUPPRF94864",35,40,49,47,27,94,20,14,"Pilot 8","Pilot 8: max feedback + text",10,"high",33
"SUPPRF94864",36,41,63,6,-14,74,20,30,"Pilot 8","Pilot 8: max feedback + text",10,"high",-24
"SUPPRF94864",37,39,52,24,-13,83,37,40,"Pilot 8","Pilot 8: max feedback + text",10,"high",-16
"SUPPRF94864",38,51,57,96,16,69,80,54,"Pilot 8","Pilot 8: max feedback + text",10,"high",42
"SUPPRF94864",39,49,50,8,-12,79,20,37,"Pilot 8","Pilot 8: max feedback + text",10,"high",-29
"SUPPRF94864",40,49,56,83,12,43,71,48,"Pilot 8","Pilot 8: max feedback + text",10,"high",35
"SUPPRF94864",41,46,50,34,-12,80,46,43,"Pilot 8","Pilot 8: max feedback + text",10,"high",-9
"SUPPRF94864",42,49,53,63,0,73,63,43,"Pilot 8","Pilot 8: max feedback + text",10,"high",20
"SUPPRF94864",43,48,50,19,-1,89,20,3,"Pilot 8","Pilot 8: max feedback + text",10,"high",16
"SUPPRF94864",44,50,53,58,29,42,29,66,"Pilot 8","Pilot 8: max feedback + text",10,"high",-8
"SUPPRF94864",45,47,48,22,-15,82,37,48,"Pilot 8","Pilot 8: max feedback + text",10,"high",-26
"SUPPRF94864",46,52,50,68,-12,84,80,63,"Pilot 8","Pilot 8: max feedback + text",10,"high",5
"SUPPRF94864",47,51,45,80,0,39,80,91,"Pilot 8","Pilot 8: max feedback + text",10,"high",-11
"SUPPRF94864",48,48,49,16,-13,82,29,3,"Pilot 8","Pilot 8: max feedback + text",10,"high",13
"SUPPRF95014",1,47,57,62,-1,82,63,81,"Pilot 6","Pilot 6: feedback + text",9,"high",-19
"SUPPRF95014",2,38,37,50,-13,60,63,67,"Pilot 6","Pilot 6: feedback + text",9,"high",-17
"SUPPRF95014",3,35,27,34,-12,22,46,42,"Pilot 6","Pilot 6: feedback + text",9,"high",-8
"SUPPRF95014",4,32,31,46,17,28,29,26,"Pilot 6","Pilot 6: feedback + text",9,"high",20
"SUPPRF95014",5,30,35,29,0,35,29,37,"Pilot 6","Pilot 6: feedback + text",9,"high",-8
"SUPPRF95014",6,30,32,35,15,30,20,27,"Pilot 6","Pilot 6: feedback + text",9,"high",8
"SUPPRF95014",7,41,42,77,14,25,63,28,"Pilot 6","Pilot 6: feedback + text",9,"high",49
"SUPPRF95014",8,34,35,84,13,37,71,39,"Pilot 6","Pilot 6: feedback + text",9,"high",45
"SUPPRF95014",9,45,46,66,12,41,54,37,"Pilot 6","Pilot 6: feedback + text",9,"high",29
"SUPPRF95014",10,47,45,47,-16,71,63,69,"Pilot 6","Pilot 6: feedback + text",9,"high",-22
"SUPPRF95014",11,52,28,49,12,59,37,50,"Pilot 6","Pilot 6: feedback + text",9,"high",-1
"SUPPRF95014",12,39,36,6,-14,66,20,64,"Pilot 6","Pilot 6: feedback + text",9,"high",-58
"SUPPRF95014",13,38,40,83,12,39,71,43,"Pilot 6","Pilot 6: feedback + text",9,"high",40
"SUPPRF95014",14,33,32,15,-14,33,29,51,"Pilot 6","Pilot 6: feedback + text",9,"high",-36
"SUPPRF95014",15,26,36,68,-12,66,80,59,"Pilot 6","Pilot 6: feedback + text",9,"high",9
"SUPPRF95014",16,38,32,70,-1,36,71,32,"Pilot 6","Pilot 6: feedback + text",9,"high",38
"SUPPRF95014",17,19,4,45,-1,57,46,49,"Pilot 6","Pilot 6: feedback + text",9,"high",-4
"SUPPRF95014",18,11,24,55,1,33,54,32,"Pilot 6","Pilot 6: feedback + text",9,"high",23
"SUPPRF95014",19,24,27,22,-15,86,37,70,"Pilot 6","Pilot 6: feedback + text",9,"high",-48
"SUPPRF95014",20,14,42,38,1,100,37,99,"Pilot 6","Pilot 6: feedback + text",9,"high",-61
"SUPPRF95014",21,6,5,58,12,87,46,91,"Pilot 6","Pilot 6: feedback + text",9,"high",-33
"SUPPRF95014",22,15,80,80,0,46,80,51,"Pilot 6","Pilot 6: feedback + text",9,"high",29
"SUPPRF95014",23,34,37,16,-13,63,29,56,"Pilot 6","Pilot 6: feedback + text",9,"high",-40
"SUPPRF95014",24,22,23,96,16,34,80,36,"Pilot 6","Pilot 6: feedback + text",9,"high",60
"SUPPRF95014",25,0,100,68,14,94,54,87,"Pilot 6","Pilot 6: feedback + text",9,"high",-19
"SUPPRF95014",26,29,37,20,0,38,20,34,"Pilot 6","Pilot 6: feedback + text",9,"high",-14
"SUPPRF95014",27,37,34,41,-13,33,54,26,"Pilot 6","Pilot 6: feedback + text",9,"high",15
"SUPPRF95014",28,34,50,65,19,56,46,52,"Pilot 6","Pilot 6: feedback + text",9,"high",13
"SUPPRF95014",29,27,32,54,0,42,54,28,"Pilot 6","Pilot 6: feedback + text",9,"high",26
"SUPPRF95014",30,0,33,56,-15,53,71,52,"Pilot 6","Pilot 6: feedback + text",9,"high",4
"SUPPRF95014",31,32,32,8,-12,29,20,27,"Pilot 6","Pilot 6: feedback + text",9,"high",-19
"SUPPRF95014",32,22,17,51,14,99,37,1,"Pilot 6","Pilot 6: feedback + text",9,"high",50
"SUPPRF95014",33,14,5,37,0,86,37,20,"Pilot 6","Pilot 6: feedback + text",9,"high",17
"SUPPRF95014",34,1,82,46,0,5,46,3,"Pilot 6","Pilot 6: feedback + text",9,"high",43
"SUPPRF95014",35,0,40,63,0,38,63,13,"Pilot 6","Pilot 6: feedback + text",9,"high",50
"SUPPRF95014",36,27,29,28,-1,95,29,11,"Pilot 6","Pilot 6: feedback + text",9,"high",17
"SUPPRF95014",37,14,5,33,-13,34,46,30,"Pilot 6","Pilot 6: feedback + text",9,"high",3
"SUPPRF95014",38,22,24,37,17,16,20,15,"Pilot 6","Pilot 6: feedback + text",9,"high",22
"SUPPRF95014",39,2,45,97,17,82,80,82,"Pilot 6","Pilot 6: feedback + text",9,"high",15
"SUPPRF95014",40,4,9,55,-16,48,71,38,"Pilot 6","Pilot 6: feedback + text",9,"high",17
"SUPPRF95014",41,11,22,19,-1,83,20,88,"Pilot 6","Pilot 6: feedback + text",9,"high",-69
"SUPPRF95014",42,43,43,78,15,35,63,38,"Pilot 6","Pilot 6: feedback + text",9,"high",40
"SUPPRF95014",43,30,12,71,0,67,71,56,"Pilot 6","Pilot 6: feedback + text",9,"high",15
"SUPPRF95014",44,44,41,38,-16,53,54,46,"Pilot 6","Pilot 6: feedback + text",9,"high",-8
"SUPPRF95014",45,14,100,81,1,82,80,68,"Pilot 6","Pilot 6: feedback + text",9,"high",13
"SUPPRF95014",46,14,12,24,-13,99,37,98,"Pilot 6","Pilot 6: feedback + text",9,"high",-74
"SUPPRF95014",47,2,97,48,19,98,29,96,"Pilot 6","Pilot 6: feedback + text",9,"high",-48
"SUPPRF95014",48,15,10,67,-13,97,80,97,"Pilot 6","Pilot 6: feedback + text",9,"high",-30
"SUPPRF95208",1,93,7,28,-1,22,29,74,"Pilot 11","Pilot 11: bigger feedback + video + socially anxious",3,"low",-46
"SUPPRF95208",2,90,9,94,23,18,71,73,"Pilot 11","Pilot 11: bigger feedback + video + socially anxious",3,"low",21
"SUPPRF95208",3,95,3,41,-13,4,54,65,"Pilot 11","Pilot 11: bigger feedback + video + socially anxious",3,"low",-24
"SUPPRF95208",4,98,1,67,-13,10,80,77,"Pilot 11","Pilot 11: bigger feedback + video + socially anxious",3,"low",-10
"SUPPRF95208",5,97,3,71,0,3,71,70,"Pilot 11","Pilot 11: bigger feedback + video + socially anxious",3,"low",1
"SUPPRF95208",6,95,6,47,27,9,20,25,"Pilot 11","Pilot 11: bigger feedback + video + socially anxious",3,"low",22
"SUPPRF95208",7,92,5,38,1,33,37,54,"Pilot 11","Pilot 11: bigger feedback + video + socially anxious",3,"low",-16
"SUPPRF95208",8,95,5,96,16,20,80,89,"Pilot 11","Pilot 11: bigger feedback + video + socially anxious",3,"low",7
"SUPPRF95208",9,94,5,58,29,31,29,37,"Pilot 11","Pilot 11: bigger feedback + video + socially anxious",3,"low",21
"SUPPRF95208",10,97,5,77,14,24,63,55,"Pilot 11","Pilot 11: bigger feedback + video + socially anxious",3,"low",22
"SUPPRF95208",11,97,3,8,-12,15,20,40,"Pilot 11","Pilot 11: bigger feedback + video + socially anxious",3,"low",-32
"SUPPRF95208",12,95,5,83,12,18,71,72,"Pilot 11","Pilot 11: bigger feedback + video + socially anxious",3,"low",11
"SUPPRF95208",13,98,3,56,-15,74,71,76,"Pilot 11","Pilot 11: bigger feedback + video + socially anxious",3,"low",-20
"SUPPRF95208",14,98,2,62,-1,20,63,58,"Pilot 11","Pilot 11: bigger feedback + video + socially anxious",3,"low",4
"SUPPRF95208",15,99,1,46,17,5,29,32,"Pilot 11","Pilot 11: bigger feedback + video + socially anxious",3,"low",14
"SUPPRF95208",16,99,2,68,-12,55,80,89,"Pilot 11","Pilot 11: bigger feedback + video + socially anxious",3,"low",-21
"SUPPRF95208",17,95,1,33,-13,68,46,45,"Pilot 11","Pilot 11: bigger feedback + video + socially anxious",3,"low",-12
"SUPPRF95208",18,98,2,47,-16,67,63,51,"Pilot 11","Pilot 11: bigger feedback + video + socially anxious",3,"low",-4
"SUPPRF95208",19,97,3,58,12,79,46,53,"Pilot 11","Pilot 11: bigger feedback + video + socially anxious",3,"low",5
"SUPPRF95208",20,94,4,20,0,83,20,22,"Pilot 11","Pilot 11: bigger feedback + video + socially anxious",3,"low",-2
"SUPPRF95208",21,94,4,80,0,74,80,86,"Pilot 11","Pilot 11: bigger feedback + video + socially anxious",3,"low",-6
"SUPPRF95208",22,98,4,49,12,73,37,51,"Pilot 11","Pilot 11: bigger feedback + video + socially anxious",3,"low",-2
"SUPPRF95208",23,97,2,100,20,75,80,83,"Pilot 11","Pilot 11: bigger feedback + video + socially anxious",3,"low",17
"SUPPRF95208",24,97,2,55,-16,57,71,80,"Pilot 11","Pilot 11: bigger feedback + video + socially anxious",3,"low",-25
"SUPPRF95208",25,94,3,50,-13,71,63,55,"Pilot 11","Pilot 11: bigger feedback + video + socially anxious",3,"low",-5
"SUPPRF95208",26,95,3,24,-13,90,37,44,"Pilot 11","Pilot 11: bigger feedback + video + socially anxious",3,"low",-20
"SUPPRF95208",27,93,3,88,25,76,63,66,"Pilot 11","Pilot 11: bigger feedback + video + socially anxious",3,"low",22
"SUPPRF95208",28,96,4,22,-15,47,37,49,"Pilot 11","Pilot 11: bigger feedback + video + socially anxious",3,"low",-27
"SUPPRF95208",29,96,2,55,1,71,54,55,"Pilot 11","Pilot 11: bigger feedback + video + socially anxious",3,"low",0
"SUPPRF95208",30,97,3,34,-12,57,46,56,"Pilot 11","Pilot 11: bigger feedback + video + socially anxious",3,"low",-22
"SUPPRF95208",31,99,2,19,-1,14,20,57,"Pilot 11","Pilot 11: bigger feedback + video + socially anxious",3,"low",-38
"SUPPRF95208",32,98,1,70,-1,64,71,71,"Pilot 11","Pilot 11: bigger feedback + video + socially anxious",3,"low",-1
"SUPPRF95208",33,96,5,6,-14,73,20,22,"Pilot 11","Pilot 11: bigger feedback + video + socially anxious",3,"low",-16
"SUPPRF95208",34,99,4,16,-13,18,29,17,"Pilot 11","Pilot 11: bigger feedback + video + socially anxious",3,"low",-1
"SUPPRF95208",35,99,1,81,1,51,80,34,"Pilot 11","Pilot 11: bigger feedback + video + socially anxious",3,"low",47
"SUPPRF95208",36,97,6,29,0,94,29,14,"Pilot 11","Pilot 11: bigger feedback + video + socially anxious",3,"low",15
"SUPPRF95208",37,99,2,54,0,8,54,57,"Pilot 11","Pilot 11: bigger feedback + video + socially anxious",3,"low",-3
"SUPPRF95208",38,97,6,61,24,69,37,42,"Pilot 11","Pilot 11: bigger feedback + video + socially anxious",3,"low",19
"SUPPRF95208",39,99,5,35,15,91,20,17,"Pilot 11","Pilot 11: bigger feedback + video + socially anxious",3,"low",18
"SUPPRF95208",40,99,3,46,0,66,46,54,"Pilot 11","Pilot 11: bigger feedback + video + socially anxious",3,"low",-8
"SUPPRF95208",41,97,5,66,12,63,54,56,"Pilot 11","Pilot 11: bigger feedback + video + socially anxious",3,"low",10
"SUPPRF95208",42,97,1,75,29,71,46,58,"Pilot 11","Pilot 11: bigger feedback + video + socially anxious",3,"low",17
"SUPPRF95208",43,97,2,15,-14,59,29,23,"Pilot 11","Pilot 11: bigger feedback + video + socially anxious",3,"low",-8
"SUPPRF95208",44,98,0,38,-16,64,54,52,"Pilot 11","Pilot 11: bigger feedback + video + socially anxious",3,"low",-14
"SUPPRF95208",45,97,4,37,0,83,37,32,"Pilot 11","Pilot 11: bigger feedback + video + socially anxious",3,"low",5
"SUPPRF95208",46,96,2,45,-1,85,46,55,"Pilot 11","Pilot 11: bigger feedback + video + socially anxious",3,"low",-10
"SUPPRF95208",47,97,2,78,24,90,54,53,"Pilot 11","Pilot 11: bigger feedback + video + socially anxious",3,"low",25
"SUPPRF95208",48,96,3,63,0,75,63,50,"Pilot 11","Pilot 11: bigger feedback + video + socially anxious",3,"low",13
"SUPPRF95341",1,79,16,6,-14,78,20,19,"Pilot 9","Pilot 9: bigger feedback + text",1,"low",-13
"SUPPRF95341",2,86,8,63,0,40,63,63,"Pilot 9","Pilot 9: bigger feedback + text",1,"low",0
"SUPPRF95341",3,76,5,55,1,89,54,67,"Pilot 9","Pilot 9: bigger feedback + text",1,"low",-12
"SUPPRF95341",4,94,2,15,-14,74,29,19,"Pilot 9","Pilot 9: bigger feedback + text",1,"low",-4
"SUPPRF95341",5,95,4,62,-1,81,63,63,"Pilot 9","Pilot 9: bigger feedback + text",1,"low",-1
"SUPPRF95341",6,98,5,58,12,89,46,51,"Pilot 9","Pilot 9: bigger feedback + text",1,"low",7
"SUPPRF95341",7,95,3,50,-13,77,63,61,"Pilot 9","Pilot 9: bigger feedback + text",1,"low",-11
"SUPPRF95341",8,98,2,94,23,2,71,84,"Pilot 9","Pilot 9: bigger feedback + text",1,"low",10
"SUPPRF95341",9,87,7,47,-16,77,63,56,"Pilot 9","Pilot 9: bigger feedback + text",1,"low",-9
"SUPPRF95341",10,99,2,71,0,12,71,69,"Pilot 9","Pilot 9: bigger feedback + text",1,"low",2
"SUPPRF95341",11,84,8,41,-13,91,54,54,"Pilot 9","Pilot 9: bigger feedback + text",1,"low",-13
"SUPPRF95341",12,83,18,22,-15,79,37,46,"Pilot 9","Pilot 9: bigger feedback + text",1,"low",-24
"SUPPRF95341",13,96,18,78,24,28,54,49,"Pilot 9","Pilot 9: bigger feedback + text",1,"low",29
"SUPPRF95341",14,96,5,66,12,78,54,58,"Pilot 9","Pilot 9: bigger feedback + text",1,"low",8
"SUPPRF95341",15,99,0,100,20,64,80,81,"Pilot 9","Pilot 9: bigger feedback + text",1,"low",19
"SUPPRF95341",16,98,1,68,-12,57,80,80,"Pilot 9","Pilot 9: bigger feedback + text",1,"low",-12
"SUPPRF95341",17,90,7,54,0,76,54,57,"Pilot 9","Pilot 9: bigger feedback + text",1,"low",-3
"SUPPRF95341",18,98,16,46,0,33,46,26,"Pilot 9","Pilot 9: bigger feedback + text",1,"low",20
"SUPPRF95341",19,99,3,81,1,80,80,79,"Pilot 9","Pilot 9: bigger feedback + text",1,"low",2
"SUPPRF95341",20,72,10,8,-12,7,20,49,"Pilot 9","Pilot 9: bigger feedback + text",1,"low",-41
"SUPPRF95341",21,88,4,38,1,32,37,40,"Pilot 9","Pilot 9: bigger feedback + text",1,"low",-2
"SUPPRF95341",22,78,10,49,12,71,37,30,"Pilot 9","Pilot 9: bigger feedback + text",1,"low",19
"SUPPRF95341",23,98,3,28,-1,97,29,20,"Pilot 9","Pilot 9: bigger feedback + text",1,"low",8
"SUPPRF95341",24,98,6,35,15,5,20,54,"Pilot 9","Pilot 9: bigger feedback + text",1,"low",-19
"SUPPRF95341",25,92,3,67,-13,11,80,72,"Pilot 9","Pilot 9: bigger feedback + text",1,"low",-5
"SUPPRF95341",26,91,8,16,-13,86,29,17,"Pilot 9","Pilot 9: bigger feedback + text",1,"low",-1
"SUPPRF95341",27,98,8,45,-1,63,46,30,"Pilot 9","Pilot 9: bigger feedback + text",1,"low",15
"SUPPRF95341",28,89,5,83,12,88,71,75,"Pilot 9","Pilot 9: bigger feedback + text",1,"low",8
"SUPPRF95341",29,97,1,38,-16,87,54,79,"Pilot 9","Pilot 9: bigger feedback + text",1,"low",-41
"SUPPRF95341",30,99,7,96,16,23,80,37,"Pilot 9","Pilot 9: bigger feedback + text",1,"low",59
"SUPPRF95341",31,100,4,58,29,75,29,23,"Pilot 9","Pilot 9: bigger feedback + text",1,"low",35
"SUPPRF95341",32,98,3,56,-15,4,71,94,"Pilot 9","Pilot 9: bigger feedback + text",1,"low",-38
"SUPPRF95341",33,92,11,34,-12,58,46,44,"Pilot 9","Pilot 9: bigger feedback + text",1,"low",-10
"SUPPRF95341",34,92,5,55,-16,9,71,49,"Pilot 9","Pilot 9: bigger feedback + text",1,"low",6
"SUPPRF95341",35,98,6,33,-13,7,46,28,"Pilot 9","Pilot 9: bigger feedback + text",1,"low",5
"SUPPRF95341",36,89,10,70,-1,9,71,47,"Pilot 9","Pilot 9: bigger feedback + text",1,"low",23
"SUPPRF95341",37,97,4,19,-1,44,20,79,"Pilot 9","Pilot 9: bigger feedback + text",1,"low",-60
"SUPPRF95341",38,98,1,29,0,95,29,21,"Pilot 9","Pilot 9: bigger feedback + text",1,"low",8
"SUPPRF95341",39,89,2,24,-13,11,37,67,"Pilot 9","Pilot 9: bigger feedback + text",1,"low",-43
"SUPPRF95341",40,99,0,88,25,82,63,40,"Pilot 9","Pilot 9: bigger feedback + text",1,"low",48
"SUPPRF95341",41,99,0,80,0,87,80,18,"Pilot 9","Pilot 9: bigger feedback + text",1,"low",62
"SUPPRF95341",42,87,11,20,0,87,20,7,"Pilot 9","Pilot 9: bigger feedback + text",1,"low",13
"SUPPRF95341",43,100,1,47,27,81,20,12,"Pilot 9","Pilot 9: bigger feedback + text",1,"low",35
"SUPPRF95341",44,99,4,46,17,89,29,15,"Pilot 9","Pilot 9: bigger feedback + text",1,"low",31
"SUPPRF95341",45,98,9,77,14,90,63,79,"Pilot 9","Pilot 9: bigger feedback + text",1,"low",-2
"SUPPRF95341",46,99,2,61,24,26,37,21,"Pilot 9","Pilot 9: bigger feedback + text",1,"low",40
"SUPPRF95341",47,98,10,37,0,45,37,37,"Pilot 9","Pilot 9: bigger feedback + text",1,"low",0
"SUPPRF95341",48,91,5,75,29,92,46,28,"Pilot 9","Pilot 9: bigger feedback + text",1,"low",47
"SUPPRF96180",1,79,36,58,12,77,46,37,"Pilot 6","Pilot 6: feedback + text",6,"high",21
"SUPPRF96180",2,87,24,80,0,82,80,71,"Pilot 6","Pilot 6: feedback + text",6,"high",9
"SUPPRF96180",3,78,31,38,1,88,37,45,"Pilot 6","Pilot 6: feedback + text",6,"high",-7
"SUPPRF96180",4,81,26,54,0,89,54,40,"Pilot 6","Pilot 6: feedback + text",6,"high",14
"SUPPRF96180",5,63,51,15,-14,71,29,40,"Pilot 6","Pilot 6: feedback + text",6,"high",-25
"SUPPRF96180",6,73,36,51,14,70,37,40,"Pilot 6","Pilot 6: feedback + text",6,"high",11
"SUPPRF96180",7,71,32,37,17,53,20,15,"Pilot 6","Pilot 6: feedback + text",6,"high",22
"SUPPRF96180",8,71,19,97,17,93,80,90,"Pilot 6","Pilot 6: feedback + text",6,"high",7
"SUPPRF96180",9,74,17,48,19,30,29,30,"Pilot 6","Pilot 6: feedback + text",6,"high",18
"SUPPRF96180",10,76,42,8,-12,60,20,10,"Pilot 6","Pilot 6: feedback + text",6,"high",-2
"SUPPRF96180",11,83,28,20,0,70,20,25,"Pilot 6","Pilot 6: feedback + text",6,"high",-5
"SUPPRF96180",12,83,35,41,-13,65,54,60,"Pilot 6","Pilot 6: feedback + text",6,"high",-19
"SUPPRF96180",13,57,49,67,-13,80,80,85,"Pilot 6","Pilot 6: feedback + text",6,"high",-18
"SUPPRF96180",14,59,54,28,-1,42,29,45,"Pilot 6","Pilot 6: feedback + text",6,"high",-17
"SUPPRF96180",15,77,32,81,1,80,80,85,"Pilot 6","Pilot 6: feedback + text",6,"high",-4
"SUPPRF96180",16,76,21,77,14,70,63,70,"Pilot 6","Pilot 6: feedback + text",6,"high",7
"SUPPRF96180",17,68,34,56,-15,85,71,70,"Pilot 6","Pilot 6: feedback + text",6,"high",-14
"SUPPRF96180",18,82,21,22,-15,65,37,25,"Pilot 6","Pilot 6: feedback + text",6,"high",-3
"SUPPRF96180",19,72,20,6,-14,20,20,30,"Pilot 6","Pilot 6: feedback + text",6,"high",-24
"SUPPRF96180",20,82,13,46,0,40,46,55,"Pilot 6","Pilot 6: feedback + text",6,"high",-9
"SUPPRF96180",21,78,15,65,19,75,46,40,"Pilot 6","Pilot 6: feedback + text",6,"high",25
"SUPPRF96180",22,83,21,83,12,60,71,70,"Pilot 6","Pilot 6: feedback + text",6,"high",13
"SUPPRF96180",23,86,12,49,12,40,37,35,"Pilot 6","Pilot 6: feedback + text",6,"high",14
"SUPPRF96180",24,86,5,34,-12,10,46,40,"Pilot 6","Pilot 6: feedback + text",6,"high",-6
"SUPPRF96180",25,92,13,70,-1,80,71,70,"Pilot 6","Pilot 6: feedback + text",6,"high",0
"SUPPRF96180",26,74,28,47,-16,90,63,65,"Pilot 6","Pilot 6: feedback + text",6,"high",-18
"SUPPRF96180",27,83,18,37,0,30,37,50,"Pilot 6","Pilot 6: feedback + text",6,"high",-13
"SUPPRF96180",28,84,9,50,-13,35,63,65,"Pilot 6","Pilot 6: feedback + text",6,"high",-15
"SUPPRF96180",29,82,19,62,-1,50,63,40,"Pilot 6","Pilot 6: feedback + text",6,"high",22
"SUPPRF96180",30,95,8,35,15,80,20,25,"Pilot 6","Pilot 6: feedback + text",6,"high",10
"SUPPRF96180",31,79,19,71,0,30,71,65,"Pilot 6","Pilot 6: feedback + text",6,"high",6
"SUPPRF96180",32,91,20,46,17,10,29,55,"Pilot 6","Pilot 6: feedback + text",6,"high",-9
"SUPPRF96180",33,91,10,55,1,75,54,50,"Pilot 6","Pilot 6: feedback + text",6,"high",5
"SUPPRF96180",34,72,28,55,-16,30,71,65,"Pilot 6","Pilot 6: feedback + text",6,"high",-10
"SUPPRF96180",35,82,24,16,-13,80,29,30,"Pilot 6","Pilot 6: feedback + text",6,"high",-14
"SUPPRF96180",36,93,14,96,16,40,80,60,"Pilot 6","Pilot 6: feedback + text",6,"high",36
"SUPPRF96180",37,76,24,78,15,5,63,55,"Pilot 6","Pilot 6: feedback + text",6,"high",23
"SUPPRF96180",38,66,30,38,-16,70,54,50,"Pilot 6","Pilot 6: feedback + text",6,"high",-12
"SUPPRF96180",39,85,20,33,-13,40,46,45,"Pilot 6","Pilot 6: feedback + text",6,"high",-12
"SUPPRF96180",40,94,11,84,13,75,71,70,"Pilot 6","Pilot 6: feedback + text",6,"high",14
"SUPPRF96180",41,87,31,68,14,15,54,40,"Pilot 6","Pilot 6: feedback + text",6,"high",28
"SUPPRF96180",42,76,37,63,0,80,63,40,"Pilot 6","Pilot 6: feedback + text",6,"high",23
"SUPPRF96180",43,96,19,66,12,60,54,50,"Pilot 6","Pilot 6: feedback + text",6,"high",16
"SUPPRF96180",44,87,24,45,-1,20,46,40,"Pilot 6","Pilot 6: feedback + text",6,"high",5
"SUPPRF96180",45,73,41,29,0,10,29,60,"Pilot 6","Pilot 6: feedback + text",6,"high",-31
"SUPPRF96180",46,54,42,68,-12,90,80,80,"Pilot 6","Pilot 6: feedback + text",6,"high",-12
"SUPPRF96180",47,66,34,19,-1,70,20,25,"Pilot 6","Pilot 6: feedback + text",6,"high",-6
"SUPPRF96180",48,42,71,24,-13,10,37,50,"Pilot 6","Pilot 6: feedback + text",6,"high",-26
"SUPPRF96217",1,42,21,50,-13,35,63,43,"Pilot 8","Pilot 8: max feedback + text",0,"low",7
"SUPPRF96217",2,43,31,47,27,34,20,35,"Pilot 8","Pilot 8: max feedback + text",0,"low",12
"SUPPRF96217",3,44,26,45,-1,45,46,55,"Pilot 8","Pilot 8: max feedback + text",0,"low",-10
"SUPPRF96217",4,42,22,19,-1,59,20,38,"Pilot 8","Pilot 8: max feedback + text",0,"low",-19
"SUPPRF96217",5,41,20,77,14,34,63,53,"Pilot 8","Pilot 8: max feedback + text",0,"low",24
"SUPPRF96217",6,32,14,37,0,66,37,26,"Pilot 8","Pilot 8: max feedback + text",0,"low",11
"SUPPRF96217",7,43,10,38,1,60,37,22,"Pilot 8","Pilot 8: max feedback + text",0,"low",16
"SUPPRF96217",8,39,18,61,24,67,37,32,"Pilot 8","Pilot 8: max feedback + text",0,"low",29
"SUPPRF96217",9,59,8,100,20,29,80,67,"Pilot 8","Pilot 8: max feedback + text",0,"low",33
"SUPPRF96217",10,50,23,34,-12,70,46,56,"Pilot 8","Pilot 8: max feedback + text",0,"low",-22
"SUPPRF96217",11,50,15,58,12,60,46,38,"Pilot 8","Pilot 8: max feedback + text",0,"low",20
"SUPPRF96217",12,49,22,55,-16,58,71,66,"Pilot 8","Pilot 8: max feedback + text",0,"low",-11
"SUPPRF96217",13,44,21,16,-13,63,29,34,"Pilot 8","Pilot 8: max feedback + text",0,"low",-18
"SUPPRF96217",14,65,23,88,25,62,63,73,"Pilot 8","Pilot 8: max feedback + text",0,"low",15
"SUPPRF96217",15,51,21,55,1,60,54,72,"Pilot 8","Pilot 8: max feedback + text",0,"low",-17
"SUPPRF96217",16,50,17,68,-12,71,80,79,"Pilot 8","Pilot 8: max feedback + text",0,"low",-11
"SUPPRF96217",17,46,12,94,23,77,71,80,"Pilot 8","Pilot 8: max feedback + text",0,"low",14
"SUPPRF96217",18,50,11,66,12,75,54,56,"Pilot 8","Pilot 8: max feedback + text",0,"low",10
"SUPPRF96217",19,43,32,96,16,31,80,77,"Pilot 8","Pilot 8: max feedback + text",0,"low",19
"SUPPRF96217",20,44,32,78,24,67,54,64,"Pilot 8","Pilot 8: max feedback + text",0,"low",14
"SUPPRF96217",21,53,25,22,-15,72,37,42,"Pilot 8","Pilot 8: max feedback + text",0,"low",-20
"SUPPRF96217",22,50,15,47,-16,65,63,52,"Pilot 8","Pilot 8: max feedback + text",0,"low",-5
"SUPPRF96217",23,39,14,62,-1,68,63,58,"Pilot 8","Pilot 8: max feedback + text",0,"low",4
"SUPPRF96217",24,45,17,28,-1,50,29,33,"Pilot 8","Pilot 8: max feedback + text",0,"low",-5
"SUPPRF96217",25,45,18,46,17,30,29,42,"Pilot 8","Pilot 8: max feedback + text",0,"low",4
"SUPPRF96217",26,44,14,70,-1,59,71,87,"Pilot 8","Pilot 8: max feedback + text",0,"low",-17
"SUPPRF96217",27,45,14,35,15,56,20,33,"Pilot 8","Pilot 8: max feedback + text",0,"low",2
"SUPPRF96217",28,45,16,80,0,77,80,80,"Pilot 8","Pilot 8: max feedback + text",0,"low",0
"SUPPRF96217",29,38,13,15,-14,27,29,75,"Pilot 8","Pilot 8: max feedback + text",0,"low",-60
"SUPPRF96217",30,44,14,63,0,24,63,41,"Pilot 8","Pilot 8: max feedback + text",0,"low",22
"SUPPRF96217",31,41,14,49,12,15,37,35,"Pilot 8","Pilot 8: max feedback + text",0,"low",14
"SUPPRF96217",32,54,14,29,0,73,29,36,"Pilot 8","Pilot 8: max feedback + text",0,"low",-7
"SUPPRF96217",33,35,27,6,-14,73,20,40,"Pilot 8","Pilot 8: max feedback + text",0,"low",-34
"SUPPRF96217",34,46,13,81,1,15,80,33,"Pilot 8","Pilot 8: max feedback + text",0,"low",48
"SUPPRF96217",35,43,13,56,-15,72,71,79,"Pilot 8","Pilot 8: max feedback + text",0,"low",-23
"SUPPRF96217",36,45,11,67,-13,55,80,59,"Pilot 8","Pilot 8: max feedback + text",0,"low",8
"SUPPRF96217",37,45,15,24,-13,29,37,32,"Pilot 8","Pilot 8: max feedback + text",0,"low",-8
"SUPPRF96217",38,45,12,71,0,74,71,77,"Pilot 8","Pilot 8: max feedback + text",0,"low",-6
"SUPPRF96217",39,41,13,41,-13,50,54,62,"Pilot 8","Pilot 8: max feedback + text",0,"low",-21
"SUPPRF96217",40,44,10,54,0,79,54,68,"Pilot 8","Pilot 8: max feedback + text",0,"low",-14
"SUPPRF96217",41,45,24,83,12,96,71,81,"Pilot 8","Pilot 8: max feedback + text",0,"low",2
"SUPPRF96217",42,53,13,75,29,77,46,84,"Pilot 8","Pilot 8: max feedback + text",0,"low",-9
"SUPPRF96217",43,48,19,58,29,18,29,35,"Pilot 8","Pilot 8: max feedback + text",0,"low",23
"SUPPRF96217",44,39,9,20,0,11,20,36,"Pilot 8","Pilot 8: max feedback + text",0,"low",-16
"SUPPRF96217",45,39,12,38,-16,53,54,60,"Pilot 8","Pilot 8: max feedback + text",0,"low",-22
"SUPPRF96217",46,28,13,8,-12,69,20,25,"Pilot 8","Pilot 8: max feedback + text",0,"low",-17
"SUPPRF96217",47,41,12,33,-13,71,46,33,"Pilot 8","Pilot 8: max feedback + text",0,"low",0
"SUPPRF96217",48,47,16,46,0,90,46,45,"Pilot 8","Pilot 8: max feedback + text",0,"low",1
"SUPPRF96614",1,35,74,67,-13,70,80,39,"Pilot 11","Pilot 11: bigger feedback + video + socially anxious",8,"high",28
"SUPPRF96614",2,39,68,16,-13,41,29,33,"Pilot 11","Pilot 11: bigger feedback + video + socially anxious",8,"high",-17
"SUPPRF96614",3,64,43,55,1,54,54,61,"Pilot 11","Pilot 11: bigger feedback + video + socially anxious",8,"high",-6
"SUPPRF96614",4,67,19,58,12,36,46,47,"Pilot 11","Pilot 11: bigger feedback + video + socially anxious",8,"high",11
"SUPPRF96614",5,55,28,20,0,43,20,36,"Pilot 11","Pilot 11: bigger feedback + video + socially anxious",8,"high",-16
"SUPPRF96614",6,65,54,55,-16,65,71,63,"Pilot 11","Pilot 11: bigger feedback + video + socially anxious",8,"high",-8
"SUPPRF96614",7,53,56,38,1,51,37,69,"Pilot 11","Pilot 11: bigger feedback + video + socially anxious",8,"high",-31
"SUPPRF96614",8,32,37,34,-12,59,46,63,"Pilot 11","Pilot 11: bigger feedback + video + socially anxious",8,"high",-29
"SUPPRF96614",9,54,55,62,-1,57,63,63,"Pilot 11","Pilot 11: bigger feedback + video + socially anxious",8,"high",-1
"SUPPRF96614",10,57,55,50,-13,56,63,58,"Pilot 11","Pilot 11: bigger feedback + video + socially anxious",8,"high",-8
"SUPPRF96614",11,55,52,38,-16,55,54,56,"Pilot 11","Pilot 11: bigger feedback + video + socially anxious",8,"high",-18
"SUPPRF96614",12,69,38,41,-13,58,54,69,"Pilot 11","Pilot 11: bigger feedback + video + socially anxious",8,"high",-28
"SUPPRF96614",13,33,45,19,-1,61,20,27,"Pilot 11","Pilot 11: bigger feedback + video + socially anxious",8,"high",-8
"SUPPRF96614",14,51,47,61,24,61,37,57,"Pilot 11","Pilot 11: bigger feedback + video + socially anxious",8,"high",4
"SUPPRF96614",15,47,57,81,1,57,80,75,"Pilot 11","Pilot 11: bigger feedback + video + socially anxious",8,"high",6
"SUPPRF96614",16,64,40,78,24,35,54,52,"Pilot 11","Pilot 11: bigger feedback + video + socially anxious",8,"high",26
"SUPPRF96614",17,43,24,47,27,47,20,26,"Pilot 11","Pilot 11: bigger feedback + video + socially anxious",8,"high",21
"SUPPRF96614",18,59,41,75,29,46,46,43,"Pilot 11","Pilot 11: bigger feedback + video + socially anxious",8,"high",32
"SUPPRF96614",19,44,44,22,-15,57,37,55,"Pilot 11","Pilot 11: bigger feedback + video + socially anxious",8,"high",-33
"SUPPRF96614",20,69,53,35,15,29,20,35,"Pilot 11","Pilot 11: bigger feedback + video + socially anxious",8,"high",0
"SUPPRF96614",21,8,28,6,-14,38,20,42,"Pilot 11","Pilot 11: bigger feedback + video + socially anxious",8,"high",-36
"SUPPRF96614",22,51,51,49,12,46,37,38,"Pilot 11","Pilot 11: bigger feedback + video + socially anxious",8,"high",11
"SUPPRF96614",23,62,23,46,17,50,29,49,"Pilot 11","Pilot 11: bigger feedback + video + socially anxious",8,"high",-3
"SUPPRF96614",24,80,17,83,12,58,71,84,"Pilot 11","Pilot 11: bigger feedback + video + socially anxious",8,"high",-1
"SUPPRF96614",25,77,9,77,14,34,63,37,"Pilot 11","Pilot 11: bigger feedback + video + socially anxious",8,"high",40
"SUPPRF96614",26,86,9,46,0,78,46,44,"Pilot 11","Pilot 11: bigger feedback + video + socially anxious",8,"high",2
"SUPPRF96614",27,74,23,63,0,41,63,60,"Pilot 11","Pilot 11: bigger feedback + video + socially anxious",8,"high",3
"SUPPRF96614",28,20,9,28,-1,55,29,43,"Pilot 11","Pilot 11: bigger feedback + video + socially anxious",8,"high",-15
"SUPPRF96614",29,69,16,71,0,72,71,75,"Pilot 11","Pilot 11: bigger feedback + video + socially anxious",8,"high",-4
"SUPPRF96614",30,85,14,58,29,39,29,51,"Pilot 11","Pilot 11: bigger feedback + video + socially anxious",8,"high",7
"SUPPRF96614",31,30,17,56,-15,66,71,71,"Pilot 11","Pilot 11: bigger feedback + video + socially anxious",8,"high",-15
"SUPPRF96614",32,6,19,15,-14,52,29,49,"Pilot 11","Pilot 11: bigger feedback + video + socially anxious",8,"high",-34
"SUPPRF96614",33,80,6,80,0,38,80,49,"Pilot 11","Pilot 11: bigger feedback + video + socially anxious",8,"high",31
"SUPPRF96614",34,51,16,33,-13,39,46,54,"Pilot 11","Pilot 11: bigger feedback + video + socially anxious",8,"high",-21
"SUPPRF96614",35,94,5,96,16,48,80,50,"Pilot 11","Pilot 11: bigger feedback + video + socially anxious",8,"high",46
"SUPPRF96614",36,82,23,68,-12,76,80,88,"Pilot 11","Pilot 11: bigger feedback + video + socially anxious",8,"high",-20
"SUPPRF96614",37,82,9,70,-1,41,71,74,"Pilot 11","Pilot 11: bigger feedback + video + socially anxious",8,"high",-4
"SUPPRF96614",38,74,20,45,-1,68,46,45,"Pilot 11","Pilot 11: bigger feedback + video + socially anxious",8,"high",0
"SUPPRF96614",39,16,20,24,-13,30,37,60,"Pilot 11","Pilot 11: bigger feedback + video + socially anxious",8,"high",-36
"SUPPRF96614",40,73,18,29,0,33,29,28,"Pilot 11","Pilot 11: bigger feedback + video + socially anxious",8,"high",1
"SUPPRF96614",41,8,13,8,-12,49,20,53,"Pilot 11","Pilot 11: bigger feedback + video + socially anxious",8,"high",-45
"SUPPRF96614",42,75,29,66,12,49,54,53,"Pilot 11","Pilot 11: bigger feedback + video + socially anxious",8,"high",13
"SUPPRF96614",43,68,16,47,-16,29,63,59,"Pilot 11","Pilot 11: bigger feedback + video + socially anxious",8,"high",-12
"SUPPRF96614",44,85,13,88,25,73,63,66,"Pilot 11","Pilot 11: bigger feedback + video + socially anxious",8,"high",22
"SUPPRF96614",45,98,3,100,20,65,80,73,"Pilot 11","Pilot 11: bigger feedback + video + socially anxious",8,"high",27
"SUPPRF96614",46,68,2,37,0,57,37,33,"Pilot 11","Pilot 11: bigger feedback + video + socially anxious",8,"high",4
"SUPPRF96614",47,63,13,54,0,35,54,59,"Pilot 11","Pilot 11: bigger feedback + video + socially anxious",8,"high",-5
"SUPPRF96614",48,97,6,94,23,20,71,75,"Pilot 11","Pilot 11: bigger feedback + video + socially anxious",8,"high",19
"SUPPRF97235",1,48,70,68,-12,63,80,80,"Pilot 7","Pilot 7: bigger feedback + text",10,"high",-12
"SUPPRF97235",2,58,58,49,12,54,37,34,"Pilot 7","Pilot 7: bigger feedback + text",10,"high",15
"SUPPRF97235",3,51,58,33,-13,59,46,43,"Pilot 7","Pilot 7: bigger feedback + text",10,"high",-10
"SUPPRF97235",4,50,45,37,17,41,20,24,"Pilot 7","Pilot 7: bigger feedback + text",10,"high",13
"SUPPRF97235",5,49,48,63,0,42,63,46,"Pilot 7","Pilot 7: bigger feedback + text",10,"high",17
"SUPPRF97235",6,49,44,62,-1,27,63,53,"Pilot 7","Pilot 7: bigger feedback + text",10,"high",9
"SUPPRF97235",7,49,49,16,-13,27,29,32,"Pilot 7","Pilot 7: bigger feedback + text",10,"high",-16
"SUPPRF97235",8,50,32,70,-1,64,71,76,"Pilot 7","Pilot 7: bigger feedback + text",10,"high",-6
"SUPPRF97235",9,52,29,45,-1,11,46,56,"Pilot 7","Pilot 7: bigger feedback + text",10,"high",-11
"SUPPRF97235",10,57,21,78,15,44,63,64,"Pilot 7","Pilot 7: bigger feedback + text",10,"high",14
"SUPPRF97235",11,50,23,38,-16,48,54,57,"Pilot 7","Pilot 7: bigger feedback + text",10,"high",-19
"SUPPRF97235",12,50,49,84,13,57,71,60,"Pilot 7","Pilot 7: bigger feedback + text",10,"high",24
"SUPPRF97235",13,48,21,19,-1,72,20,21,"Pilot 7","Pilot 7: bigger feedback + text",10,"high",-2
"SUPPRF97235",14,51,15,77,14,25,63,79,"Pilot 7","Pilot 7: bigger feedback + text",10,"high",-2
"SUPPRF97235",15,48,17,41,-13,61,54,65,"Pilot 7","Pilot 7: bigger feedback + text",10,"high",-24
"SUPPRF97235",16,51,19,55,1,39,54,51,"Pilot 7","Pilot 7: bigger feedback + text",10,"high",4
"SUPPRF97235",17,48,12,46,0,32,46,50,"Pilot 7","Pilot 7: bigger feedback + text",10,"high",-4
"SUPPRF97235",18,52,15,80,0,36,80,86,"Pilot 7","Pilot 7: bigger feedback + text",10,"high",-6
"SUPPRF97235",19,53,14,68,14,27,54,45,"Pilot 7","Pilot 7: bigger feedback + text",10,"high",23
"SUPPRF97235",20,48,13,51,14,27,37,42,"Pilot 7","Pilot 7: bigger feedback + text",10,"high",9
"SUPPRF97235",21,51,17,47,-16,39,63,54,"Pilot 7","Pilot 7: bigger feedback + text",10,"high",-7
"SUPPRF97235",22,47,14,20,0,47,20,11,"Pilot 7","Pilot 7: bigger feedback + text",10,"high",9
"SUPPRF97235",23,42,17,38,1,33,37,53,"Pilot 7","Pilot 7: bigger feedback + text",10,"high",-15
"SUPPRF97235",24,43,27,24,-13,42,37,31,"Pilot 7","Pilot 7: bigger feedback + text",10,"high",-7
"SUPPRF97235",25,45,19,67,-13,53,80,78,"Pilot 7","Pilot 7: bigger feedback + text",10,"high",-11
"SUPPRF97235",26,42,21,96,16,28,80,73,"Pilot 7","Pilot 7: bigger feedback + text",10,"high",23
"SUPPRF97235",27,42,19,35,15,34,20,20,"Pilot 7","Pilot 7: bigger feedback + text",10,"high",15
"SUPPRF97235",28,43,11,58,12,40,46,31,"Pilot 7","Pilot 7: bigger feedback + text",10,"high",27
"SUPPRF97235",29,45,22,29,0,32,29,25,"Pilot 7","Pilot 7: bigger feedback + text",10,"high",4
"SUPPRF97235",30,43,22,97,17,48,80,85,"Pilot 7","Pilot 7: bigger feedback + text",10,"high",12
"SUPPRF97235",31,45,30,56,-15,41,71,58,"Pilot 7","Pilot 7: bigger feedback + text",10,"high",-2
"SUPPRF97235",32,42,29,54,0,38,54,56,"Pilot 7","Pilot 7: bigger feedback + text",10,"high",-2
"SUPPRF97235",33,46,25,46,17,50,29,21,"Pilot 7","Pilot 7: bigger feedback + text",10,"high",25
"SUPPRF97235",34,42,32,71,0,37,71,38,"Pilot 7","Pilot 7: bigger feedback + text",10,"high",33
"SUPPRF97235",35,39,29,55,-16,59,71,72,"Pilot 7","Pilot 7: bigger feedback + text",10,"high",-17
"SUPPRF97235",36,50,25,15,-14,46,29,15,"Pilot 7","Pilot 7: bigger feedback + text",10,"high",0
"SUPPRF97235",37,39,25,28,-1,46,29,12,"Pilot 7","Pilot 7: bigger feedback + text",10,"high",16
"SUPPRF97235",38,42,30,8,-12,39,20,17,"Pilot 7","Pilot 7: bigger feedback + text",10,"high",-9
"SUPPRF97235",39,34,22,6,-14,41,20,22,"Pilot 7","Pilot 7: bigger feedback + text",10,"high",-16
"SUPPRF97235",40,42,28,65,19,30,46,53,"Pilot 7","Pilot 7: bigger feedback + text",10,"high",12
"SUPPRF97235",41,40,25,37,0,33,37,52,"Pilot 7","Pilot 7: bigger feedback + text",10,"high",-15
"SUPPRF97235",42,40,23,48,19,27,29,22,"Pilot 7","Pilot 7: bigger feedback + text",10,"high",26
"SUPPRF97235",43,42,24,66,12,27,54,49,"Pilot 7","Pilot 7: bigger feedback + text",10,"high",17
"SUPPRF97235",44,40,25,34,-12,18,46,36,"Pilot 7","Pilot 7: bigger feedback + text",10,"high",-2
"SUPPRF97235",45,42,23,50,-13,31,63,59,"Pilot 7","Pilot 7: bigger feedback + text",10,"high",-9
"SUPPRF97235",46,37,16,22,-15,35,37,32,"Pilot 7","Pilot 7: bigger feedback + text",10,"high",-10
"SUPPRF97235",47,42,21,81,1,66,80,86,"Pilot 7","Pilot 7: bigger feedback + text",10,"high",-5
"SUPPRF97235",48,42,23,83,12,53,71,75,"Pilot 7","Pilot 7: bigger feedback + text",10,"high",8
"SUPPRF97320",1,78,5,35,15,49,20,21,"Pilot 8","Pilot 8: max feedback + text",6,"high",14
"SUPPRF97320",2,90,5,83,12,60,71,75,"Pilot 8","Pilot 8: max feedback + text",6,"high",8
"SUPPRF97320",3,89,6,16,-13,76,29,29,"Pilot 8","Pilot 8: max feedback + text",6,"high",-13
"SUPPRF97320",4,94,4,70,-1,67,71,83,"Pilot 8","Pilot 8: max feedback + text",6,"high",-13
"SUPPRF97320",5,97,3,58,29,61,29,14,"Pilot 8","Pilot 8: max feedback + text",6,"high",44
"SUPPRF97320",6,98,2,45,-1,41,46,48,"Pilot 8","Pilot 8: max feedback + text",6,"high",-3
"SUPPRF97320",7,97,3,28,-1,0,29,48,"Pilot 8","Pilot 8: max feedback + text",6,"high",-20
"SUPPRF97320",8,91,1,55,-16,41,71,62,"Pilot 8","Pilot 8: max feedback + text",6,"high",-7
"SUPPRF97320",9,96,2,81,1,76,80,78,"Pilot 8","Pilot 8: max feedback + text",6,"high",3
"SUPPRF97320",10,98,2,41,-13,5,54,64,"Pilot 8","Pilot 8: max feedback + text",6,"high",-23
"SUPPRF97320",11,97,4,34,-12,52,46,29,"Pilot 8","Pilot 8: max feedback + text",6,"high",5
"SUPPRF97320",12,100,1,100,20,89,80,89,"Pilot 8","Pilot 8: max feedback + text",6,"high",11
"SUPPRF97320",13,95,4,75,29,39,46,52,"Pilot 8","Pilot 8: max feedback + text",6,"high",23
"SUPPRF97320",14,99,0,94,23,18,71,27,"Pilot 8","Pilot 8: max feedback + text",6,"high",67
"SUPPRF97320",15,98,1,78,24,91,54,54,"Pilot 8","Pilot 8: max feedback + text",6,"high",24
"SUPPRF97320",16,93,3,24,-13,47,37,66,"Pilot 8","Pilot 8: max feedback + text",6,"high",-42
"SUPPRF97320",17,97,4,37,0,93,37,35,"Pilot 8","Pilot 8: max feedback + text",6,"high",2
"SUPPRF97320",18,98,3,29,0,72,29,39,"Pilot 8","Pilot 8: max feedback + text",6,"high",-10
"SUPPRF97320",19,98,1,50,-13,70,63,71,"Pilot 8","Pilot 8: max feedback + text",6,"high",-21
"SUPPRF97320",20,97,2,77,14,87,63,55,"Pilot 8","Pilot 8: max feedback + text",6,"high",22
"SUPPRF97320",21,93,1,71,0,25,71,59,"Pilot 8","Pilot 8: max feedback + text",6,"high",12
"SUPPRF97320",22,97,3,63,0,32,63,68,"Pilot 8","Pilot 8: max feedback + text",6,"high",-5
"SUPPRF97320",23,98,2,46,0,66,46,53,"Pilot 8","Pilot 8: max feedback + text",6,"high",-7
"SUPPRF97320",24,98,0,49,12,9,37,62,"Pilot 8","Pilot 8: max feedback + text",6,"high",-13
"SUPPRF97320",25,100,2,46,17,51,29,46,"Pilot 8","Pilot 8: max feedback + text",6,"high",0
"SUPPRF97320",26,95,4,20,0,29,20,72,"Pilot 8","Pilot 8: max feedback + text",6,"high",-52
"SUPPRF97320",27,97,2,66,12,82,54,54,"Pilot 8","Pilot 8: max feedback + text",6,"high",12
"SUPPRF97320",28,98,3,88,25,38,63,73,"Pilot 8","Pilot 8: max feedback + text",6,"high",15
"SUPPRF97320",29,98,4,38,1,13,37,70,"Pilot 8","Pilot 8: max feedback + text",6,"high",-32
"SUPPRF97320",30,98,1,80,0,88,80,84,"Pilot 8","Pilot 8: max feedback + text",6,"high",-4
"SUPPRF97320",31,99,1,54,0,86,54,52,"Pilot 8","Pilot 8: max feedback + text",6,"high",2
"SUPPRF97320",32,99,3,19,-1,8,20,45,"Pilot 8","Pilot 8: max feedback + text",6,"high",-26
"SUPPRF97320",33,99,2,15,-14,65,29,27,"Pilot 8","Pilot 8: max feedback + text",6,"high",-12
"SUPPRF97320",34,99,1,96,16,14,80,54,"Pilot 8","Pilot 8: max feedback + text",6,"high",42
"SUPPRF97320",35,98,1,58,12,73,46,25,"Pilot 8","Pilot 8: max feedback + text",6,"high",33
"SUPPRF97320",36,96,2,8,-12,18,20,25,"Pilot 8","Pilot 8: max feedback + text",6,"high",-17
"SUPPRF97320",37,98,1,67,-13,11,80,87,"Pilot 8","Pilot 8: max feedback + text",6,"high",-20
"SUPPRF97320",38,100,1,62,-1,21,63,33,"Pilot 8","Pilot 8: max feedback + text",6,"high",29
"SUPPRF97320",39,86,4,38,-16,32,54,86,"Pilot 8","Pilot 8: max feedback + text",6,"high",-48
"SUPPRF97320",40,89,4,55,1,77,54,47,"Pilot 8","Pilot 8: max feedback + text",6,"high",8
"SUPPRF97320",41,92,8,33,-13,85,46,45,"Pilot 8","Pilot 8: max feedback + text",6,"high",-12
"SUPPRF97320",42,93,7,56,-15,10,71,35,"Pilot 8","Pilot 8: max feedback + text",6,"high",21
"SUPPRF97320",43,96,4,61,24,12,37,64,"Pilot 8","Pilot 8: max feedback + text",6,"high",-3
"SUPPRF97320",44,95,5,47,27,33,20,61,"Pilot 8","Pilot 8: max feedback + text",6,"high",-14
"SUPPRF97320",45,92,2,68,-12,11,80,63,"Pilot 8","Pilot 8: max feedback + text",6,"high",5
"SUPPRF97320",46,99,3,22,-15,15,37,74,"Pilot 8","Pilot 8: max feedback + text",6,"high",-52
"SUPPRF97320",47,93,1,47,-16,89,63,62,"Pilot 8","Pilot 8: max feedback + text",6,"high",-15
"SUPPRF97320",48,96,1,6,-14,84,20,20,"Pilot 8","Pilot 8: max feedback + text",6,"high",-14
"SUPPRF97792",1,18,91,8,-12,74,20,32,"Pilot 11","Pilot 11: bigger feedback + video + socially anxious",6,"high",-24
"SUPPRF97792",2,38,56,58,12,77,46,49,"Pilot 11","Pilot 11: bigger feedback + video + socially anxious",6,"high",9
"SUPPRF97792",3,50,47,54,0,83,54,57,"Pilot 11","Pilot 11: bigger feedback + video + socially anxious",6,"high",-3
"SUPPRF97792",4,63,35,71,0,84,71,63,"Pilot 11","Pilot 11: bigger feedback + video + socially anxious",6,"high",8
"SUPPRF97792",5,36,59,70,-1,75,71,60,"Pilot 11","Pilot 11: bigger feedback + video + socially anxious",6,"high",10
"SUPPRF97792",6,67,29,35,15,59,20,19,"Pilot 11","Pilot 11: bigger feedback + video + socially anxious",6,"high",16
"SUPPRF97792",7,70,20,61,24,79,37,61,"Pilot 11","Pilot 11: bigger feedback + video + socially anxious",6,"high",0
"SUPPRF97792",8,52,47,55,-16,81,71,70,"Pilot 11","Pilot 11: bigger feedback + video + socially anxious",6,"high",-15
"SUPPRF97792",9,60,33,83,12,76,71,59,"Pilot 11","Pilot 11: bigger feedback + video + socially anxious",6,"high",24
"SUPPRF97792",10,40,56,33,-13,68,46,52,"Pilot 11","Pilot 11: bigger feedback + video + socially anxious",6,"high",-19
"SUPPRF97792",11,65,25,46,17,76,29,68,"Pilot 11","Pilot 11: bigger feedback + video + socially anxious",6,"high",-22
"SUPPRF97792",12,54,40,63,0,70,63,60,"Pilot 11","Pilot 11: bigger feedback + video + socially anxious",6,"high",3
"SUPPRF97792",13,28,68,50,-13,70,63,75,"Pilot 11","Pilot 11: bigger feedback + video + socially anxious",6,"high",-25
"SUPPRF97792",14,64,44,19,-1,82,20,63,"Pilot 11","Pilot 11: bigger feedback + video + socially anxious",6,"high",-44
"SUPPRF97792",15,62,38,56,-15,80,71,65,"Pilot 11","Pilot 11: bigger feedback + video + socially anxious",6,"high",-9
"SUPPRF97792",16,36,54,58,29,83,29,67,"Pilot 11","Pilot 11: bigger feedback + video + socially anxious",6,"high",-9
"SUPPRF97792",17,54,50,49,12,74,37,64,"Pilot 11","Pilot 11: bigger feedback + video + socially anxious",6,"high",-15
"SUPPRF97792",18,77,32,62,-1,70,63,60,"Pilot 11","Pilot 11: bigger feedback + video + socially anxious",6,"high",2
"SUPPRF97792",19,67,30,77,14,71,63,65,"Pilot 11","Pilot 11: bigger feedback + video + socially anxious",6,"high",12
"SUPPRF97792",20,67,25,66,12,67,54,66,"Pilot 11","Pilot 11: bigger feedback + video + socially anxious",6,"high",0
"SUPPRF97792",21,62,46,55,1,71,54,64,"Pilot 11","Pilot 11: bigger feedback + video + socially anxious",6,"high",-9
"SUPPRF97792",22,32,64,38,1,73,37,68,"Pilot 11","Pilot 11: bigger feedback + video + socially anxious",6,"high",-30
"SUPPRF97792",23,0,90,34,-12,74,46,68,"Pilot 11","Pilot 11: bigger feedback + video + socially anxious",6,"high",-34
"SUPPRF97792",24,78,21,81,1,89,80,100,"Pilot 11","Pilot 11: bigger feedback + video + socially anxious",6,"high",-19
"SUPPRF97792",25,80,18,88,25,69,63,70,"Pilot 11","Pilot 11: bigger feedback + video + socially anxious",6,"high",18
"SUPPRF97792",26,0,96,37,0,77,37,72,"Pilot 11","Pilot 11: bigger feedback + video + socially anxious",6,"high",-35
"SUPPRF97792",27,0,100,68,-12,100,80,89,"Pilot 11","Pilot 11: bigger feedback + video + socially anxious",6,"high",-21
"SUPPRF97792",28,29,82,80,0,100,80,100,"Pilot 11","Pilot 11: bigger feedback + video + socially anxious",6,"high",-20
"SUPPRF97792",29,89,11,94,23,81,71,71,"Pilot 11","Pilot 11: bigger feedback + video + socially anxious",6,"high",23
"SUPPRF97792",30,0,100,22,-15,83,37,75,"Pilot 11","Pilot 11: bigger feedback + video + socially anxious",6,"high",-53
"SUPPRF97792",31,0,100,47,27,86,20,69,"Pilot 11","Pilot 11: bigger feedback + video + socially anxious",6,"high",-22
"SUPPRF97792",32,59,41,78,24,85,54,71,"Pilot 11","Pilot 11: bigger feedback + video + socially anxious",6,"high",7
"SUPPRF97792",33,36,63,41,-13,79,54,66,"Pilot 11","Pilot 11: bigger feedback + video + socially anxious",6,"high",-25
"SUPPRF97792",34,14,81,46,0,78,46,68,"Pilot 11","Pilot 11: bigger feedback + video + socially anxious",6,"high",-22
"SUPPRF97792",35,91,8,100,20,87,80,68,"Pilot 11","Pilot 11: bigger feedback + video + socially anxious",6,"high",32
"SUPPRF97792",36,64,36,15,-14,100,29,75,"Pilot 11","Pilot 11: bigger feedback + video + socially anxious",6,"high",-60
"SUPPRF97792",37,18,80,28,-1,70,29,34,"Pilot 11","Pilot 11: bigger feedback + video + socially anxious",6,"high",-6
"SUPPRF97792",38,75,17,75,29,75,46,60,"Pilot 11","Pilot 11: bigger feedback + video + socially anxious",6,"high",15
"SUPPRF97792",39,0,100,24,-13,83,37,64,"Pilot 11","Pilot 11: bigger feedback + video + socially anxious",6,"high",-40
"SUPPRF97792",40,0,100,29,0,87,29,76,"Pilot 11","Pilot 11: bigger feedback + video + socially anxious",6,"high",-47
"SUPPRF97792",41,0,100,6,-14,91,20,80,"Pilot 11","Pilot 11: bigger feedback + video + socially anxious",6,"high",-74
"SUPPRF97792",42,14,85,45,-1,89,46,69,"Pilot 11","Pilot 11: bigger feedback + video + socially anxious",6,"high",-24
"SUPPRF97792",43,10,84,67,-13,91,80,81,"Pilot 11","Pilot 11: bigger feedback + video + socially anxious",6,"high",-14
"SUPPRF97792",44,0,98,16,-13,94,29,91,"Pilot 11","Pilot 11: bigger feedback + video + socially anxious",6,"high",-75
"SUPPRF97792",45,0,100,38,-16,78,54,69,"Pilot 11","Pilot 11: bigger feedback + video + socially anxious",6,"high",-31
"SUPPRF97792",46,56,8,47,-16,83,63,67,"Pilot 11","Pilot 11: bigger feedback + video + socially anxious",6,"high",-20
"SUPPRF97792",47,98,0,96,16,87,80,74,"Pilot 11","Pilot 11: bigger feedback + video + socially anxious",6,"high",22
"SUPPRF97792",48,22,21,20,0,85,20,74,"Pilot 11","Pilot 11: bigger feedback + video + socially anxious",6,"high",-54
"SUPPRF98014",1,91,16,35,15,45,20,23,"Pilot 8","Pilot 8: max feedback + text",7,"high",12
"SUPPRF98014",2,92,4,81,1,66,80,75,"Pilot 8","Pilot 8: max feedback + text",7,"high",6
"SUPPRF98014",3,90,4,63,0,76,63,64,"Pilot 8","Pilot 8: max feedback + text",7,"high",-1
"SUPPRF98014",4,76,9,29,0,68,29,16,"Pilot 8","Pilot 8: max feedback + text",7,"high",13
"SUPPRF98014",5,75,9,16,-13,73,29,30,"Pilot 8","Pilot 8: max feedback + text",7,"high",-14
"SUPPRF98014",6,79,6,61,24,30,37,48,"Pilot 8","Pilot 8: max feedback + text",7,"high",13
"SUPPRF98014",7,89,1,68,-12,75,80,78,"Pilot 8","Pilot 8: max feedback + text",7,"high",-10
"SUPPRF98014",8,61,10,6,-14,29,20,18,"Pilot 8","Pilot 8: max feedback + text",7,"high",-12
"SUPPRF98014",9,66,4,54,0,27,54,34,"Pilot 8","Pilot 8: max feedback + text",7,"high",20
"SUPPRF98014",10,96,3,94,23,69,71,32,"Pilot 8","Pilot 8: max feedback + text",7,"high",62
"SUPPRF98014",11,71,12,19,-1,82,20,17,"Pilot 8","Pilot 8: max feedback + text",7,"high",2
"SUPPRF98014",12,69,3,58,12,62,46,42,"Pilot 8","Pilot 8: max feedback + text",7,"high",16
"SUPPRF98014",13,82,2,37,0,71,37,37,"Pilot 8","Pilot 8: max feedback + text",7,"high",0
"SUPPRF98014",14,90,4,58,29,61,29,32,"Pilot 8","Pilot 8: max feedback + text",7,"high",26
"SUPPRF98014",15,74,2,20,0,84,20,15,"Pilot 8","Pilot 8: max feedback + text",7,"high",5
"SUPPRF98014",16,57,1,56,-15,80,71,77,"Pilot 8","Pilot 8: max feedback + text",7,"high",-21
"SUPPRF98014",17,97,2,75,29,81,46,37,"Pilot 8","Pilot 8: max feedback + text",7,"high",38
"SUPPRF98014",18,64,2,38,1,79,37,54,"Pilot 8","Pilot 8: max feedback + text",7,"high",-16
"SUPPRF98014",19,59,5,55,-16,80,71,73,"Pilot 8","Pilot 8: max feedback + text",7,"high",-18
"SUPPRF98014",20,77,5,66,12,68,54,52,"Pilot 8","Pilot 8: max feedback + text",7,"high",14
"SUPPRF98014",21,60,3,50,-13,86,63,68,"Pilot 8","Pilot 8: max feedback + text",7,"high",-18
"SUPPRF98014",22,63,2,33,-13,75,46,51,"Pilot 8","Pilot 8: max feedback + text",7,"high",-18
"SUPPRF98014",23,74,1,28,-1,74,29,22,"Pilot 8","Pilot 8: max feedback + text",7,"high",6
"SUPPRF98014",24,55,5,8,-12,74,20,16,"Pilot 8","Pilot 8: max feedback + text",7,"high",-8
"SUPPRF98014",25,71,1,49,12,86,37,33,"Pilot 8","Pilot 8: max feedback + text",7,"high",16
"SUPPRF98014",26,84,5,77,14,75,63,42,"Pilot 8","Pilot 8: max feedback + text",7,"high",35
"SUPPRF98014",27,81,7,38,-16,84,54,27,"Pilot 8","Pilot 8: max feedback + text",7,"high",11
"SUPPRF98014",28,91,3,88,25,77,63,59,"Pilot 8","Pilot 8: max feedback + text",7,"high",29
"SUPPRF98014",29,94,3,78,24,58,54,29,"Pilot 8","Pilot 8: max feedback + text",7,"high",49
"SUPPRF98014",30,90,4,83,12,59,71,70,"Pilot 8","Pilot 8: max feedback + text",7,"high",13
"SUPPRF98014",31,81,4,47,27,83,20,14,"Pilot 8","Pilot 8: max feedback + text",7,"high",33
"SUPPRF98014",32,75,7,47,-16,32,63,72,"Pilot 8","Pilot 8: max feedback + text",7,"high",-25
"SUPPRF98014",33,78,4,46,0,30,46,69,"Pilot 8","Pilot 8: max feedback + text",7,"high",-23
"SUPPRF98014",34,81,4,70,-1,26,71,35,"Pilot 8","Pilot 8: max feedback + text",7,"high",35
"SUPPRF98014",35,78,6,67,-13,35,80,53,"Pilot 8","Pilot 8: max feedback + text",7,"high",14
"SUPPRF98014",36,75,10,22,-15,75,37,45,"Pilot 8","Pilot 8: max feedback + text",7,"high",-23
"SUPPRF98014",37,87,3,62,-1,64,63,45,"Pilot 8","Pilot 8: max feedback + text",7,"high",17
"SUPPRF98014",38,76,7,45,-1,82,46,66,"Pilot 8","Pilot 8: max feedback + text",7,"high",-21
"SUPPRF98014",39,84,2,71,0,85,71,69,"Pilot 8","Pilot 8: max feedback + text",7,"high",2
"SUPPRF98014",40,44,14,55,1,60,54,96,"Pilot 8","Pilot 8: max feedback + text",7,"high",-41
"SUPPRF98014",41,53,9,24,-13,84,37,51,"Pilot 8","Pilot 8: max feedback + text",7,"high",-27
"SUPPRF98014",42,77,1,80,0,84,80,76,"Pilot 8","Pilot 8: max feedback + text",7,"high",4
"SUPPRF98014",43,91,2,96,16,75,80,74,"Pilot 8","Pilot 8: max feedback + text",7,"high",22
"SUPPRF98014",44,77,4,15,-14,85,29,31,"Pilot 8","Pilot 8: max feedback + text",7,"high",-16
"SUPPRF98014",45,76,13,34,-12,80,46,63,"Pilot 8","Pilot 8: max feedback + text",7,"high",-29
"SUPPRF98014",46,74,8,41,-13,78,54,33,"Pilot 8","Pilot 8: max feedback + text",7,"high",8
"SUPPRF98014",47,97,3,100,20,84,80,71,"Pilot 8","Pilot 8: max feedback + text",7,"high",29
"SUPPRF98014",48,86,2,46,17,79,29,29,"Pilot 8","Pilot 8: max feedback + text",7,"high",17
"SUPPRF98797",1,37,70,6,-14,41,20,29,"Pilot 11","Pilot 11: bigger feedback + video + socially anxious",9,"high",-23
"SUPPRF98797",2,37,62,88,25,25,63,38,"Pilot 11","Pilot 11: bigger feedback + video + socially anxious",9,"high",50
"SUPPRF98797",3,47,48,71,0,65,71,65,"Pilot 11","Pilot 11: bigger feedback + video + socially anxious",9,"high",6
"SUPPRF98797",4,46,51,49,12,50,37,25,"Pilot 11","Pilot 11: bigger feedback + video + socially anxious",9,"high",24
"SUPPRF98797",5,46,45,78,24,62,54,54,"Pilot 11","Pilot 11: bigger feedback + video + socially anxious",9,"high",24
"SUPPRF98797",6,44,48,35,15,48,20,22,"Pilot 11","Pilot 11: bigger feedback + video + socially anxious",9,"high",13
"SUPPRF98797",7,50,50,75,29,49,46,34,"Pilot 11","Pilot 11: bigger feedback + video + socially anxious",9,"high",41
"SUPPRF98797",8,48,48,50,-13,37,63,42,"Pilot 11","Pilot 11: bigger feedback + video + socially anxious",9,"high",8
"SUPPRF98797",9,46,48,29,0,44,29,43,"Pilot 11","Pilot 11: bigger feedback + video + socially anxious",9,"high",-14
"SUPPRF98797",10,46,50,16,-13,49,29,34,"Pilot 11","Pilot 11: bigger feedback + video + socially anxious",9,"high",-18
"SUPPRF98797",11,46,49,77,14,51,63,56,"Pilot 11","Pilot 11: bigger feedback + video + socially anxious",9,"high",21
"SUPPRF98797",12,47,47,94,23,47,71,62,"Pilot 11","Pilot 11: bigger feedback + video + socially anxious",9,"high",32
"SUPPRF98797",13,48,48,41,-13,33,54,46,"Pilot 11","Pilot 11: bigger feedback + video + socially anxious",9,"high",-5
"SUPPRF98797",14,48,45,63,0,55,63,47,"Pilot 11","Pilot 11: bigger feedback + video + socially anxious",9,"high",16
"SUPPRF98797",15,47,45,22,-15,33,37,28,"Pilot 11","Pilot 11: bigger feedback + video + socially anxious",9,"high",-6
"SUPPRF98797",16,49,50,96,16,45,80,64,"Pilot 11","Pilot 11: bigger feedback + video + socially anxious",9,"high",32
"SUPPRF98797",17,47,51,19,-1,41,20,17,"Pilot 11","Pilot 11: bigger feedback + video + socially anxious",9,"high",2
"SUPPRF98797",18,46,47,81,1,58,80,64,"Pilot 11","Pilot 11: bigger feedback + video + socially anxious",9,"high",17
"SUPPRF98797",19,39,43,83,12,55,71,69,"Pilot 11","Pilot 11: bigger feedback + video + socially anxious",9,"high",14
"SUPPRF98797",20,35,37,15,-14,54,29,20,"Pilot 11","Pilot 11: bigger feedback + video + socially anxious",9,"high",-5
"SUPPRF98797",21,39,27,46,17,37,29,31,"Pilot 11","Pilot 11: bigger feedback + video + socially anxious",9,"high",15
"SUPPRF98797",22,35,28,38,-16,31,54,59,"Pilot 11","Pilot 11: bigger feedback + video + socially anxious",9,"high",-21
"SUPPRF98797",23,32,25,66,12,39,54,46,"Pilot 11","Pilot 11: bigger feedback + video + socially anxious",9,"high",20
"SUPPRF98797",24,42,26,47,-16,28,63,46,"Pilot 11","Pilot 11: bigger feedback + video + socially anxious",9,"high",1
"SUPPRF98797",25,48,24,58,12,46,46,37,"Pilot 11","Pilot 11: bigger feedback + video + socially anxious",9,"high",21
"SUPPRF98797",26,50,27,55,1,50,54,41,"Pilot 11","Pilot 11: bigger feedback + video + socially anxious",9,"high",14
"SUPPRF98797",27,46,25,56,-15,44,71,66,"Pilot 11","Pilot 11: bigger feedback + video + socially anxious",9,"high",-10
"SUPPRF98797",28,36,24,58,29,52,29,28,"Pilot 11","Pilot 11: bigger feedback + video + socially anxious",9,"high",30
"SUPPRF98797",29,42,24,46,0,59,46,40,"Pilot 11","Pilot 11: bigger feedback + video + socially anxious",9,"high",6
"SUPPRF98797",30,41,27,54,0,45,54,42,"Pilot 11","Pilot 11: bigger feedback + video + socially anxious",9,"high",12
"SUPPRF98797",31,36,24,47,27,59,20,23,"Pilot 11","Pilot 11: bigger feedback + video + socially anxious",9,"high",24
"SUPPRF98797",32,39,24,61,24,58,37,24,"Pilot 11","Pilot 11: bigger feedback + video + socially anxious",9,"high",37
"SUPPRF98797",33,36,20,20,0,69,20,22,"Pilot 11","Pilot 11: bigger feedback + video + socially anxious",9,"high",-2
"SUPPRF98797",34,30,24,37,0,63,37,23,"Pilot 11","Pilot 11: bigger feedback + video + socially anxious",9,"high",14
"SUPPRF98797",35,35,22,45,-1,55,46,31,"Pilot 11","Pilot 11: bigger feedback + video + socially anxious",9,"high",14
"SUPPRF98797",36,37,20,8,-12,64,20,20,"Pilot 11","Pilot 11: bigger feedback + video + socially anxious",9,"high",-12
"SUPPRF98797",37,23,25,67,-13,57,80,66,"Pilot 11","Pilot 11: bigger feedback + video + socially anxious",9,"high",1
"SUPPRF98797",38,30,20,24,-13,26,37,30,"Pilot 11","Pilot 11: bigger feedback + video + socially anxious",9,"high",-6
"SUPPRF98797",39,29,44,100,20,68,80,66,"Pilot 11","Pilot 11: bigger feedback + video + socially anxious",9,"high",34
"SUPPRF98797",40,36,37,38,1,66,37,27,"Pilot 11","Pilot 11: bigger feedback + video + socially anxious",9,"high",11
"SUPPRF98797",41,33,44,55,-16,40,71,62,"Pilot 11","Pilot 11: bigger feedback + video + socially anxious",9,"high",-7
"SUPPRF98797",42,39,45,80,0,41,80,58,"Pilot 11","Pilot 11: bigger feedback + video + socially anxious",9,"high",22
"SUPPRF98797",43,36,53,62,-1,57,63,43,"Pilot 11","Pilot 11: bigger feedback + video + socially anxious",9,"high",19
"SUPPRF98797",44,39,56,34,-12,25,46,29,"Pilot 11","Pilot 11: bigger feedback + video + socially anxious",9,"high",5
"SUPPRF98797",45,34,59,28,-1,58,29,29,"Pilot 11","Pilot 11: bigger feedback + video + socially anxious",9,"high",-1
"SUPPRF98797",46,36,49,68,-12,59,80,63,"Pilot 11","Pilot 11: bigger feedback + video + socially anxious",9,"high",5
"SUPPRF98797",47,34,64,70,-1,50,71,53,"Pilot 11","Pilot 11: bigger feedback + video + socially anxious",9,"high",17
"SUPPRF98797",48,67,49,33,-13,48,46,33,"Pilot 11","Pilot 11: bigger feedback + video + socially anxious",9,"high",0
"SUPPRF98941",1,55,45,55,1,47,54,57,"Pilot 6","Pilot 6: feedback + text",7,"high",-2
"SUPPRF98941",2,46,44,65,19,60,46,51,"Pilot 6","Pilot 6: feedback + text",7,"high",14
"SUPPRF98941",3,44,54,54,0,56,54,51,"Pilot 6","Pilot 6: feedback + text",7,"high",3
"SUPPRF98941",4,51,50,50,-13,75,63,63,"Pilot 6","Pilot 6: feedback + text",7,"high",-13
"SUPPRF98941",5,49,54,46,17,52,29,41,"Pilot 6","Pilot 6: feedback + text",7,"high",5
"SUPPRF98941",6,47,61,6,-14,58,20,38,"Pilot 6","Pilot 6: feedback + text",7,"high",-32
"SUPPRF98941",7,50,60,68,-12,51,80,65,"Pilot 6","Pilot 6: feedback + text",7,"high",3
"SUPPRF98941",8,49,56,15,-14,55,29,62,"Pilot 6","Pilot 6: feedback + text",7,"high",-47
"SUPPRF98941",9,59,51,37,0,47,37,54,"Pilot 6","Pilot 6: feedback + text",7,"high",-17
"SUPPRF98941",10,47,49,66,12,40,54,32,"Pilot 6","Pilot 6: feedback + text",7,"high",34
"SUPPRF98941",11,53,56,46,0,39,46,35,"Pilot 6","Pilot 6: feedback + text",7,"high",11
"SUPPRF98941",12,66,53,67,-13,68,80,66,"Pilot 6","Pilot 6: feedback + text",7,"high",1
"SUPPRF98941",13,55,53,83,12,58,71,69,"Pilot 6","Pilot 6: feedback + text",7,"high",14
"SUPPRF98941",14,34,64,49,12,54,37,63,"Pilot 6","Pilot 6: feedback + text",7,"high",-14
"SUPPRF98941",15,56,51,22,-15,49,37,61,"Pilot 6","Pilot 6: feedback + text",7,"high",-39
"SUPPRF98941",16,49,58,20,0,52,20,61,"Pilot 6","Pilot 6: feedback + text",7,"high",-41
"SUPPRF98941",17,51,57,84,13,48,71,47,"Pilot 6","Pilot 6: feedback + text",7,"high",37
"SUPPRF98941",18,61,62,96,16,49,80,59,"Pilot 6","Pilot 6: feedback + text",7,"high",37
"SUPPRF98941",19,59,44,45,-1,49,46,58,"Pilot 6","Pilot 6: feedback + text",7,"high",-13
"SUPPRF98941",20,46,60,51,14,53,37,46,"Pilot 6","Pilot 6: feedback + text",7,"high",5
"SUPPRF98941",21,53,41,8,-12,51,20,58,"Pilot 6","Pilot 6: feedback + text",7,"high",-50
"SUPPRF98941",22,55,63,33,-13,83,46,1,"Pilot 6","Pilot 6: feedback + text",7,"high",32
"SUPPRF98941",23,53,51,24,-13,55,37,59,"Pilot 6","Pilot 6: feedback + text",7,"high",-35
"SUPPRF98941",24,50,53,29,0,41,29,32,"Pilot 6","Pilot 6: feedback + text",7,"high",-3
"SUPPRF98941",25,56,49,62,-1,60,63,69,"Pilot 6","Pilot 6: feedback + text",7,"high",-7
"SUPPRF98941",26,60,43,47,-16,60,63,39,"Pilot 6","Pilot 6: feedback + text",7,"high",8
"SUPPRF98941",27,38,37,34,-12,71,46,24,"Pilot 6","Pilot 6: feedback + text",7,"high",10
"SUPPRF98941",28,44,56,16,-13,67,29,17,"Pilot 6","Pilot 6: feedback + text",7,"high",-1
"SUPPRF98941",29,63,37,77,14,55,63,52,"Pilot 6","Pilot 6: feedback + text",7,"high",25
"SUPPRF98941",30,48,57,56,-15,33,71,31,"Pilot 6","Pilot 6: feedback + text",7,"high",25
"SUPPRF98941",31,46,51,38,1,48,37,38,"Pilot 6","Pilot 6: feedback + text",7,"high",0
"SUPPRF98941",32,59,53,80,0,52,80,63,"Pilot 6","Pilot 6: feedback + text",7,"high",17
"SUPPRF98941",33,58,49,55,-16,49,71,61,"Pilot 6","Pilot 6: feedback + text",7,"high",-6
"SUPPRF98941",34,53,60,41,-13,40,54,54,"Pilot 6","Pilot 6: feedback + text",7,"high",-13
"SUPPRF98941",35,38,47,19,-1,38,20,30,"Pilot 6","Pilot 6: feedback + text",7,"high",-11
"SUPPRF98941",36,63,54,68,14,43,54,52,"Pilot 6","Pilot 6: feedback + text",7,"high",16
"SUPPRF98941",37,56,51,71,0,53,71,58,"Pilot 6","Pilot 6: feedback + text",7,"high",13
"SUPPRF98941",38,54,48,28,-1,43,29,60,"Pilot 6","Pilot 6: feedback + text",7,"high",-32
"SUPPRF98941",39,48,56,38,-16,51,54,68,"Pilot 6","Pilot 6: feedback + text",7,"high",-30
"SUPPRF98941",40,61,42,70,-1,54,71,63,"Pilot 6","Pilot 6: feedback + text",7,"high",7
"SUPPRF98941",41,48,58,37,17,68,20,18,"Pilot 6","Pilot 6: feedback + text",7,"high",19
"SUPPRF98941",42,62,53,97,17,48,80,65,"Pilot 6","Pilot 6: feedback + text",7,"high",32
"SUPPRF98941",43,55,63,63,0,47,63,60,"Pilot 6","Pilot 6: feedback + text",7,"high",3
"SUPPRF98941",44,53,60,48,19,51,29,57,"Pilot 6","Pilot 6: feedback + text",7,"high",-9
"SUPPRF98941",45,52,51,78,15,53,63,61,"Pilot 6","Pilot 6: feedback + text",7,"high",17
"SUPPRF98941",46,50,58,35,15,28,20,15,"Pilot 6","Pilot 6: feedback + text",7,"high",20
"SUPPRF98941",47,52,64,81,1,48,80,70,"Pilot 6","Pilot 6: feedback + text",7,"high",11
"SUPPRF98941",48,39,45,58,12,55,46,35,"Pilot 6","Pilot 6: feedback + text",7,"high",23
"SUPPRF98981",1,28,97,35,15,55,20,85,"Pilot 10","Pilot 10: bigger feedback + video",2,"low",-50
"SUPPRF98981",2,3,98,16,-13,20,29,60,"Pilot 10","Pilot 10: bigger feedback + video",2,"low",-44
"SUPPRF98981",3,72,80,83,12,49,71,81,"Pilot 10","Pilot 10: bigger feedback + video",2,"low",2
"SUPPRF98981",4,72,66,67,-13,51,80,73,"Pilot 10","Pilot 10: bigger feedback + video",2,"low",-6
"SUPPRF98981",5,33,87,8,-12,37,20,74,"Pilot 10","Pilot 10: bigger feedback + video",2,"low",-66
"SUPPRF98981",6,83,64,71,0,63,71,77,"Pilot 10","Pilot 10: bigger feedback + video",2,"low",-6
"SUPPRF98981",7,81,59,47,-16,51,63,85,"Pilot 10","Pilot 10: bigger feedback + video",2,"low",-38
"SUPPRF98981",8,68,51,24,-13,52,37,77,"Pilot 10","Pilot 10: bigger feedback + video",2,"low",-53
"SUPPRF98981",9,76,34,81,1,37,80,65,"Pilot 10","Pilot 10: bigger feedback + video",2,"low",16
"SUPPRF98981",10,68,66,47,27,56,20,77,"Pilot 10","Pilot 10: bigger feedback + video",2,"low",-30
"SUPPRF98981",11,26,77,29,0,72,29,41,"Pilot 10","Pilot 10: bigger feedback + video",2,"low",-12
"SUPPRF98981",12,69,65,54,0,46,54,17,"Pilot 10","Pilot 10: bigger feedback + video",2,"low",37
"SUPPRF98981",13,69,70,94,23,53,71,42,"Pilot 10","Pilot 10: bigger feedback + video",2,"low",52
"SUPPRF98981",14,74,62,78,24,74,54,22,"Pilot 10","Pilot 10: bigger feedback + video",2,"low",56
"SUPPRF98981",15,98,7,100,20,73,80,43,"Pilot 10","Pilot 10: bigger feedback + video",2,"low",57
"SUPPRF98981",16,79,72,41,-13,45,54,31,"Pilot 10","Pilot 10: bigger feedback + video",2,"low",10
"SUPPRF98981",17,65,78,20,0,84,20,16,"Pilot 10","Pilot 10: bigger feedback + video",2,"low",4
"SUPPRF98981",18,76,75,22,-15,79,37,44,"Pilot 10","Pilot 10: bigger feedback + video",2,"low",-22
"SUPPRF98981",19,81,65,62,-1,67,63,71,"Pilot 10","Pilot 10: bigger feedback + video",2,"low",-9
"SUPPRF98981",20,56,52,37,0,54,37,55,"Pilot 10","Pilot 10: bigger feedback + video",2,"low",-18
"SUPPRF98981",21,61,14,61,24,22,37,87,"Pilot 10","Pilot 10: bigger feedback + video",2,"low",-26
"SUPPRF98981",22,84,62,70,-1,64,71,70,"Pilot 10","Pilot 10: bigger feedback + video",2,"low",0
"SUPPRF98981",23,71,22,56,-15,84,71,58,"Pilot 10","Pilot 10: bigger feedback + video",2,"low",-2
"SUPPRF98981",24,70,48,38,1,92,37,29,"Pilot 10","Pilot 10: bigger feedback + video",2,"low",9
"SUPPRF98981",25,66,75,38,-16,86,54,22,"Pilot 10","Pilot 10: bigger feedback + video",2,"low",16
"SUPPRF98981",26,53,45,46,0,86,46,49,"Pilot 10","Pilot 10: bigger feedback + video",2,"low",-3
"SUPPRF98981",27,87,10,55,-16,90,71,54,"Pilot 10","Pilot 10: bigger feedback + video",2,"low",1
"SUPPRF98981",28,80,40,49,12,90,37,32,"Pilot 10","Pilot 10: bigger feedback + video",2,"low",17
"SUPPRF98981",29,86,83,77,14,52,63,53,"Pilot 10","Pilot 10: bigger feedback + video",2,"low",24
"SUPPRF98981",30,54,71,28,-1,51,29,49,"Pilot 10","Pilot 10: bigger feedback + video",2,"low",-21
"SUPPRF98981",31,94,4,45,-1,96,46,46,"Pilot 10","Pilot 10: bigger feedback + video",2,"low",-1
"SUPPRF98981",32,81,6,63,0,91,63,70,"Pilot 10","Pilot 10: bigger feedback + video",2,"low",-7
"SUPPRF98981",33,82,9,19,-1,72,20,14,"Pilot 10","Pilot 10: bigger feedback + video",2,"low",5
"SUPPRF98981",34,82,89,55,1,66,54,63,"Pilot 10","Pilot 10: bigger feedback + video",2,"low",-8
"SUPPRF98981",35,77,78,80,0,63,80,58,"Pilot 10","Pilot 10: bigger feedback + video",2,"low",22
"SUPPRF98981",36,10,89,50,-13,91,63,80,"Pilot 10","Pilot 10: bigger feedback + video",2,"low",-30
"SUPPRF98981",37,63,71,68,-12,89,80,57,"Pilot 10","Pilot 10: bigger feedback + video",2,"low",11
"SUPPRF98981",38,51,62,58,12,70,46,26,"Pilot 10","Pilot 10: bigger feedback + video",2,"low",32
"SUPPRF98981",39,75,45,46,17,51,29,56,"Pilot 10","Pilot 10: bigger feedback + video",2,"low",-10
"SUPPRF98981",40,4,81,33,-13,68,46,56,"Pilot 10","Pilot 10: bigger feedback + video",2,"low",-23
"SUPPRF98981",41,17,76,96,16,91,80,27,"Pilot 10","Pilot 10: bigger feedback + video",2,"low",69
"SUPPRF98981",42,99,1,88,25,50,63,59,"Pilot 10","Pilot 10: bigger feedback + video",2,"low",29
"SUPPRF98981",43,58,67,15,-14,54,29,61,"Pilot 10","Pilot 10: bigger feedback + video",2,"low",-46
"SUPPRF98981",44,81,72,66,12,48,54,54,"Pilot 10","Pilot 10: bigger feedback + video",2,"low",12
"SUPPRF98981",45,86,27,58,29,68,29,55,"Pilot 10","Pilot 10: bigger feedback + video",2,"low",3
"SUPPRF98981",46,15,11,34,-12,54,46,62,"Pilot 10","Pilot 10: bigger feedback + video",2,"low",-28
"SUPPRF98981",47,99,4,75,29,91,46,63,"Pilot 10","Pilot 10: bigger feedback + video",2,"low",12
"SUPPRF98981",48,2,95,6,-14,94,20,93,"Pilot 10","Pilot 10: bigger feedback + video",2,"low",-87
"SUPPRF99152",1,99,41,100,20,26,80,66,"Pilot 9","Pilot 9: bigger feedback + text",5,"low",34
"SUPPRF99152",2,69,37,62,-1,53,63,70,"Pilot 9","Pilot 9: bigger feedback + text",5,"low",-8
"SUPPRF99152",3,73,38,35,15,59,20,30,"Pilot 9","Pilot 9: bigger feedback + text",5,"low",5
"SUPPRF99152",4,52,49,19,-1,26,20,30,"Pilot 9","Pilot 9: bigger feedback + text",5,"low",-11
"SUPPRF99152",5,37,52,22,-15,50,37,40,"Pilot 9","Pilot 9: bigger feedback + text",5,"low",-18
"SUPPRF99152",6,28,62,24,-13,50,37,50,"Pilot 9","Pilot 9: bigger feedback + text",5,"low",-26
"SUPPRF99152",7,55,44,58,12,43,46,44,"Pilot 9","Pilot 9: bigger feedback + text",5,"low",14
"SUPPRF99152",8,62,37,71,0,36,71,59,"Pilot 9","Pilot 9: bigger feedback + text",5,"low",12
"SUPPRF99152",9,65,37,78,24,25,54,50,"Pilot 9","Pilot 9: bigger feedback + text",5,"low",28
"SUPPRF99152",10,74,35,58,29,28,29,44,"Pilot 9","Pilot 9: bigger feedback + text",5,"low",14
"SUPPRF99152",11,50,50,41,-13,62,54,65,"Pilot 9","Pilot 9: bigger feedback + text",5,"low",-24
"SUPPRF99152",12,40,54,16,-13,26,29,30,"Pilot 9","Pilot 9: bigger feedback + text",5,"low",-14
"SUPPRF99152",13,64,31,47,27,29,20,28,"Pilot 9","Pilot 9: bigger feedback + text",5,"low",19
"SUPPRF99152",14,52,42,50,-13,25,63,60,"Pilot 9","Pilot 9: bigger feedback + text",5,"low",-10
"SUPPRF99152",15,57,35,54,0,37,54,54,"Pilot 9","Pilot 9: bigger feedback + text",5,"low",0
"SUPPRF99152",16,49,52,29,0,24,29,40,"Pilot 9","Pilot 9: bigger feedback + text",5,"low",-11
"SUPPRF99152",17,69,33,88,25,45,63,55,"Pilot 9","Pilot 9: bigger feedback + text",5,"low",33
"SUPPRF99152",18,52,53,28,-1,55,29,40,"Pilot 9","Pilot 9: bigger feedback + text",5,"low",-12
"SUPPRF99152",19,81,31,96,16,33,80,50,"Pilot 9","Pilot 9: bigger feedback + text",5,"low",46
"SUPPRF99152",20,48,51,33,-13,44,46,50,"Pilot 9","Pilot 9: bigger feedback + text",5,"low",-17
"SUPPRF99152",21,55,45,38,1,42,37,46,"Pilot 9","Pilot 9: bigger feedback + text",5,"low",-8
"SUPPRF99152",22,55,37,46,17,18,29,30,"Pilot 9","Pilot 9: bigger feedback + text",5,"low",16
"SUPPRF99152",23,59,35,61,24,35,37,44,"Pilot 9","Pilot 9: bigger feedback + text",5,"low",17
"SUPPRF99152",24,68,41,37,0,39,37,42,"Pilot 9","Pilot 9: bigger feedback + text",5,"low",-5
"SUPPRF99152",25,68,45,66,12,56,54,54,"Pilot 9","Pilot 9: bigger feedback + text",5,"low",12
"SUPPRF99152",26,72,25,81,1,41,80,67,"Pilot 9","Pilot 9: bigger feedback + text",5,"low",14
"SUPPRF99152",27,69,26,49,12,21,37,51,"Pilot 9","Pilot 9: bigger feedback + text",5,"low",-2
"SUPPRF99152",28,56,47,45,-1,34,46,29,"Pilot 9","Pilot 9: bigger feedback + text",5,"low",16
"SUPPRF99152",29,54,52,38,-16,53,54,52,"Pilot 9","Pilot 9: bigger feedback + text",5,"low",-14
"SUPPRF99152",30,66,33,56,-15,26,71,54,"Pilot 9","Pilot 9: bigger feedback + text",5,"low",2
"SUPPRF99152",31,67,46,20,0,53,20,20,"Pilot 9","Pilot 9: bigger feedback + text",5,"low",0
"SUPPRF99152",32,67,35,55,1,71,54,55,"Pilot 9","Pilot 9: bigger feedback + text",5,"low",0
"SUPPRF99152",33,69,43,46,0,56,46,35,"Pilot 9","Pilot 9: bigger feedback + text",5,"low",11
"SUPPRF99152",34,67,44,83,12,43,71,50,"Pilot 9","Pilot 9: bigger feedback + text",5,"low",33
"SUPPRF99152",35,61,33,67,-13,59,80,71,"Pilot 9","Pilot 9: bigger feedback + text",5,"low",-4
"SUPPRF99152",36,68,31,68,-12,60,80,72,"Pilot 9","Pilot 9: bigger feedback + text",5,"low",-4
"SUPPRF99152",37,64,37,63,0,40,63,48,"Pilot 9","Pilot 9: bigger feedback + text",5,"low",15
"SUPPRF99152",38,56,50,15,-14,56,29,32,"Pilot 9","Pilot 9: bigger feedback + text",5,"low",-17
"SUPPRF99152",39,64,41,70,-1,33,71,64,"Pilot 9","Pilot 9: bigger feedback + text",5,"low",6
"SUPPRF99152",40,72,32,75,29,58,46,48,"Pilot 9","Pilot 9: bigger feedback + text",5,"low",27
"SUPPRF99152",41,57,44,55,-16,40,71,72,"Pilot 9","Pilot 9: bigger feedback + text",5,"low",-17
"SUPPRF99152",42,55,49,47,-16,30,63,58,"Pilot 9","Pilot 9: bigger feedback + text",5,"low",-11
"SUPPRF99152",43,83,26,94,23,57,71,73,"Pilot 9","Pilot 9: bigger feedback + text",5,"low",21
"SUPPRF99152",44,39,66,6,-14,31,20,30,"Pilot 9","Pilot 9: bigger feedback + text",5,"low",-24
"SUPPRF99152",45,24,65,8,-12,27,20,25,"Pilot 9","Pilot 9: bigger feedback + text",5,"low",-17
"SUPPRF99152",46,50,50,34,-12,36,46,40,"Pilot 9","Pilot 9: bigger feedback + text",5,"low",-6
"SUPPRF99152",47,63,47,80,0,50,80,81,"Pilot 9","Pilot 9: bigger feedback + text",5,"low",-1
"SUPPRF99152",48,66,46,77,14,32,63,51,"Pilot 9","Pilot 9: bigger feedback + text",5,"low",26
"SUPPRF99862",1,55,52,24,-13,44,37,44,"Pilot 11","Pilot 11: bigger feedback + video + socially anxious",7,"high",-20
"SUPPRF99862",2,58,42,38,1,62,37,34,"Pilot 11","Pilot 11: bigger feedback + video + socially anxious",7,"high",4
"SUPPRF99862",3,52,44,28,-1,52,29,32,"Pilot 11","Pilot 11: bigger feedback + video + socially anxious",7,"high",-4
"SUPPRF99862",4,50,49,33,-13,42,46,26,"Pilot 11","Pilot 11: bigger feedback + video + socially anxious",7,"high",7
"SUPPRF99862",5,50,39,71,0,70,71,64,"Pilot 11","Pilot 11: bigger feedback + video + socially anxious",7,"high",7
"SUPPRF99862",6,48,40,6,-14,70,20,24,"Pilot 11","Pilot 11: bigger feedback + video + socially anxious",7,"high",-18
"SUPPRF99862",7,38,34,34,-12,42,46,27,"Pilot 11","Pilot 11: bigger feedback + video + socially anxious",7,"high",7
"SUPPRF99862",8,62,40,100,20,84,80,78,"Pilot 11","Pilot 11: bigger feedback + video + socially anxious",7,"high",22
"SUPPRF99862",9,53,38,77,14,78,63,64,"Pilot 11","Pilot 11: bigger feedback + video + socially anxious",7,"high",13
"SUPPRF99862",10,50,46,62,-1,45,63,44,"Pilot 11","Pilot 11: bigger feedback + video + socially anxious",7,"high",18
"SUPPRF99862",11,44,50,75,29,73,46,50,"Pilot 11","Pilot 11: bigger feedback + video + socially anxious",7,"high",25
"SUPPRF99862",12,58,51,68,-12,85,80,75,"Pilot 11","Pilot 11: bigger feedback + video + socially anxious",7,"high",-7
"SUPPRF99862",13,53,58,83,12,73,71,53,"Pilot 11","Pilot 11: bigger feedback + video + socially anxious",7,"high",30
"SUPPRF99862",14,50,58,54,0,72,54,31,"Pilot 11","Pilot 11: bigger feedback + video + socially anxious",7,"high",23
"SUPPRF99862",15,47,59,66,12,66,54,36,"Pilot 11","Pilot 11: bigger feedback + video + socially anxious",7,"high",30
"SUPPRF99862",16,41,66,22,-15,64,37,35,"Pilot 11","Pilot 11: bigger feedback + video + socially anxious",7,"high",-13
"SUPPRF99862",17,38,68,15,-14,24,29,48,"Pilot 11","Pilot 11: bigger feedback + video + socially anxious",7,"high",-33
"SUPPRF99862",18,38,73,35,15,76,20,19,"Pilot 11","Pilot 11: bigger feedback + video + socially anxious",7,"high",16
"SUPPRF99862",19,40,64,70,-1,49,71,36,"Pilot 11","Pilot 11: bigger feedback + video + socially anxious",7,"high",34
"SUPPRF99862",20,37,75,63,0,82,63,85,"Pilot 11","Pilot 11: bigger feedback + video + socially anxious",7,"high",-22
"SUPPRF99862",21,40,76,37,0,77,37,31,"Pilot 11","Pilot 11: bigger feedback + video + socially anxious",7,"high",6
"SUPPRF99862",22,45,67,47,27,82,20,18,"Pilot 11","Pilot 11: bigger feedback + video + socially anxious",7,"high",29
"SUPPRF99862",23,49,64,78,24,83,54,37,"Pilot 11","Pilot 11: bigger feedback + video + socially anxious",7,"high",41
"SUPPRF99862",24,44,66,8,-12,48,20,16,"Pilot 11","Pilot 11: bigger feedback + video + socially anxious",7,"high",-8
"SUPPRF99862",25,49,65,55,1,68,54,45,"Pilot 11","Pilot 11: bigger feedback + video + socially anxious",7,"high",10
"SUPPRF99862",26,52,60,96,16,93,80,80,"Pilot 11","Pilot 11: bigger feedback + video + socially anxious",7,"high",16
"SUPPRF99862",27,52,58,49,12,68,37,35,"Pilot 11","Pilot 11: bigger feedback + video + socially anxious",7,"high",14
"SUPPRF99862",28,50,61,47,-16,73,63,32,"Pilot 11","Pilot 11: bigger feedback + video + socially anxious",7,"high",15
"SUPPRF99862",29,56,56,46,17,75,29,23,"Pilot 11","Pilot 11: bigger feedback + video + socially anxious",7,"high",23
"SUPPRF99862",30,57,55,80,0,86,80,81,"Pilot 11","Pilot 11: bigger feedback + video + socially anxious",7,"high",-1
"SUPPRF99862",31,54,56,61,24,50,37,26,"Pilot 11","Pilot 11: bigger feedback + video + socially anxious",7,"high",35
"SUPPRF99862",32,48,60,94,23,68,71,38,"Pilot 11","Pilot 11: bigger feedback + video + socially anxious",7,"high",56
"SUPPRF99862",33,56,53,58,12,75,46,41,"Pilot 11","Pilot 11: bigger feedback + video + socially anxious",7,"high",17
"SUPPRF99862",34,46,49,29,0,74,29,36,"Pilot 11","Pilot 11: bigger feedback + video + socially anxious",7,"high",-7
"SUPPRF99862",35,50,46,41,-13,63,54,61,"Pilot 11","Pilot 11: bigger feedback + video + socially anxious",7,"high",-20
"SUPPRF99862",36,44,52,50,-13,74,63,27,"Pilot 11","Pilot 11: bigger feedback + video + socially anxious",7,"high",23
"SUPPRF99862",37,54,45,38,-16,69,54,43,"Pilot 11","Pilot 11: bigger feedback + video + socially anxious",7,"high",-5
"SUPPRF99862",38,52,46,19,-1,53,20,23,"Pilot 11","Pilot 11: bigger feedback + video + socially anxious",7,"high",-4
"SUPPRF99862",39,37,62,88,25,79,63,34,"Pilot 11","Pilot 11: bigger feedback + video + socially anxious",7,"high",54
"SUPPRF99862",40,51,55,56,-15,65,71,53,"Pilot 11","Pilot 11: bigger feedback + video + socially anxious",7,"high",3
"SUPPRF99862",41,49,55,58,29,83,29,15,"Pilot 11","Pilot 11: bigger feedback + video + socially anxious",7,"high",43
"SUPPRF99862",42,54,50,46,0,79,46,38,"Pilot 11","Pilot 11: bigger feedback + video + socially anxious",7,"high",8
"SUPPRF99862",43,70,42,81,1,98,80,81,"Pilot 11","Pilot 11: bigger feedback + video + socially anxious",7,"high",0
"SUPPRF99862",44,54,50,20,0,84,20,18,"Pilot 11","Pilot 11: bigger feedback + video + socially anxious",7,"high",2
"SUPPRF99862",45,56,49,67,-13,95,80,89,"Pilot 11","Pilot 11: bigger feedback + video + socially anxious",7,"high",-22
"SUPPRF99862",46,47,49,16,-13,96,29,8,"Pilot 11","Pilot 11: bigger feedback + video + socially anxious",7,"high",8
"SUPPRF99862",47,56,52,55,-16,94,71,91,"Pilot 11","Pilot 11: bigger feedback + video + socially anxious",7,"high",-36
"SUPPRF99862",48,45,67,45,-1,73,46,25,"Pilot 11","Pilot 11: bigger feedback + video + socially anxious",7,"high",20
