"Trial.Number","Random_ID","Mood","Anxiety","fdbk","SubjPE","PE","Certainty_Rating","m_hist","Prediction","pilot_nr","pilot_details"
1,"SUPPRF18834",77,72,67,2,-13,76,80,65,"Pilot 6","Pilot 6: feedback + text"
2,"SUPPRF18834",86,57,96,36,16,64,80,60,"Pilot 6","Pilot 6: feedback + text"
3,"SUPPRF18834",53,43,19,-35,-1,46,20,54,"Pilot 6","Pilot 6: feedback + text"
4,"SUPPRF18834",65,40,68,27,14,77,54,41,"Pilot 6","Pilot 6: feedback + text"
5,"SUPPRF18834",70,38,80,22,0,64,80,58,"Pilot 6","Pilot 6: feedback + text"
6,"SUPPRF18834",55,39,65,28,19,65,46,37,"Pilot 6","Pilot 6: feedback + text"
7,"SUPPRF18834",63,36,51,18,14,73,37,33,"Pilot 6","Pilot 6: feedback + text"
8,"SUPPRF18834",64,34,56,-5,-15,79,71,61,"Pilot 6","Pilot 6: feedback + text"
9,"SUPPRF18834",50,33,48,18,19,69,29,30,"Pilot 6","Pilot 6: feedback + text"
10,"SUPPRF18834",45,22,55,-11,1,74,54,66,"Pilot 6","Pilot 6: feedback + text"
11,"SUPPRF18834",50,23,78,18,15,71,63,60,"Pilot 6","Pilot 6: feedback + text"
12,"SUPPRF18834",56,32,37,17,17,74,20,20,"Pilot 6","Pilot 6: feedback + text"
13,"SUPPRF18834",46,17,33,-7,-13,40,46,40,"Pilot 6","Pilot 6: feedback + text"
14,"SUPPRF18834",60,22,70,10,-1,83,71,60,"Pilot 6","Pilot 6: feedback + text"
15,"SUPPRF18834",41,19,77,23,14,39,63,54,"Pilot 6","Pilot 6: feedback + text"
16,"SUPPRF18834",45,23,83,34,12,31,71,49,"Pilot 6","Pilot 6: feedback + text"
17,"SUPPRF18834",34,24,34,-15,-12,28,46,49,"Pilot 6","Pilot 6: feedback + text"
18,"SUPPRF18834",40,8,49,9,12,63,37,40,"Pilot 6","Pilot 6: feedback + text"
19,"SUPPRF18834",65,20,97,46,17,62,80,51,"Pilot 6","Pilot 6: feedback + text"
20,"SUPPRF18834",63,15,71,8,0,65,71,63,"Pilot 6","Pilot 6: feedback + text"
21,"SUPPRF18834",60,17,58,11,12,75,46,47,"Pilot 6","Pilot 6: feedback + text"
22,"SUPPRF18834",37,15,8,-18,-12,74,20,26,"Pilot 6","Pilot 6: feedback + text"
23,"SUPPRF18834",56,20,20,-6,0,64,20,26,"Pilot 6","Pilot 6: feedback + text"
24,"SUPPRF18834",43,15,28,-16,-1,35,29,44,"Pilot 6","Pilot 6: feedback + text"
25,"SUPPRF18834",51,22,68,6,-12,35,80,62,"Pilot 6","Pilot 6: feedback + text"
26,"SUPPRF18834",42,24,29,-7,0,45,29,36,"Pilot 6","Pilot 6: feedback + text"
27,"SUPPRF18834",57,30,41,-4,-13,68,54,45,"Pilot 6","Pilot 6: feedback + text"
28,"SUPPRF18834",43,24,50,10,-13,38,63,40,"Pilot 6","Pilot 6: feedback + text"
29,"SUPPRF18834",37,24,46,-7,0,64,46,53,"Pilot 6","Pilot 6: feedback + text"
30,"SUPPRF18834",58,35,37,6,0,30,37,31,"Pilot 6","Pilot 6: feedback + text"
31,"SUPPRF18834",36,32,22,-14,-15,61,37,36,"Pilot 6","Pilot 6: feedback + text"
32,"SUPPRF18834",43,39,38,-2,1,26,37,40,"Pilot 6","Pilot 6: feedback + text"
33,"SUPPRF18834",33,54,47,30,-16,84,63,17,"Pilot 6","Pilot 6: feedback + text"
34,"SUPPRF18834",23,30,16,-10,-13,53,29,26,"Pilot 6","Pilot 6: feedback + text"
35,"SUPPRF18834",25,30,66,42,12,35,54,24,"Pilot 6","Pilot 6: feedback + text"
36,"SUPPRF18834",35,35,84,47,13,77,71,37,"Pilot 6","Pilot 6: feedback + text"
37,"SUPPRF18834",48,30,46,32,17,84,29,14,"Pilot 6","Pilot 6: feedback + text"
38,"SUPPRF18834",53,38,15,-24,-14,59,29,39,"Pilot 6","Pilot 6: feedback + text"
39,"SUPPRF18834",33,62,45,1,-1,64,46,44,"Pilot 6","Pilot 6: feedback + text"
40,"SUPPRF18834",67,36,55,-4,-16,67,71,59,"Pilot 6","Pilot 6: feedback + text"
41,"SUPPRF18834",52,38,24,-9,-13,28,37,33,"Pilot 6","Pilot 6: feedback + text"
42,"SUPPRF18834",36,72,54,15,0,57,54,39,"Pilot 6","Pilot 6: feedback + text"
43,"SUPPRF18834",49,37,63,14,0,35,63,49,"Pilot 6","Pilot 6: feedback + text"
44,"SUPPRF18834",50,41,81,6,1,93,80,75,"Pilot 6","Pilot 6: feedback + text"
45,"SUPPRF18834",40,36,6,-10,-14,92,20,16,"Pilot 6","Pilot 6: feedback + text"
46,"SUPPRF18834",47,35,38,-8,-16,30,54,46,"Pilot 6","Pilot 6: feedback + text"
47,"SUPPRF18834",55,36,62,38,-1,30,63,24,"Pilot 6","Pilot 6: feedback + text"
48,"SUPPRF18834",44,38,35,19,15,92,20,16,"Pilot 6","Pilot 6: feedback + text"
1,"SUPPRF41746",40,47,55,22,1,33,54,33,"Pilot 6","Pilot 6: feedback + text"
2,"SUPPRF41746",47,48,46,16,17,49,29,30,"Pilot 6","Pilot 6: feedback + text"
3,"SUPPRF41746",40,48,24,-23,-13,52,37,47,"Pilot 6","Pilot 6: feedback + text"
4,"SUPPRF41746",47,48,84,10,13,58,71,74,"Pilot 6","Pilot 6: feedback + text"
5,"SUPPRF41746",45,50,67,-13,-13,62,80,80,"Pilot 6","Pilot 6: feedback + text"
6,"SUPPRF41746",42,46,8,-12,-12,58,20,20,"Pilot 6","Pilot 6: feedback + text"
7,"SUPPRF41746",45,45,48,18,19,51,29,30,"Pilot 6","Pilot 6: feedback + text"
8,"SUPPRF41746",46,48,50,-16,-13,70,63,66,"Pilot 6","Pilot 6: feedback + text"
9,"SUPPRF41746",46,45,77,27,14,77,63,50,"Pilot 6","Pilot 6: feedback + text"
10,"SUPPRF41746",49,41,58,14,12,66,46,44,"Pilot 6","Pilot 6: feedback + text"
11,"SUPPRF41746",49,44,54,-2,0,68,54,56,"Pilot 6","Pilot 6: feedback + text"
12,"SUPPRF41746",47,43,63,14,0,63,63,49,"Pilot 6","Pilot 6: feedback + text"
13,"SUPPRF41746",49,41,28,-2,-1,73,29,30,"Pilot 6","Pilot 6: feedback + text"
14,"SUPPRF41746",48,40,34,-5,-12,40,46,39,"Pilot 6","Pilot 6: feedback + text"
15,"SUPPRF41746",49,42,19,-3,-1,65,20,22,"Pilot 6","Pilot 6: feedback + text"
16,"SUPPRF41746",48,38,51,20,14,48,37,31,"Pilot 6","Pilot 6: feedback + text"
17,"SUPPRF41746",48,39,37,18,17,67,20,19,"Pilot 6","Pilot 6: feedback + text"
18,"SUPPRF41746",48,39,41,-9,-13,57,54,50,"Pilot 6","Pilot 6: feedback + text"
19,"SUPPRF41746",49,38,33,-24,-13,63,46,57,"Pilot 6","Pilot 6: feedback + text"
20,"SUPPRF41746",50,44,80,0,0,54,80,80,"Pilot 6","Pilot 6: feedback + text"
21,"SUPPRF41746",47,40,49,5,12,48,37,44,"Pilot 6","Pilot 6: feedback + text"
22,"SUPPRF41746",44,38,46,22,0,67,46,24,"Pilot 6","Pilot 6: feedback + text"
23,"SUPPRF41746",42,42,35,14,15,49,20,21,"Pilot 6","Pilot 6: feedback + text"
24,"SUPPRF41746",39,40,29,0,0,51,29,29,"Pilot 6","Pilot 6: feedback + text"
25,"SUPPRF41746",44,37,62,4,-1,58,63,58,"Pilot 6","Pilot 6: feedback + text"
26,"SUPPRF41746",45,38,38,6,1,49,37,32,"Pilot 6","Pilot 6: feedback + text"
27,"SUPPRF41746",48,38,37,1,0,66,37,36,"Pilot 6","Pilot 6: feedback + text"
28,"SUPPRF41746",46,38,20,2,0,59,20,18,"Pilot 6","Pilot 6: feedback + text"
29,"SUPPRF41746",50,35,70,-1,-1,70,71,71,"Pilot 6","Pilot 6: feedback + text"
30,"SUPPRF41746",48,40,45,-4,-1,65,46,49,"Pilot 6","Pilot 6: feedback + text"
31,"SUPPRF41746",50,37,71,0,0,68,71,71,"Pilot 6","Pilot 6: feedback + text"
32,"SUPPRF41746",43,36,56,-18,-15,75,71,74,"Pilot 6","Pilot 6: feedback + text"
33,"SUPPRF41746",46,37,68,12,14,70,54,56,"Pilot 6","Pilot 6: feedback + text"
34,"SUPPRF41746",49,40,68,11,-12,47,80,57,"Pilot 6","Pilot 6: feedback + text"
35,"SUPPRF41746",49,50,55,55,-16,0,71,0,"Pilot 6","Pilot 6: feedback + text"
36,"SUPPRF41746",48,41,96,28,16,50,80,68,"Pilot 6","Pilot 6: feedback + text"
37,"SUPPRF41746",45,37,15,-13,-14,49,29,28,"Pilot 6","Pilot 6: feedback + text"
38,"SUPPRF41746",40,37,38,-26,-16,56,54,64,"Pilot 6","Pilot 6: feedback + text"
39,"SUPPRF41746",44,34,83,11,12,54,71,72,"Pilot 6","Pilot 6: feedback + text"
40,"SUPPRF41746",45,40,97,18,17,67,80,79,"Pilot 6","Pilot 6: feedback + text"
41,"SUPPRF41746",41,37,66,-1,12,64,54,67,"Pilot 6","Pilot 6: feedback + text"
42,"SUPPRF41746",40,35,16,-12,-13,65,29,28,"Pilot 6","Pilot 6: feedback + text"
43,"SUPPRF41746",39,37,65,21,19,66,46,44,"Pilot 6","Pilot 6: feedback + text"
44,"SUPPRF41746",44,35,78,43,15,49,63,35,"Pilot 6","Pilot 6: feedback + text"
45,"SUPPRF41746",41,35,47,-14,-16,58,63,61,"Pilot 6","Pilot 6: feedback + text"
46,"SUPPRF41746",40,36,22,-12,-15,48,37,34,"Pilot 6","Pilot 6: feedback + text"
47,"SUPPRF41746",42,39,81,5,1,63,80,76,"Pilot 6","Pilot 6: feedback + text"
48,"SUPPRF41746",43,34,6,-11,-14,60,20,17,"Pilot 6","Pilot 6: feedback + text"
1,"SUPPRF51534",52,65,24,-9,-13,59,37,33,"Pilot 6","Pilot 6: feedback + text"
2,"SUPPRF51534",49,57,46,5,0,62,46,41,"Pilot 6","Pilot 6: feedback + text"
3,"SUPPRF51534",67,49,45,1,-1,64,46,44,"Pilot 6","Pilot 6: feedback + text"
4,"SUPPRF51534",73,37,70,4,-1,73,71,66,"Pilot 6","Pilot 6: feedback + text"
5,"SUPPRF51534",69,31,83,11,12,75,71,72,"Pilot 6","Pilot 6: feedback + text"
6,"SUPPRF51534",73,19,62,2,-1,75,63,60,"Pilot 6","Pilot 6: feedback + text"
7,"SUPPRF51534",46,51,50,-17,-13,73,63,67,"Pilot 6","Pilot 6: feedback + text"
8,"SUPPRF51534",48,55,28,4,-1,69,29,24,"Pilot 6","Pilot 6: feedback + text"
9,"SUPPRF51534",53,52,41,-8,-13,83,54,49,"Pilot 6","Pilot 6: feedback + text"
10,"SUPPRF51534",52,50,67,1,-13,69,80,66,"Pilot 6","Pilot 6: feedback + text"
11,"SUPPRF51534",42,57,55,-9,1,70,54,64,"Pilot 6","Pilot 6: feedback + text"
12,"SUPPRF51534",63,44,37,18,17,78,20,19,"Pilot 6","Pilot 6: feedback + text"
13,"SUPPRF51534",72,44,68,19,-12,70,80,49,"Pilot 6","Pilot 6: feedback + text"
14,"SUPPRF51534",22,63,15,-22,-14,65,29,37,"Pilot 6","Pilot 6: feedback + text"
15,"SUPPRF51534",55,52,48,24,19,61,29,24,"Pilot 6","Pilot 6: feedback + text"
16,"SUPPRF51534",51,53,8,-28,-12,17,20,36,"Pilot 6","Pilot 6: feedback + text"
17,"SUPPRF51534",66,47,54,8,0,51,54,46,"Pilot 6","Pilot 6: feedback + text"
18,"SUPPRF51534",59,40,38,-2,1,56,37,40,"Pilot 6","Pilot 6: feedback + text"
19,"SUPPRF51534",67,35,71,23,0,55,71,48,"Pilot 6","Pilot 6: feedback + text"
20,"SUPPRF51534",60,42,63,-7,0,68,63,70,"Pilot 6","Pilot 6: feedback + text"
21,"SUPPRF51534",67,31,35,11,15,64,20,24,"Pilot 6","Pilot 6: feedback + text"
22,"SUPPRF51534",38,59,6,-16,-14,65,20,22,"Pilot 6","Pilot 6: feedback + text"
23,"SUPPRF51534",68,35,78,13,15,61,63,65,"Pilot 6","Pilot 6: feedback + text"
24,"SUPPRF51534",54,30,65,10,19,56,46,55,"Pilot 6","Pilot 6: feedback + text"
25,"SUPPRF51534",67,33,20,-2,0,82,20,22,"Pilot 6","Pilot 6: feedback + text"
26,"SUPPRF51534",57,34,58,15,12,65,46,43,"Pilot 6","Pilot 6: feedback + text"
27,"SUPPRF51534",60,37,49,-1,12,71,37,50,"Pilot 6","Pilot 6: feedback + text"
28,"SUPPRF51534",65,32,84,28,13,71,71,56,"Pilot 6","Pilot 6: feedback + text"
29,"SUPPRF51534",72,22,46,14,17,83,29,32,"Pilot 6","Pilot 6: feedback + text"
30,"SUPPRF51534",71,34,80,40,0,72,80,40,"Pilot 6","Pilot 6: feedback + text"
31,"SUPPRF51534",74,31,29,-5,0,64,29,34,"Pilot 6","Pilot 6: feedback + text"
32,"SUPPRF51534",64,23,51,11,14,65,37,40,"Pilot 6","Pilot 6: feedback + text"
33,"SUPPRF51534",48,51,19,-1,-1,69,20,20,"Pilot 6","Pilot 6: feedback + text"
34,"SUPPRF51534",72,28,68,15,14,84,54,53,"Pilot 6","Pilot 6: feedback + text"
35,"SUPPRF51534",47,45,33,-11,-13,58,46,44,"Pilot 6","Pilot 6: feedback + text"
36,"SUPPRF51534",49,49,56,-12,-15,64,71,68,"Pilot 6","Pilot 6: feedback + text"
37,"SUPPRF51534",41,61,22,-21,-15,69,37,43,"Pilot 6","Pilot 6: feedback + text"
38,"SUPPRF51534",48,51,37,6,0,71,37,31,"Pilot 6","Pilot 6: feedback + text"
39,"SUPPRF51534",44,58,38,-16,-16,66,54,54,"Pilot 6","Pilot 6: feedback + text"
40,"SUPPRF51534",64,30,77,17,14,63,63,60,"Pilot 6","Pilot 6: feedback + text"
41,"SUPPRF51534",39,59,16,-14,-13,60,29,30,"Pilot 6","Pilot 6: feedback + text"
42,"SUPPRF51534",74,42,96,37,16,64,80,59,"Pilot 6","Pilot 6: feedback + text"
43,"SUPPRF51534",43,53,47,-14,-16,74,63,61,"Pilot 6","Pilot 6: feedback + text"
44,"SUPPRF51534",65,34,97,22,17,76,80,75,"Pilot 6","Pilot 6: feedback + text"
45,"SUPPRF51534",46,46,34,-8,-12,51,46,42,"Pilot 6","Pilot 6: feedback + text"
46,"SUPPRF51534",58,32,81,19,1,52,80,62,"Pilot 6","Pilot 6: feedback + text"
47,"SUPPRF51534",61,44,55,6,-16,40,71,49,"Pilot 6","Pilot 6: feedback + text"
48,"SUPPRF51534",59,35,66,13,12,64,54,53,"Pilot 6","Pilot 6: feedback + text"
1,"SUPPRF77371",51,41,22,-11,-15,48,37,33,"Pilot 6","Pilot 6: feedback + text"
2,"SUPPRF77371",72,45,80,-1,0,78,80,81,"Pilot 6","Pilot 6: feedback + text"
3,"SUPPRF77371",67,34,68,37,14,37,54,31,"Pilot 6","Pilot 6: feedback + text"
4,"SUPPRF77371",64,31,38,6,1,32,37,32,"Pilot 6","Pilot 6: feedback + text"
5,"SUPPRF77371",53,37,96,46,16,50,80,50,"Pilot 6","Pilot 6: feedback + text"
6,"SUPPRF77371",63,46,63,32,0,33,63,31,"Pilot 6","Pilot 6: feedback + text"
7,"SUPPRF77371",76,40,81,5,1,76,80,76,"Pilot 6","Pilot 6: feedback + text"
8,"SUPPRF77371",75,27,46,21,17,24,29,25,"Pilot 6","Pilot 6: feedback + text"
9,"SUPPRF77371",76,30,67,-7,-13,79,80,74,"Pilot 6","Pilot 6: feedback + text"
10,"SUPPRF77371",84,22,62,-6,-1,69,63,68,"Pilot 6","Pilot 6: feedback + text"
11,"SUPPRF77371",77,23,24,-24,-13,52,37,48,"Pilot 6","Pilot 6: feedback + text"
12,"SUPPRF77371",82,18,83,46,12,56,71,37,"Pilot 6","Pilot 6: feedback + text"
13,"SUPPRF77371",87,14,19,10,-1,6,20,9,"Pilot 6","Pilot 6: feedback + text"
14,"SUPPRF77371",84,14,55,7,1,44,54,48,"Pilot 6","Pilot 6: feedback + text"
15,"SUPPRF77371",89,11,16,5,-13,15,29,11,"Pilot 6","Pilot 6: feedback + text"
16,"SUPPRF77371",88,22,58,25,12,45,46,33,"Pilot 6","Pilot 6: feedback + text"
17,"SUPPRF77371",91,8,20,8,0,9,20,12,"Pilot 6","Pilot 6: feedback + text"
18,"SUPPRF77371",93,9,48,36,19,12,29,12,"Pilot 6","Pilot 6: feedback + text"
19,"SUPPRF77371",94,1,65,31,19,28,46,34,"Pilot 6","Pilot 6: feedback + text"
20,"SUPPRF77371",96,5,33,-7,-13,16,46,40,"Pilot 6","Pilot 6: feedback + text"
21,"SUPPRF77371",92,3,50,-3,-13,55,63,53,"Pilot 6","Pilot 6: feedback + text"
22,"SUPPRF77371",93,5,38,-18,-16,41,54,56,"Pilot 6","Pilot 6: feedback + text"
23,"SUPPRF77371",95,14,28,-29,-1,30,29,57,"Pilot 6","Pilot 6: feedback + text"
24,"SUPPRF77371",90,15,8,-8,-12,16,20,16,"Pilot 6","Pilot 6: feedback + text"
25,"SUPPRF77371",87,4,56,-6,-15,45,71,62,"Pilot 6","Pilot 6: feedback + text"
26,"SUPPRF77371",95,4,45,5,-1,38,46,40,"Pilot 6","Pilot 6: feedback + text"
27,"SUPPRF77371",86,11,47,-7,-16,52,63,54,"Pilot 6","Pilot 6: feedback + text"
28,"SUPPRF77371",73,15,34,-8,-12,27,46,42,"Pilot 6","Pilot 6: feedback + text"
29,"SUPPRF77371",80,17,54,10,0,50,54,44,"Pilot 6","Pilot 6: feedback + text"
30,"SUPPRF77371",82,8,37,16,17,18,20,21,"Pilot 6","Pilot 6: feedback + text"
31,"SUPPRF77371",84,14,68,-7,-12,37,80,75,"Pilot 6","Pilot 6: feedback + text"
32,"SUPPRF77371",90,5,29,3,0,15,29,26,"Pilot 6","Pilot 6: feedback + text"
33,"SUPPRF77371",82,7,15,-15,-14,13,29,30,"Pilot 6","Pilot 6: feedback + text"
34,"SUPPRF77371",75,10,78,58,15,48,63,20,"Pilot 6","Pilot 6: feedback + text"
35,"SUPPRF77371",91,7,41,14,-13,20,54,27,"Pilot 6","Pilot 6: feedback + text"
36,"SUPPRF77371",97,6,66,20,12,43,54,46,"Pilot 6","Pilot 6: feedback + text"
37,"SUPPRF77371",79,10,46,25,0,28,46,21,"Pilot 6","Pilot 6: feedback + text"
38,"SUPPRF77371",97,1,97,33,17,42,80,64,"Pilot 6","Pilot 6: feedback + text"
39,"SUPPRF77371",98,6,71,5,0,42,71,66,"Pilot 6","Pilot 6: feedback + text"
40,"SUPPRF77371",94,7,55,-17,-16,62,71,72,"Pilot 6","Pilot 6: feedback + text"
41,"SUPPRF77371",84,4,70,24,-1,46,71,46,"Pilot 6","Pilot 6: feedback + text"
42,"SUPPRF77371",87,8,84,30,13,53,71,54,"Pilot 6","Pilot 6: feedback + text"
43,"SUPPRF77371",92,4,37,12,0,25,37,25,"Pilot 6","Pilot 6: feedback + text"
44,"SUPPRF77371",96,3,49,21,12,34,37,28,"Pilot 6","Pilot 6: feedback + text"
45,"SUPPRF77371",97,6,35,11,15,53,20,24,"Pilot 6","Pilot 6: feedback + text"
46,"SUPPRF77371",98,2,77,37,14,62,63,40,"Pilot 6","Pilot 6: feedback + text"
47,"SUPPRF77371",96,2,51,22,14,48,37,29,"Pilot 6","Pilot 6: feedback + text"
48,"SUPPRF77371",93,9,6,-39,-14,45,20,45,"Pilot 6","Pilot 6: feedback + text"
1,"SUPPRF20648",54,31,51,13,14,89,37,38,"Pilot 6","Pilot 6: feedback + text"
2,"SUPPRF20648",49,35,55,-5,1,64,54,60,"Pilot 6","Pilot 6: feedback + text"
3,"SUPPRF20648",52,48,66,11,12,89,54,55,"Pilot 6","Pilot 6: feedback + text"
4,"SUPPRF20648",53,49,68,-12,-12,66,80,80,"Pilot 6","Pilot 6: feedback + text"
5,"SUPPRF20648",52,51,55,-10,-16,54,71,65,"Pilot 6","Pilot 6: feedback + text"
6,"SUPPRF20648",50,43,46,-24,0,53,46,70,"Pilot 6","Pilot 6: feedback + text"
7,"SUPPRF20648",55,50,83,27,12,53,71,56,"Pilot 6","Pilot 6: feedback + text"
8,"SUPPRF20648",53,44,28,5,-1,48,29,23,"Pilot 6","Pilot 6: feedback + text"
9,"SUPPRF20648",52,50,78,31,15,12,63,47,"Pilot 6","Pilot 6: feedback + text"
10,"SUPPRF20648",47,47,47,-16,-16,72,63,63,"Pilot 6","Pilot 6: feedback + text"
11,"SUPPRF20648",66,47,96,16,16,55,80,80,"Pilot 6","Pilot 6: feedback + text"
12,"SUPPRF20648",51,40,49,23,12,50,37,26,"Pilot 6","Pilot 6: feedback + text"
13,"SUPPRF20648",42,30,46,32,17,0,29,14,"Pilot 6","Pilot 6: feedback + text"
14,"SUPPRF20648",47,25,58,18,12,77,46,40,"Pilot 6","Pilot 6: feedback + text"
15,"SUPPRF20648",49,37,84,14,13,71,71,70,"Pilot 6","Pilot 6: feedback + text"
16,"SUPPRF20648",40,22,38,-12,-16,21,54,50,"Pilot 6","Pilot 6: feedback + text"
17,"SUPPRF20648",50,28,80,-4,0,85,80,84,"Pilot 6","Pilot 6: feedback + text"
18,"SUPPRF20648",41,24,48,10,19,11,29,38,"Pilot 6","Pilot 6: feedback + text"
19,"SUPPRF20648",50,31,56,0,-15,26,71,56,"Pilot 6","Pilot 6: feedback + text"
20,"SUPPRF20648",46,27,77,36,14,70,63,41,"Pilot 6","Pilot 6: feedback + text"
21,"SUPPRF20648",51,32,37,4,0,52,37,33,"Pilot 6","Pilot 6: feedback + text"
22,"SUPPRF20648",45,27,81,-4,1,90,80,85,"Pilot 6","Pilot 6: feedback + text"
23,"SUPPRF20648",49,27,35,21,15,74,20,14,"Pilot 6","Pilot 6: feedback + text"
24,"SUPPRF20648",41,25,24,-16,-13,69,37,40,"Pilot 6","Pilot 6: feedback + text"
25,"SUPPRF20648",86,21,97,54,17,26,80,43,"Pilot 6","Pilot 6: feedback + text"
26,"SUPPRF20648",48,28,29,1,0,72,29,28,"Pilot 6","Pilot 6: feedback + text"
27,"SUPPRF20648",51,33,22,-11,-15,70,37,33,"Pilot 6","Pilot 6: feedback + text"
28,"SUPPRF20648",51,28,34,-11,-12,90,46,45,"Pilot 6","Pilot 6: feedback + text"
29,"SUPPRF20648",74,27,19,4,-1,85,20,15,"Pilot 6","Pilot 6: feedback + text"
30,"SUPPRF20648",50,36,54,6,0,85,54,48,"Pilot 6","Pilot 6: feedback + text"
31,"SUPPRF20648",51,35,15,-11,-14,77,29,26,"Pilot 6","Pilot 6: feedback + text"
32,"SUPPRF20648",52,52,65,25,19,70,46,40,"Pilot 6","Pilot 6: feedback + text"
33,"SUPPRF20648",50,33,45,-9,-1,74,46,54,"Pilot 6","Pilot 6: feedback + text"
34,"SUPPRF20648",49,48,38,8,1,65,37,30,"Pilot 6","Pilot 6: feedback + text"
35,"SUPPRF20648",48,29,50,-10,-13,80,63,60,"Pilot 6","Pilot 6: feedback + text"
36,"SUPPRF20648",50,34,63,-1,0,71,63,64,"Pilot 6","Pilot 6: feedback + text"
37,"SUPPRF20648",50,24,62,-6,-1,90,63,68,"Pilot 6","Pilot 6: feedback + text"
38,"SUPPRF20648",48,31,37,20,17,76,20,17,"Pilot 6","Pilot 6: feedback + text"
39,"SUPPRF20648",49,35,33,-9,-13,80,46,42,"Pilot 6","Pilot 6: feedback + text"
40,"SUPPRF20648",50,34,41,-9,-13,70,54,50,"Pilot 6","Pilot 6: feedback + text"
41,"SUPPRF20648",51,30,67,-21,-13,85,80,88,"Pilot 6","Pilot 6: feedback + text"
42,"SUPPRF20648",49,27,68,11,14,90,54,57,"Pilot 6","Pilot 6: feedback + text"
43,"SUPPRF20648",51,30,16,-28,-13,0,29,44,"Pilot 6","Pilot 6: feedback + text"
44,"SUPPRF20648",50,28,6,-18,-14,65,20,24,"Pilot 6","Pilot 6: feedback + text"
45,"SUPPRF20648",79,32,70,50,-1,1,71,20,"Pilot 6","Pilot 6: feedback + text"
46,"SUPPRF20648",47,19,8,-2,-12,94,20,10,"Pilot 6","Pilot 6: feedback + text"
47,"SUPPRF20648",50,33,20,13,0,70,20,7,"Pilot 6","Pilot 6: feedback + text"
48,"SUPPRF20648",49,28,71,-6,0,80,71,77,"Pilot 6","Pilot 6: feedback + text"
1,"SUPPRF71510",50,0,62,-3,-1,50,63,65,"Pilot 6","Pilot 6: feedback + text"
2,"SUPPRF71510",49,0,6,-24,-14,70,20,30,"Pilot 6","Pilot 6: feedback + text"
3,"SUPPRF71510",51,0,66,11,12,30,54,55,"Pilot 6","Pilot 6: feedback + text"
4,"SUPPRF71510",49,0,45,0,-1,84,46,45,"Pilot 6","Pilot 6: feedback + text"
5,"SUPPRF71510",50,0,80,10,0,83,80,70,"Pilot 6","Pilot 6: feedback + text"
6,"SUPPRF71510",50,0,51,-4,14,81,37,55,"Pilot 6","Pilot 6: feedback + text"
7,"SUPPRF71510",50,0,84,14,13,96,71,70,"Pilot 6","Pilot 6: feedback + text"
8,"SUPPRF71510",52,0,37,30,17,92,20,7,"Pilot 6","Pilot 6: feedback + text"
9,"SUPPRF71510",50,0,83,3,12,96,71,80,"Pilot 6","Pilot 6: feedback + text"
10,"SUPPRF71510",51,0,54,-16,0,91,54,70,"Pilot 6","Pilot 6: feedback + text"
11,"SUPPRF71510",51,0,68,3,14,77,54,65,"Pilot 6","Pilot 6: feedback + text"
12,"SUPPRF71510",50,0,46,12,17,67,29,34,"Pilot 6","Pilot 6: feedback + text"
13,"SUPPRF71510",49,0,8,-8,-12,92,20,16,"Pilot 6","Pilot 6: feedback + text"
14,"SUPPRF71510",51,0,47,-23,-16,87,63,70,"Pilot 6","Pilot 6: feedback + text"
15,"SUPPRF71510",49,0,67,17,-13,14,80,50,"Pilot 6","Pilot 6: feedback + text"
16,"SUPPRF71510",50,0,50,-18,-13,97,63,68,"Pilot 6","Pilot 6: feedback + text"
17,"SUPPRF71510",50,0,58,15,12,96,46,43,"Pilot 6","Pilot 6: feedback + text"
18,"SUPPRF71510",51,0,70,-2,-1,94,71,72,"Pilot 6","Pilot 6: feedback + text"
19,"SUPPRF71510",50,0,97,62,17,79,80,35,"Pilot 6","Pilot 6: feedback + text"
20,"SUPPRF71510",51,0,34,-9,-12,94,46,43,"Pilot 6","Pilot 6: feedback + text"
21,"SUPPRF71510",50,0,78,44,15,92,63,34,"Pilot 6","Pilot 6: feedback + text"
22,"SUPPRF71510",50,0,46,-4,0,85,46,50,"Pilot 6","Pilot 6: feedback + text"
23,"SUPPRF71510",51,0,65,20,19,85,46,45,"Pilot 6","Pilot 6: feedback + text"
24,"SUPPRF71510",51,0,63,4,0,71,63,59,"Pilot 6","Pilot 6: feedback + text"
25,"SUPPRF71510",51,0,22,-18,-15,90,37,40,"Pilot 6","Pilot 6: feedback + text"
26,"SUPPRF71510",51,0,38,11,-16,83,54,27,"Pilot 6","Pilot 6: feedback + text"
27,"SUPPRF71510",50,0,38,-29,1,86,37,67,"Pilot 6","Pilot 6: feedback + text"
28,"SUPPRF71510",51,0,48,9,19,82,29,39,"Pilot 6","Pilot 6: feedback + text"
29,"SUPPRF71510",50,0,41,5,-13,75,54,36,"Pilot 6","Pilot 6: feedback + text"
30,"SUPPRF71510",50,0,16,-48,-13,89,29,64,"Pilot 6","Pilot 6: feedback + text"
31,"SUPPRF71510",52,0,55,-18,-16,93,71,73,"Pilot 6","Pilot 6: feedback + text"
32,"SUPPRF71510",49,0,37,-37,0,96,37,74,"Pilot 6","Pilot 6: feedback + text"
33,"SUPPRF71510",51,0,96,63,16,83,80,33,"Pilot 6","Pilot 6: feedback + text"
34,"SUPPRF71510",51,0,49,11,12,89,37,38,"Pilot 6","Pilot 6: feedback + text"
35,"SUPPRF71510",51,0,56,17,-15,81,71,39,"Pilot 6","Pilot 6: feedback + text"
36,"SUPPRF71510",52,0,28,-37,-1,91,29,65,"Pilot 6","Pilot 6: feedback + text"
37,"SUPPRF71510",51,0,55,17,1,87,54,38,"Pilot 6","Pilot 6: feedback + text"
38,"SUPPRF71510",50,0,81,14,1,95,80,67,"Pilot 6","Pilot 6: feedback + text"
39,"SUPPRF71510",51,0,19,-40,-1,88,20,59,"Pilot 6","Pilot 6: feedback + text"
40,"SUPPRF71510",50,0,29,-5,0,72,29,34,"Pilot 6","Pilot 6: feedback + text"
41,"SUPPRF71510",49,0,24,-16,-13,90,37,40,"Pilot 6","Pilot 6: feedback + text"
42,"SUPPRF71510",51,0,33,-38,-13,94,46,71,"Pilot 6","Pilot 6: feedback + text"
43,"SUPPRF71510",50,0,15,-25,-14,79,29,40,"Pilot 6","Pilot 6: feedback + text"
44,"SUPPRF71510",50,0,71,3,0,94,71,68,"Pilot 6","Pilot 6: feedback + text"
45,"SUPPRF71510",51,0,77,35,14,83,63,42,"Pilot 6","Pilot 6: feedback + text"
46,"SUPPRF71510",50,0,35,-18,15,85,20,53,"Pilot 6","Pilot 6: feedback + text"
47,"SUPPRF71510",50,0,68,26,-12,85,80,42,"Pilot 6","Pilot 6: feedback + text"
48,"SUPPRF71510",52,0,20,-22,0,86,20,42,"Pilot 6","Pilot 6: feedback + text"
1,"SUPPRF43420",64,37,65,34,19,74,46,31,"Pilot 6","Pilot 6: feedback + text"
2,"SUPPRF43420",64,40,48,15,19,60,29,33,"Pilot 6","Pilot 6: feedback + text"
3,"SUPPRF43420",62,43,66,11,12,48,54,55,"Pilot 6","Pilot 6: feedback + text"
4,"SUPPRF43420",56,45,15,-25,-14,68,29,40,"Pilot 6","Pilot 6: feedback + text"
5,"SUPPRF43420",63,41,78,27,15,39,63,51,"Pilot 6","Pilot 6: feedback + text"
6,"SUPPRF43420",57,43,16,-16,-13,58,29,32,"Pilot 6","Pilot 6: feedback + text"
7,"SUPPRF43420",55,44,41,-15,-13,59,54,56,"Pilot 6","Pilot 6: feedback + text"
8,"SUPPRF43420",60,35,68,13,14,40,54,55,"Pilot 6","Pilot 6: feedback + text"
9,"SUPPRF43420",57,41,55,-11,-16,52,71,66,"Pilot 6","Pilot 6: feedback + text"
10,"SUPPRF43420",76,34,97,26,17,49,80,71,"Pilot 6","Pilot 6: feedback + text"
11,"SUPPRF43420",62,32,28,-4,-1,44,29,32,"Pilot 6","Pilot 6: feedback + text"
12,"SUPPRF43420",57,42,24,-13,-13,46,37,37,"Pilot 6","Pilot 6: feedback + text"
13,"SUPPRF43420",66,34,71,22,0,37,71,49,"Pilot 6","Pilot 6: feedback + text"
14,"SUPPRF43420",64,36,55,-3,1,65,54,58,"Pilot 6","Pilot 6: feedback + text"
15,"SUPPRF43420",63,37,96,16,16,67,80,80,"Pilot 6","Pilot 6: feedback + text"
16,"SUPPRF43420",64,33,77,47,14,61,63,30,"Pilot 6","Pilot 6: feedback + text"
17,"SUPPRF43420",58,40,50,-13,-13,43,63,63,"Pilot 6","Pilot 6: feedback + text"
18,"SUPPRF43420",55,41,54,2,0,43,54,52,"Pilot 6","Pilot 6: feedback + text"
19,"SUPPRF43420",60,37,51,2,14,28,37,49,"Pilot 6","Pilot 6: feedback + text"
20,"SUPPRF43420",59,36,49,15,12,54,37,34,"Pilot 6","Pilot 6: feedback + text"
21,"SUPPRF43420",63,38,35,14,15,60,20,21,"Pilot 6","Pilot 6: feedback + text"
22,"SUPPRF43420",63,37,22,-2,-15,64,37,24,"Pilot 6","Pilot 6: feedback + text"
23,"SUPPRF43420",58,39,56,-12,-15,55,71,68,"Pilot 6","Pilot 6: feedback + text"
24,"SUPPRF43420",60,41,19,4,-1,59,20,15,"Pilot 6","Pilot 6: feedback + text"
25,"SUPPRF43420",61,39,83,13,12,59,71,70,"Pilot 6","Pilot 6: feedback + text"
26,"SUPPRF43420",61,39,34,-9,-12,36,46,43,"Pilot 6","Pilot 6: feedback + text"
27,"SUPPRF43420",61,36,80,-2,0,62,80,82,"Pilot 6","Pilot 6: feedback + text"
28,"SUPPRF43420",58,42,47,-14,-16,53,63,61,"Pilot 6","Pilot 6: feedback + text"
29,"SUPPRF43420",57,41,8,-6,-12,64,20,14,"Pilot 6","Pilot 6: feedback + text"
30,"SUPPRF43420",58,40,46,13,17,56,29,33,"Pilot 6","Pilot 6: feedback + text"
31,"SUPPRF43420",60,33,81,-3,1,63,80,84,"Pilot 6","Pilot 6: feedback + text"
32,"SUPPRF43420",62,35,62,5,-1,37,63,57,"Pilot 6","Pilot 6: feedback + text"
33,"SUPPRF43420",55,40,67,-12,-13,67,80,79,"Pilot 6","Pilot 6: feedback + text"
34,"SUPPRF43420",62,35,46,4,0,31,46,42,"Pilot 6","Pilot 6: feedback + text"
35,"SUPPRF43420",60,32,37,23,17,68,20,14,"Pilot 6","Pilot 6: feedback + text"
36,"SUPPRF43420",63,32,33,-10,-13,25,46,43,"Pilot 6","Pilot 6: feedback + text"
37,"SUPPRF43420",65,33,63,5,0,53,63,58,"Pilot 6","Pilot 6: feedback + text"
38,"SUPPRF43420",63,35,68,-8,-12,66,80,76,"Pilot 6","Pilot 6: feedback + text"
39,"SUPPRF43420",63,36,37,0,0,59,37,37,"Pilot 6","Pilot 6: feedback + text"
40,"SUPPRF43420",64,36,84,17,13,56,71,67,"Pilot 6","Pilot 6: feedback + text"
41,"SUPPRF43420",65,30,38,-2,1,67,37,40,"Pilot 6","Pilot 6: feedback + text"
42,"SUPPRF43420",65,35,45,7,-1,67,46,38,"Pilot 6","Pilot 6: feedback + text"
43,"SUPPRF43420",65,33,58,15,12,65,46,43,"Pilot 6","Pilot 6: feedback + text"
44,"SUPPRF43420",62,33,6,-7,-14,73,20,13,"Pilot 6","Pilot 6: feedback + text"
45,"SUPPRF43420",56,38,38,-17,-16,59,54,55,"Pilot 6","Pilot 6: feedback + text"
46,"SUPPRF43420",61,39,20,6,0,66,20,14,"Pilot 6","Pilot 6: feedback + text"
47,"SUPPRF43420",64,34,29,6,0,63,29,23,"Pilot 6","Pilot 6: feedback + text"
48,"SUPPRF43420",65,32,70,0,-1,61,71,70,"Pilot 6","Pilot 6: feedback + text"
1,"SUPPRF54374",99,0,28,7,-1,69,29,21,"Pilot 6","Pilot 6: feedback + text"
2,"SUPPRF54374",99,1,29,2,0,89,29,27,"Pilot 6","Pilot 6: feedback + text"
3,"SUPPRF54374",99,1,41,-14,-13,74,54,55,"Pilot 6","Pilot 6: feedback + text"
4,"SUPPRF54374",99,1,51,10,14,74,37,41,"Pilot 6","Pilot 6: feedback + text"
5,"SUPPRF54374",99,0,46,-11,0,81,46,57,"Pilot 6","Pilot 6: feedback + text"
6,"SUPPRF54374",99,0,56,-9,-15,82,71,65,"Pilot 6","Pilot 6: feedback + text"
7,"SUPPRF54374",100,2,47,-20,-16,84,63,67,"Pilot 6","Pilot 6: feedback + text"
8,"SUPPRF54374",100,1,54,1,0,78,54,53,"Pilot 6","Pilot 6: feedback + text"
9,"SUPPRF54374",100,1,46,18,17,83,29,28,"Pilot 6","Pilot 6: feedback + text"
10,"SUPPRF54374",85,1,24,-2,-13,81,37,26,"Pilot 6","Pilot 6: feedback + text"
11,"SUPPRF54374",82,1,71,-2,0,72,71,73,"Pilot 6","Pilot 6: feedback + text"
12,"SUPPRF54374",85,3,22,-2,-15,71,37,24,"Pilot 6","Pilot 6: feedback + text"
13,"SUPPRF54374",75,7,8,-43,-12,63,20,51,"Pilot 6","Pilot 6: feedback + text"
14,"SUPPRF54374",73,8,62,-10,-1,88,63,72,"Pilot 6","Pilot 6: feedback + text"
15,"SUPPRF54374",83,7,33,6,-13,76,46,27,"Pilot 6","Pilot 6: feedback + text"
16,"SUPPRF54374",79,7,34,23,-12,77,46,11,"Pilot 6","Pilot 6: feedback + text"
17,"SUPPRF54374",87,8,70,47,-1,60,71,23,"Pilot 6","Pilot 6: feedback + text"
18,"SUPPRF54374",88,12,45,-1,-1,73,46,46,"Pilot 6","Pilot 6: feedback + text"
19,"SUPPRF54374",83,9,6,-8,-14,89,20,14,"Pilot 6","Pilot 6: feedback + text"
20,"SUPPRF54374",82,8,16,3,-13,81,29,13,"Pilot 6","Pilot 6: feedback + text"
21,"SUPPRF54374",91,10,37,29,17,81,20,8,"Pilot 6","Pilot 6: feedback + text"
22,"SUPPRF54374",87,13,63,4,0,59,63,59,"Pilot 6","Pilot 6: feedback + text"
23,"SUPPRF54374",82,21,66,16,12,50,54,50,"Pilot 6","Pilot 6: feedback + text"
24,"SUPPRF54374",81,10,35,21,15,81,20,14,"Pilot 6","Pilot 6: feedback + text"
25,"SUPPRF54374",81,9,55,-2,1,80,54,57,"Pilot 6","Pilot 6: feedback + text"
26,"SUPPRF54374",89,4,97,23,17,75,80,74,"Pilot 6","Pilot 6: feedback + text"
27,"SUPPRF54374",86,8,78,10,15,68,63,68,"Pilot 6","Pilot 6: feedback + text"
28,"SUPPRF54374",82,12,48,27,19,73,29,21,"Pilot 6","Pilot 6: feedback + text"
29,"SUPPRF54374",76,10,49,29,12,81,37,20,"Pilot 6","Pilot 6: feedback + text"
30,"SUPPRF54374",84,12,58,32,12,77,46,26,"Pilot 6","Pilot 6: feedback + text"
31,"SUPPRF54374",77,13,50,-35,-13,73,63,85,"Pilot 6","Pilot 6: feedback + text"
32,"SUPPRF54374",79,8,15,-2,-14,66,29,17,"Pilot 6","Pilot 6: feedback + text"
33,"SUPPRF54374",81,83,20,7,0,90,20,13,"Pilot 6","Pilot 6: feedback + text"
34,"SUPPRF54374",72,28,19,11,-1,81,20,8,"Pilot 6","Pilot 6: feedback + text"
35,"SUPPRF54374",79,17,65,24,19,74,46,41,"Pilot 6","Pilot 6: feedback + text"
36,"SUPPRF54374",83,17,84,32,13,78,71,52,"Pilot 6","Pilot 6: feedback + text"
37,"SUPPRF54374",80,12,77,6,14,68,63,71,"Pilot 6","Pilot 6: feedback + text"
38,"SUPPRF54374",84,8,37,2,0,79,37,35,"Pilot 6","Pilot 6: feedback + text"
39,"SUPPRF54374",91,8,38,-16,-16,82,54,54,"Pilot 6","Pilot 6: feedback + text"
40,"SUPPRF54374",86,9,83,13,12,87,71,70,"Pilot 6","Pilot 6: feedback + text"
41,"SUPPRF54374",86,9,38,-3,1,82,37,41,"Pilot 6","Pilot 6: feedback + text"
42,"SUPPRF54374",85,12,81,3,1,81,80,78,"Pilot 6","Pilot 6: feedback + text"
43,"SUPPRF54374",92,9,68,-2,-12,78,80,70,"Pilot 6","Pilot 6: feedback + text"
44,"SUPPRF54374",82,11,67,-9,-13,85,80,76,"Pilot 6","Pilot 6: feedback + text"
45,"SUPPRF54374",81,13,55,-7,-16,71,71,62,"Pilot 6","Pilot 6: feedback + text"
46,"SUPPRF54374",84,12,80,21,0,66,80,59,"Pilot 6","Pilot 6: feedback + text"
47,"SUPPRF54374",86,11,68,15,14,72,54,53,"Pilot 6","Pilot 6: feedback + text"
48,"SUPPRF54374",79,16,96,29,16,81,80,67,"Pilot 6","Pilot 6: feedback + text"
1,"SUPPRF62013",88,4,45,-2,-1,76,46,47,"Pilot 6","Pilot 6: feedback + text"
2,"SUPPRF62013",86,9,55,-30,1,7,54,85,"Pilot 6","Pilot 6: feedback + text"
3,"SUPPRF62013",82,16,20,-2,0,89,20,22,"Pilot 6","Pilot 6: feedback + text"
4,"SUPPRF62013",76,14,58,27,12,98,46,31,"Pilot 6","Pilot 6: feedback + text"
5,"SUPPRF62013",80,3,19,-1,-1,57,20,20,"Pilot 6","Pilot 6: feedback + text"
6,"SUPPRF62013",56,18,37,35,17,97,20,2,"Pilot 6","Pilot 6: feedback + text"
7,"SUPPRF62013",78,12,54,-26,0,45,54,80,"Pilot 6","Pilot 6: feedback + text"
8,"SUPPRF62013",81,22,6,-29,-14,70,20,35,"Pilot 6","Pilot 6: feedback + text"
9,"SUPPRF62013",93,10,35,9,15,67,20,26,"Pilot 6","Pilot 6: feedback + text"
10,"SUPPRF62013",79,3,38,-37,-16,60,54,75,"Pilot 6","Pilot 6: feedback + text"
11,"SUPPRF62013",85,4,55,25,-16,40,71,30,"Pilot 6","Pilot 6: feedback + text"
12,"SUPPRF62013",77,15,24,5,-13,30,37,19,"Pilot 6","Pilot 6: feedback + text"
13,"SUPPRF62013",92,24,81,71,1,38,80,10,"Pilot 6","Pilot 6: feedback + text"
14,"SUPPRF62013",81,10,46,10,0,57,46,36,"Pilot 6","Pilot 6: feedback + text"
15,"SUPPRF62013",75,0,68,28,14,30,54,40,"Pilot 6","Pilot 6: feedback + text"
16,"SUPPRF62013",77,14,97,84,17,70,80,13,"Pilot 6","Pilot 6: feedback + text"
17,"SUPPRF62013",67,26,8,-17,-12,75,20,25,"Pilot 6","Pilot 6: feedback + text"
18,"SUPPRF62013",66,17,63,-4,0,40,63,67,"Pilot 6","Pilot 6: feedback + text"
19,"SUPPRF62013",92,19,56,16,-15,80,71,40,"Pilot 6","Pilot 6: feedback + text"
20,"SUPPRF62013",78,15,16,-14,-13,55,29,30,"Pilot 6","Pilot 6: feedback + text"
21,"SUPPRF62013",76,19,28,13,-1,32,29,15,"Pilot 6","Pilot 6: feedback + text"
22,"SUPPRF62013",80,9,47,12,-16,63,63,35,"Pilot 6","Pilot 6: feedback + text"
23,"SUPPRF62013",88,1,68,55,-12,32,80,13,"Pilot 6","Pilot 6: feedback + text"
24,"SUPPRF62013",78,1,51,19,14,25,37,32,"Pilot 6","Pilot 6: feedback + text"
25,"SUPPRF62013",91,15,48,6,19,56,29,42,"Pilot 6","Pilot 6: feedback + text"
26,"SUPPRF62013",29,71,77,75,14,75,63,2,"Pilot 6","Pilot 6: feedback + text"
27,"SUPPRF62013",73,11,41,-29,-13,38,54,70,"Pilot 6","Pilot 6: feedback + text"
28,"SUPPRF62013",82,2,46,-3,17,64,29,49,"Pilot 6","Pilot 6: feedback + text"
29,"SUPPRF62013",80,14,50,40,-13,33,63,10,"Pilot 6","Pilot 6: feedback + text"
30,"SUPPRF62013",83,8,29,-7,0,50,29,36,"Pilot 6","Pilot 6: feedback + text"
31,"SUPPRF62013",86,0,84,33,13,21,71,51,"Pilot 6","Pilot 6: feedback + text"
32,"SUPPRF62013",85,10,33,-7,-13,81,46,40,"Pilot 6","Pilot 6: feedback + text"
33,"SUPPRF62013",73,10,22,-53,-15,38,37,75,"Pilot 6","Pilot 6: feedback + text"
34,"SUPPRF62013",86,0,70,48,-1,78,71,22,"Pilot 6","Pilot 6: feedback + text"
35,"SUPPRF62013",93,6,96,61,16,64,80,35,"Pilot 6","Pilot 6: feedback + text"
36,"SUPPRF62013",68,6,34,12,-12,78,46,22,"Pilot 6","Pilot 6: feedback + text"
37,"SUPPRF62013",81,5,37,9,0,86,37,28,"Pilot 6","Pilot 6: feedback + text"
38,"SUPPRF62013",69,7,15,-50,-14,28,29,65,"Pilot 6","Pilot 6: feedback + text"
39,"SUPPRF62013",70,6,83,9,12,56,71,74,"Pilot 6","Pilot 6: feedback + text"
40,"SUPPRF62013",74,6,65,25,19,53,46,40,"Pilot 6","Pilot 6: feedback + text"
41,"SUPPRF62013",73,9,67,0,-13,87,80,67,"Pilot 6","Pilot 6: feedback + text"
42,"SUPPRF62013",80,2,62,20,-1,34,63,42,"Pilot 6","Pilot 6: feedback + text"
43,"SUPPRF62013",59,17,66,-9,12,22,54,75,"Pilot 6","Pilot 6: feedback + text"
44,"SUPPRF62013",73,14,71,-14,0,67,71,85,"Pilot 6","Pilot 6: feedback + text"
45,"SUPPRF62013",83,3,80,-10,0,24,80,90,"Pilot 6","Pilot 6: feedback + text"
46,"SUPPRF62013",37,67,49,37,12,4,37,12,"Pilot 6","Pilot 6: feedback + text"
47,"SUPPRF62013",69,30,38,-22,1,37,37,60,"Pilot 6","Pilot 6: feedback + text"
48,"SUPPRF62013",76,5,78,34,15,64,63,44,"Pilot 6","Pilot 6: feedback + text"
1,"SUPPRF96180",79,36,58,21,12,77,46,37,"Pilot 6","Pilot 6: feedback + text"
2,"SUPPRF96180",87,24,80,9,0,82,80,71,"Pilot 6","Pilot 6: feedback + text"
3,"SUPPRF96180",78,31,38,-7,1,88,37,45,"Pilot 6","Pilot 6: feedback + text"
4,"SUPPRF96180",81,26,54,14,0,89,54,40,"Pilot 6","Pilot 6: feedback + text"
5,"SUPPRF96180",63,51,15,-25,-14,71,29,40,"Pilot 6","Pilot 6: feedback + text"
6,"SUPPRF96180",73,36,51,11,14,70,37,40,"Pilot 6","Pilot 6: feedback + text"
7,"SUPPRF96180",71,32,37,22,17,53,20,15,"Pilot 6","Pilot 6: feedback + text"
8,"SUPPRF96180",71,19,97,7,17,93,80,90,"Pilot 6","Pilot 6: feedback + text"
9,"SUPPRF96180",74,17,48,18,19,30,29,30,"Pilot 6","Pilot 6: feedback + text"
10,"SUPPRF96180",76,42,8,-2,-12,60,20,10,"Pilot 6","Pilot 6: feedback + text"
11,"SUPPRF96180",83,28,20,-5,0,70,20,25,"Pilot 6","Pilot 6: feedback + text"
12,"SUPPRF96180",83,35,41,-19,-13,65,54,60,"Pilot 6","Pilot 6: feedback + text"
13,"SUPPRF96180",57,49,67,-18,-13,80,80,85,"Pilot 6","Pilot 6: feedback + text"
14,"SUPPRF96180",59,54,28,-17,-1,42,29,45,"Pilot 6","Pilot 6: feedback + text"
15,"SUPPRF96180",77,32,81,-4,1,80,80,85,"Pilot 6","Pilot 6: feedback + text"
16,"SUPPRF96180",76,21,77,7,14,70,63,70,"Pilot 6","Pilot 6: feedback + text"
17,"SUPPRF96180",68,34,56,-14,-15,85,71,70,"Pilot 6","Pilot 6: feedback + text"
18,"SUPPRF96180",82,21,22,-3,-15,65,37,25,"Pilot 6","Pilot 6: feedback + text"
19,"SUPPRF96180",72,20,6,-24,-14,20,20,30,"Pilot 6","Pilot 6: feedback + text"
20,"SUPPRF96180",82,13,46,-9,0,40,46,55,"Pilot 6","Pilot 6: feedback + text"
21,"SUPPRF96180",78,15,65,25,19,75,46,40,"Pilot 6","Pilot 6: feedback + text"
22,"SUPPRF96180",83,21,83,13,12,60,71,70,"Pilot 6","Pilot 6: feedback + text"
23,"SUPPRF96180",86,12,49,14,12,40,37,35,"Pilot 6","Pilot 6: feedback + text"
24,"SUPPRF96180",86,5,34,-6,-12,10,46,40,"Pilot 6","Pilot 6: feedback + text"
25,"SUPPRF96180",92,13,70,0,-1,80,71,70,"Pilot 6","Pilot 6: feedback + text"
26,"SUPPRF96180",74,28,47,-18,-16,90,63,65,"Pilot 6","Pilot 6: feedback + text"
27,"SUPPRF96180",83,18,37,-13,0,30,37,50,"Pilot 6","Pilot 6: feedback + text"
28,"SUPPRF96180",84,9,50,-15,-13,35,63,65,"Pilot 6","Pilot 6: feedback + text"
29,"SUPPRF96180",82,19,62,22,-1,50,63,40,"Pilot 6","Pilot 6: feedback + text"
30,"SUPPRF96180",95,8,35,10,15,80,20,25,"Pilot 6","Pilot 6: feedback + text"
31,"SUPPRF96180",79,19,71,6,0,30,71,65,"Pilot 6","Pilot 6: feedback + text"
32,"SUPPRF96180",91,20,46,-9,17,10,29,55,"Pilot 6","Pilot 6: feedback + text"
33,"SUPPRF96180",91,10,55,5,1,75,54,50,"Pilot 6","Pilot 6: feedback + text"
34,"SUPPRF96180",72,28,55,-10,-16,30,71,65,"Pilot 6","Pilot 6: feedback + text"
35,"SUPPRF96180",82,24,16,-14,-13,80,29,30,"Pilot 6","Pilot 6: feedback + text"
36,"SUPPRF96180",93,14,96,36,16,40,80,60,"Pilot 6","Pilot 6: feedback + text"
37,"SUPPRF96180",76,24,78,23,15,5,63,55,"Pilot 6","Pilot 6: feedback + text"
38,"SUPPRF96180",66,30,38,-12,-16,70,54,50,"Pilot 6","Pilot 6: feedback + text"
39,"SUPPRF96180",85,20,33,-12,-13,40,46,45,"Pilot 6","Pilot 6: feedback + text"
40,"SUPPRF96180",94,11,84,14,13,75,71,70,"Pilot 6","Pilot 6: feedback + text"
41,"SUPPRF96180",87,31,68,28,14,15,54,40,"Pilot 6","Pilot 6: feedback + text"
42,"SUPPRF96180",76,37,63,23,0,80,63,40,"Pilot 6","Pilot 6: feedback + text"
43,"SUPPRF96180",96,19,66,16,12,60,54,50,"Pilot 6","Pilot 6: feedback + text"
44,"SUPPRF96180",87,24,45,5,-1,20,46,40,"Pilot 6","Pilot 6: feedback + text"
45,"SUPPRF96180",73,41,29,-31,0,10,29,60,"Pilot 6","Pilot 6: feedback + text"
46,"SUPPRF96180",54,42,68,-12,-12,90,80,80,"Pilot 6","Pilot 6: feedback + text"
47,"SUPPRF96180",66,34,19,-6,-1,70,20,25,"Pilot 6","Pilot 6: feedback + text"
48,"SUPPRF96180",42,71,24,-26,-13,10,37,50,"Pilot 6","Pilot 6: feedback + text"
1,"SUPPRF30203",52,51,22,-11,-15,66,37,33,"Pilot 6","Pilot 6: feedback + text"
2,"SUPPRF30203",47,50,16,-28,-13,40,29,44,"Pilot 6","Pilot 6: feedback + text"
3,"SUPPRF30203",50,47,28,6,-1,53,29,22,"Pilot 6","Pilot 6: feedback + text"
4,"SUPPRF30203",35,38,6,-30,-14,40,20,36,"Pilot 6","Pilot 6: feedback + text"
5,"SUPPRF30203",45,49,46,30,17,28,29,16,"Pilot 6","Pilot 6: feedback + text"
6,"SUPPRF30203",43,49,71,2,0,59,71,69,"Pilot 6","Pilot 6: feedback + text"
7,"SUPPRF30203",49,51,83,21,12,70,71,62,"Pilot 6","Pilot 6: feedback + text"
8,"SUPPRF30203",47,47,55,14,1,41,54,41,"Pilot 6","Pilot 6: feedback + text"
9,"SUPPRF30203",48,48,45,-13,-1,53,46,58,"Pilot 6","Pilot 6: feedback + text"
10,"SUPPRF30203",60,52,81,28,1,64,80,53,"Pilot 6","Pilot 6: feedback + text"
11,"SUPPRF30203",48,33,29,-36,0,49,29,65,"Pilot 6","Pilot 6: feedback + text"
12,"SUPPRF30203",50,46,37,2,0,33,37,35,"Pilot 6","Pilot 6: feedback + text"
13,"SUPPRF30203",32,40,24,-19,-13,47,37,43,"Pilot 6","Pilot 6: feedback + text"
14,"SUPPRF30203",43,45,38,-11,-16,47,54,49,"Pilot 6","Pilot 6: feedback + text"
15,"SUPPRF30203",46,47,58,39,12,77,46,19,"Pilot 6","Pilot 6: feedback + text"
16,"SUPPRF30203",51,47,35,24,15,42,20,11,"Pilot 6","Pilot 6: feedback + text"
17,"SUPPRF30203",57,60,96,51,16,43,80,45,"Pilot 6","Pilot 6: feedback + text"
18,"SUPPRF30203",55,54,49,-18,12,0,37,67,"Pilot 6","Pilot 6: feedback + text"
19,"SUPPRF30203",44,45,38,-6,1,55,37,44,"Pilot 6","Pilot 6: feedback + text"
20,"SUPPRF30203",40,40,66,16,12,70,54,50,"Pilot 6","Pilot 6: feedback + text"
21,"SUPPRF30203",18,53,19,-43,-1,59,20,62,"Pilot 6","Pilot 6: feedback + text"
22,"SUPPRF30203",57,72,50,-6,-13,53,63,56,"Pilot 6","Pilot 6: feedback + text"
23,"SUPPRF30203",52,46,51,-4,14,49,37,55,"Pilot 6","Pilot 6: feedback + text"
24,"SUPPRF30203",44,45,20,8,0,22,20,12,"Pilot 6","Pilot 6: feedback + text"
25,"SUPPRF30203",44,31,8,-8,-12,38,20,16,"Pilot 6","Pilot 6: feedback + text"
26,"SUPPRF30203",64,53,62,7,-1,46,63,55,"Pilot 6","Pilot 6: feedback + text"
27,"SUPPRF30203",48,47,48,-1,19,58,29,49,"Pilot 6","Pilot 6: feedback + text"
28,"SUPPRF30203",48,53,55,13,-16,43,71,42,"Pilot 6","Pilot 6: feedback + text"
29,"SUPPRF30203",57,44,63,13,0,53,63,50,"Pilot 6","Pilot 6: feedback + text"
30,"SUPPRF30203",43,37,41,-19,-13,48,54,60,"Pilot 6","Pilot 6: feedback + text"
31,"SUPPRF30203",48,44,67,20,-13,39,80,47,"Pilot 6","Pilot 6: feedback + text"
32,"SUPPRF30203",56,67,70,11,-1,59,71,59,"Pilot 6","Pilot 6: feedback + text"
33,"SUPPRF30203",53,55,54,0,0,50,54,54,"Pilot 6","Pilot 6: feedback + text"
34,"SUPPRF30203",50,44,34,-18,-12,55,46,52,"Pilot 6","Pilot 6: feedback + text"
35,"SUPPRF30203",51,47,68,12,-12,59,80,56,"Pilot 6","Pilot 6: feedback + text"
36,"SUPPRF30203",51,56,68,26,14,47,54,42,"Pilot 6","Pilot 6: feedback + text"
37,"SUPPRF30203",48,42,33,-12,-13,50,46,45,"Pilot 6","Pilot 6: feedback + text"
38,"SUPPRF30203",39,38,15,-4,-14,22,29,19,"Pilot 6","Pilot 6: feedback + text"
39,"SUPPRF30203",43,47,47,-2,-16,42,63,49,"Pilot 6","Pilot 6: feedback + text"
40,"SUPPRF30203",55,41,56,20,-15,46,71,36,"Pilot 6","Pilot 6: feedback + text"
41,"SUPPRF30203",42,44,77,35,14,47,63,42,"Pilot 6","Pilot 6: feedback + text"
42,"SUPPRF30203",44,47,46,-5,0,45,46,51,"Pilot 6","Pilot 6: feedback + text"
43,"SUPPRF30203",45,51,78,37,15,47,63,41,"Pilot 6","Pilot 6: feedback + text"
44,"SUPPRF30203",75,52,37,24,17,23,20,13,"Pilot 6","Pilot 6: feedback + text"
45,"SUPPRF30203",54,47,65,18,19,52,46,47,"Pilot 6","Pilot 6: feedback + text"
46,"SUPPRF30203",38,21,97,69,17,43,80,28,"Pilot 6","Pilot 6: feedback + text"
47,"SUPPRF30203",46,54,84,22,13,58,71,62,"Pilot 6","Pilot 6: feedback + text"
48,"SUPPRF30203",53,47,80,-2,0,63,80,82,"Pilot 6","Pilot 6: feedback + text"
1,"SUPPRF16716",1,56,96,13,16,54,80,83,"Pilot 6","Pilot 6: feedback + text"
2,"SUPPRF16716",1,54,24,-6,-13,44,37,30,"Pilot 6","Pilot 6: feedback + text"
3,"SUPPRF16716",1,47,8,-7,-12,41,20,15,"Pilot 6","Pilot 6: feedback + text"
4,"SUPPRF16716",1,47,78,3,15,56,63,75,"Pilot 6","Pilot 6: feedback + text"
5,"SUPPRF16716",2,42,58,8,12,57,46,50,"Pilot 6","Pilot 6: feedback + text"
6,"SUPPRF16716",1,42,66,14,12,64,54,52,"Pilot 6","Pilot 6: feedback + text"
7,"SUPPRF16716",1,55,67,-22,-13,72,80,89,"Pilot 6","Pilot 6: feedback + text"
8,"SUPPRF16716",2,47,77,25,14,59,63,52,"Pilot 6","Pilot 6: feedback + text"
9,"SUPPRF16716",1,36,62,4,-1,38,63,58,"Pilot 6","Pilot 6: feedback + text"
10,"SUPPRF16716",0,28,19,3,-1,66,20,16,"Pilot 6","Pilot 6: feedback + text"
11,"SUPPRF16716",0,37,29,-1,0,58,29,30,"Pilot 6","Pilot 6: feedback + text"
12,"SUPPRF16716",2,37,63,-7,0,45,63,70,"Pilot 6","Pilot 6: feedback + text"
13,"SUPPRF16716",1,40,20,1,0,55,20,19,"Pilot 6","Pilot 6: feedback + text"
14,"SUPPRF16716",1,21,68,3,14,72,54,65,"Pilot 6","Pilot 6: feedback + text"
15,"SUPPRF16716",0,35,28,-2,-1,55,29,30,"Pilot 6","Pilot 6: feedback + text"
16,"SUPPRF16716",0,38,33,-7,-13,63,46,40,"Pilot 6","Pilot 6: feedback + text"
17,"SUPPRF16716",0,26,46,14,17,56,29,32,"Pilot 6","Pilot 6: feedback + text"
18,"SUPPRF16716",1,41,65,30,19,68,46,35,"Pilot 6","Pilot 6: feedback + text"
19,"SUPPRF16716",0,28,45,-2,-1,57,46,47,"Pilot 6","Pilot 6: feedback + text"
20,"SUPPRF16716",1,28,41,-10,-13,62,54,51,"Pilot 6","Pilot 6: feedback + text"
21,"SUPPRF16716",1,35,38,-21,-16,75,54,59,"Pilot 6","Pilot 6: feedback + text"
22,"SUPPRF16716",1,30,34,-4,-12,59,46,38,"Pilot 6","Pilot 6: feedback + text"
23,"SUPPRF16716",1,31,22,-5,-15,66,37,27,"Pilot 6","Pilot 6: feedback + text"
24,"SUPPRF16716",1,33,38,3,1,66,37,35,"Pilot 6","Pilot 6: feedback + text"
25,"SUPPRF16716",1,36,48,16,19,65,29,32,"Pilot 6","Pilot 6: feedback + text"
26,"SUPPRF16716",1,29,55,-25,-16,77,71,80,"Pilot 6","Pilot 6: feedback + text"
27,"SUPPRF16716",0,25,54,-7,0,78,54,61,"Pilot 6","Pilot 6: feedback + text"
28,"SUPPRF16716",1,38,16,-10,-13,57,29,26,"Pilot 6","Pilot 6: feedback + text"
29,"SUPPRF16716",1,41,97,10,17,60,80,87,"Pilot 6","Pilot 6: feedback + text"
30,"SUPPRF16716",1,42,68,-20,-12,73,80,88,"Pilot 6","Pilot 6: feedback + text"
31,"SUPPRF16716",1,26,70,-5,-1,66,71,75,"Pilot 6","Pilot 6: feedback + text"
32,"SUPPRF16716",0,34,50,15,-13,54,63,35,"Pilot 6","Pilot 6: feedback + text"
33,"SUPPRF16716",1,48,81,10,1,54,80,71,"Pilot 6","Pilot 6: feedback + text"
34,"SUPPRF16716",1,29,35,14,15,50,20,21,"Pilot 6","Pilot 6: feedback + text"
35,"SUPPRF16716",2,30,71,9,0,61,71,62,"Pilot 6","Pilot 6: feedback + text"
36,"SUPPRF16716",1,25,15,1,-14,59,29,14,"Pilot 6","Pilot 6: feedback + text"
37,"SUPPRF16716",1,36,49,7,12,66,37,42,"Pilot 6","Pilot 6: feedback + text"
38,"SUPPRF16716",0,34,46,-1,0,66,46,47,"Pilot 6","Pilot 6: feedback + text"
39,"SUPPRF16716",0,33,80,-2,0,56,80,82,"Pilot 6","Pilot 6: feedback + text"
40,"SUPPRF16716",1,34,47,-14,-16,55,63,61,"Pilot 6","Pilot 6: feedback + text"
41,"SUPPRF16716",1,33,56,-7,-15,79,71,63,"Pilot 6","Pilot 6: feedback + text"
42,"SUPPRF16716",1,21,37,-9,0,62,37,46,"Pilot 6","Pilot 6: feedback + text"
43,"SUPPRF16716",1,54,6,-22,-14,49,20,28,"Pilot 6","Pilot 6: feedback + text"
44,"SUPPRF16716",0,57,51,-2,14,43,37,53,"Pilot 6","Pilot 6: feedback + text"
45,"SUPPRF16716",0,63,55,3,1,60,54,52,"Pilot 6","Pilot 6: feedback + text"
46,"SUPPRF16716",2,38,83,18,12,74,71,65,"Pilot 6","Pilot 6: feedback + text"
47,"SUPPRF16716",1,26,84,14,13,58,71,70,"Pilot 6","Pilot 6: feedback + text"
48,"SUPPRF16716",0,21,37,24,17,69,20,13,"Pilot 6","Pilot 6: feedback + text"
1,"SUPPRF51230",56,62,65,20,19,87,46,45,"Pilot 6","Pilot 6: feedback + text"
2,"SUPPRF51230",63,62,46,12,17,61,29,34,"Pilot 6","Pilot 6: feedback + text"
3,"SUPPRF51230",64,63,33,-17,-13,74,46,50,"Pilot 6","Pilot 6: feedback + text"
4,"SUPPRF51230",62,61,78,11,15,90,63,67,"Pilot 6","Pilot 6: feedback + text"
5,"SUPPRF51230",56,55,83,15,12,68,71,68,"Pilot 6","Pilot 6: feedback + text"
6,"SUPPRF51230",59,59,55,-8,-16,81,71,63,"Pilot 6","Pilot 6: feedback + text"
7,"SUPPRF51230",60,59,49,-8,12,33,37,57,"Pilot 6","Pilot 6: feedback + text"
8,"SUPPRF51230",57,58,20,-12,0,69,20,32,"Pilot 6","Pilot 6: feedback + text"
9,"SUPPRF51230",56,56,34,-23,-12,74,46,57,"Pilot 6","Pilot 6: feedback + text"
10,"SUPPRF51230",51,53,29,-11,0,53,29,40,"Pilot 6","Pilot 6: feedback + text"
11,"SUPPRF51230",58,58,22,-13,-15,63,37,35,"Pilot 6","Pilot 6: feedback + text"
12,"SUPPRF51230",56,55,24,-15,-13,59,37,39,"Pilot 6","Pilot 6: feedback + text"
13,"SUPPRF51230",52,51,55,14,1,62,54,41,"Pilot 6","Pilot 6: feedback + text"
14,"SUPPRF51230",55,54,6,-30,-14,65,20,36,"Pilot 6","Pilot 6: feedback + text"
15,"SUPPRF51230",56,56,16,-18,-13,61,29,34,"Pilot 6","Pilot 6: feedback + text"
16,"SUPPRF51230",50,51,63,17,0,44,63,46,"Pilot 6","Pilot 6: feedback + text"
17,"SUPPRF51230",52,54,8,-6,-12,67,20,14,"Pilot 6","Pilot 6: feedback + text"
18,"SUPPRF51230",56,56,56,-14,-15,75,71,70,"Pilot 6","Pilot 6: feedback + text"
19,"SUPPRF51230",54,57,47,-17,-16,77,63,64,"Pilot 6","Pilot 6: feedback + text"
20,"SUPPRF51230",53,57,50,-4,-13,37,63,54,"Pilot 6","Pilot 6: feedback + text"
21,"SUPPRF51230",55,56,81,1,1,76,80,80,"Pilot 6","Pilot 6: feedback + text"
22,"SUPPRF51230",56,55,41,-22,-13,34,54,63,"Pilot 6","Pilot 6: feedback + text"
23,"SUPPRF51230",55,52,28,4,-1,81,29,24,"Pilot 6","Pilot 6: feedback + text"
24,"SUPPRF51230",62,64,35,19,15,82,20,16,"Pilot 6","Pilot 6: feedback + text"
25,"SUPPRF51230",52,52,96,28,16,64,80,68,"Pilot 6","Pilot 6: feedback + text"
26,"SUPPRF51230",54,53,58,5,12,58,46,53,"Pilot 6","Pilot 6: feedback + text"
27,"SUPPRF51230",52,50,97,27,17,56,80,70,"Pilot 6","Pilot 6: feedback + text"
28,"SUPPRF51230",46,55,67,-3,-13,58,80,70,"Pilot 6","Pilot 6: feedback + text"
29,"SUPPRF51230",41,56,38,-29,-16,67,54,67,"Pilot 6","Pilot 6: feedback + text"
30,"SUPPRF51230",38,57,19,-15,-1,55,20,34,"Pilot 6","Pilot 6: feedback + text"
31,"SUPPRF51230",40,56,37,-13,0,23,37,50,"Pilot 6","Pilot 6: feedback + text"
32,"SUPPRF51230",33,53,80,-1,0,62,80,81,"Pilot 6","Pilot 6: feedback + text"
33,"SUPPRF51230",40,57,84,20,13,56,71,64,"Pilot 6","Pilot 6: feedback + text"
34,"SUPPRF51230",34,60,70,21,-1,54,71,49,"Pilot 6","Pilot 6: feedback + text"
35,"SUPPRF51230",35,63,77,28,14,52,63,49,"Pilot 6","Pilot 6: feedback + text"
36,"SUPPRF51230",39,62,46,-10,0,39,46,56,"Pilot 6","Pilot 6: feedback + text"
37,"SUPPRF51230",36,65,71,20,0,66,71,51,"Pilot 6","Pilot 6: feedback + text"
38,"SUPPRF51230",38,59,15,-47,-14,58,29,62,"Pilot 6","Pilot 6: feedback + text"
39,"SUPPRF51230",33,61,66,14,12,61,54,52,"Pilot 6","Pilot 6: feedback + text"
40,"SUPPRF51230",32,60,62,11,-1,63,63,51,"Pilot 6","Pilot 6: feedback + text"
41,"SUPPRF51230",32,59,68,3,-12,34,80,65,"Pilot 6","Pilot 6: feedback + text"
42,"SUPPRF51230",36,61,48,10,19,65,29,38,"Pilot 6","Pilot 6: feedback + text"
43,"SUPPRF51230",39,58,51,13,14,54,37,38,"Pilot 6","Pilot 6: feedback + text"
44,"SUPPRF51230",33,58,45,1,-1,59,46,44,"Pilot 6","Pilot 6: feedback + text"
45,"SUPPRF51230",39,59,38,5,1,48,37,33,"Pilot 6","Pilot 6: feedback + text"
46,"SUPPRF51230",35,59,54,14,0,48,54,40,"Pilot 6","Pilot 6: feedback + text"
47,"SUPPRF51230",39,58,37,21,17,57,20,16,"Pilot 6","Pilot 6: feedback + text"
48,"SUPPRF51230",36,59,68,14,14,71,54,54,"Pilot 6","Pilot 6: feedback + text"
1,"SUPPRF43536",57,44,22,-24,-15,42,37,46,"Pilot 6","Pilot 6: feedback + text"
2,"SUPPRF43536",70,46,83,49,12,49,71,34,"Pilot 6","Pilot 6: feedback + text"
3,"SUPPRF43536",57,34,71,33,0,46,71,38,"Pilot 6","Pilot 6: feedback + text"
4,"SUPPRF43536",15,49,51,10,14,63,37,41,"Pilot 6","Pilot 6: feedback + text"
5,"SUPPRF43536",50,32,33,-8,-13,59,46,41,"Pilot 6","Pilot 6: feedback + text"
6,"SUPPRF43536",54,42,48,12,19,53,29,36,"Pilot 6","Pilot 6: feedback + text"
7,"SUPPRF43536",67,53,46,1,17,75,29,45,"Pilot 6","Pilot 6: feedback + text"
8,"SUPPRF43536",48,52,28,-19,-1,51,29,47,"Pilot 6","Pilot 6: feedback + text"
9,"SUPPRF43536",90,4,77,47,14,41,63,30,"Pilot 6","Pilot 6: feedback + text"
10,"SUPPRF43536",94,8,68,27,14,50,54,41,"Pilot 6","Pilot 6: feedback + text"
11,"SUPPRF43536",89,53,78,24,15,49,63,54,"Pilot 6","Pilot 6: feedback + text"
12,"SUPPRF43536",50,52,84,36,13,58,71,48,"Pilot 6","Pilot 6: feedback + text"
13,"SUPPRF43536",31,66,38,-4,-16,55,54,42,"Pilot 6","Pilot 6: feedback + text"
14,"SUPPRF43536",46,92,6,-41,-14,62,20,47,"Pilot 6","Pilot 6: feedback + text"
15,"SUPPRF43536",80,17,70,23,-1,52,71,47,"Pilot 6","Pilot 6: feedback + text"
16,"SUPPRF43536",68,29,20,7,0,83,20,13,"Pilot 6","Pilot 6: feedback + text"
17,"SUPPRF43536",63,47,38,-12,1,36,37,50,"Pilot 6","Pilot 6: feedback + text"
18,"SUPPRF43536",62,46,58,-8,12,61,46,66,"Pilot 6","Pilot 6: feedback + text"
19,"SUPPRF43536",20,82,15,-21,-14,55,29,36,"Pilot 6","Pilot 6: feedback + text"
20,"SUPPRF43536",49,51,16,-34,-13,46,29,50,"Pilot 6","Pilot 6: feedback + text"
21,"SUPPRF43536",83,51,65,24,19,43,46,41,"Pilot 6","Pilot 6: feedback + text"
22,"SUPPRF43536",88,25,56,6,-15,43,71,50,"Pilot 6","Pilot 6: feedback + text"
23,"SUPPRF43536",15,78,19,-30,-1,33,20,49,"Pilot 6","Pilot 6: feedback + text"
24,"SUPPRF43536",48,47,24,-23,-13,50,37,47,"Pilot 6","Pilot 6: feedback + text"
25,"SUPPRF43536",53,49,55,9,-16,40,71,46,"Pilot 6","Pilot 6: feedback + text"
26,"SUPPRF43536",54,50,54,6,0,41,54,48,"Pilot 6","Pilot 6: feedback + text"
27,"SUPPRF43536",89,18,67,27,-13,44,80,40,"Pilot 6","Pilot 6: feedback + text"
28,"SUPPRF43536",53,28,45,0,-1,42,46,45,"Pilot 6","Pilot 6: feedback + text"
29,"SUPPRF43536",58,52,41,-3,-13,49,54,44,"Pilot 6","Pilot 6: feedback + text"
30,"SUPPRF43536",91,56,96,42,16,47,80,54,"Pilot 6","Pilot 6: feedback + text"
31,"SUPPRF43536",74,35,68,30,-12,46,80,38,"Pilot 6","Pilot 6: feedback + text"
32,"SUPPRF43536",74,60,47,8,-16,51,63,39,"Pilot 6","Pilot 6: feedback + text"
33,"SUPPRF43536",56,45,35,-15,15,65,20,50,"Pilot 6","Pilot 6: feedback + text"
34,"SUPPRF43536",52,44,49,3,12,53,37,46,"Pilot 6","Pilot 6: feedback + text"
35,"SUPPRF43536",20,86,8,-46,-12,51,20,54,"Pilot 6","Pilot 6: feedback + text"
36,"SUPPRF43536",46,17,34,22,-12,55,46,12,"Pilot 6","Pilot 6: feedback + text"
37,"SUPPRF43536",52,14,97,56,17,51,80,41,"Pilot 6","Pilot 6: feedback + text"
38,"SUPPRF43536",96,3,55,2,1,55,54,53,"Pilot 6","Pilot 6: feedback + text"
39,"SUPPRF43536",87,14,80,28,0,48,80,52,"Pilot 6","Pilot 6: feedback + text"
40,"SUPPRF43536",73,13,62,48,-1,54,63,14,"Pilot 6","Pilot 6: feedback + text"
41,"SUPPRF43536",76,55,63,7,0,53,63,56,"Pilot 6","Pilot 6: feedback + text"
42,"SUPPRF43536",76,14,50,-4,-13,47,63,54,"Pilot 6","Pilot 6: feedback + text"
43,"SUPPRF43536",62,11,66,15,12,37,54,51,"Pilot 6","Pilot 6: feedback + text"
44,"SUPPRF43536",85,22,46,-3,0,38,46,49,"Pilot 6","Pilot 6: feedback + text"
45,"SUPPRF43536",86,55,29,-24,0,29,29,53,"Pilot 6","Pilot 6: feedback + text"
46,"SUPPRF43536",63,34,81,30,1,42,80,51,"Pilot 6","Pilot 6: feedback + text"
47,"SUPPRF43536",44,68,37,-6,0,47,37,43,"Pilot 6","Pilot 6: feedback + text"
48,"SUPPRF43536",65,45,37,8,17,45,20,29,"Pilot 6","Pilot 6: feedback + text"
1,"SUPPRF13138",62,57,97,25,17,69,80,72,"Pilot 6","Pilot 6: feedback + text"
2,"SUPPRF13138",57,51,55,13,1,64,54,42,"Pilot 6","Pilot 6: feedback + text"
3,"SUPPRF13138",47,52,68,12,14,65,54,56,"Pilot 6","Pilot 6: feedback + text"
4,"SUPPRF13138",49,58,50,-5,-13,59,63,55,"Pilot 6","Pilot 6: feedback + text"
5,"SUPPRF13138",48,45,48,13,19,59,29,35,"Pilot 6","Pilot 6: feedback + text"
6,"SUPPRF13138",40,71,20,-79,0,100,20,99,"Pilot 6","Pilot 6: feedback + text"
7,"SUPPRF13138",45,57,51,12,14,53,37,39,"Pilot 6","Pilot 6: feedback + text"
8,"SUPPRF13138",44,44,34,-24,-12,60,46,58,"Pilot 6","Pilot 6: feedback + text"
9,"SUPPRF13138",51,39,80,-4,0,85,80,84,"Pilot 6","Pilot 6: feedback + text"
10,"SUPPRF13138",50,36,77,22,14,57,63,55,"Pilot 6","Pilot 6: feedback + text"
11,"SUPPRF13138",48,41,58,-2,12,84,46,60,"Pilot 6","Pilot 6: feedback + text"
12,"SUPPRF13138",50,40,15,7,-14,90,29,8,"Pilot 6","Pilot 6: feedback + text"
13,"SUPPRF13138",51,37,70,5,-1,53,71,65,"Pilot 6","Pilot 6: feedback + text"
14,"SUPPRF13138",43,34,35,-31,15,58,20,66,"Pilot 6","Pilot 6: feedback + text"
15,"SUPPRF13138",40,27,49,21,12,59,37,28,"Pilot 6","Pilot 6: feedback + text"
16,"SUPPRF13138",51,28,41,-25,-13,80,54,66,"Pilot 6","Pilot 6: feedback + text"
17,"SUPPRF13138",53,34,81,26,1,64,80,55,"Pilot 6","Pilot 6: feedback + text"
18,"SUPPRF13138",50,36,65,21,19,95,46,44,"Pilot 6","Pilot 6: feedback + text"
19,"SUPPRF13138",50,20,46,6,17,43,29,40,"Pilot 6","Pilot 6: feedback + text"
20,"SUPPRF13138",47,21,38,-22,-16,58,54,60,"Pilot 6","Pilot 6: feedback + text"
21,"SUPPRF13138",56,16,67,-3,-13,76,80,70,"Pilot 6","Pilot 6: feedback + text"
22,"SUPPRF13138",36,24,46,-4,0,55,46,50,"Pilot 6","Pilot 6: feedback + text"
23,"SUPPRF13138",33,34,78,29,15,53,63,49,"Pilot 6","Pilot 6: feedback + text"
24,"SUPPRF13138",22,20,24,-10,-13,79,37,34,"Pilot 6","Pilot 6: feedback + text"
25,"SUPPRF13138",63,19,28,-2,-1,76,29,30,"Pilot 6","Pilot 6: feedback + text"
26,"SUPPRF13138",50,41,56,-15,-15,87,71,71,"Pilot 6","Pilot 6: feedback + text"
27,"SUPPRF13138",62,25,66,8,12,85,54,58,"Pilot 6","Pilot 6: feedback + text"
28,"SUPPRF13138",34,22,71,19,0,27,71,52,"Pilot 6","Pilot 6: feedback + text"
29,"SUPPRF13138",37,23,38,2,1,55,37,36,"Pilot 6","Pilot 6: feedback + text"
30,"SUPPRF13138",26,5,47,-13,-16,79,63,60,"Pilot 6","Pilot 6: feedback + text"
31,"SUPPRF13138",11,7,6,-4,-14,62,20,10,"Pilot 6","Pilot 6: feedback + text"
32,"SUPPRF13138",7,18,54,9,0,18,54,45,"Pilot 6","Pilot 6: feedback + text"
33,"SUPPRF13138",15,0,68,-18,-12,83,80,86,"Pilot 6","Pilot 6: feedback + text"
34,"SUPPRF13138",0,8,29,15,0,34,29,14,"Pilot 6","Pilot 6: feedback + text"
35,"SUPPRF13138",0,1,96,26,16,40,80,70,"Pilot 6","Pilot 6: feedback + text"
36,"SUPPRF13138",0,12,62,13,-1,48,63,49,"Pilot 6","Pilot 6: feedback + text"
37,"SUPPRF13138",0,22,19,15,-1,53,20,4,"Pilot 6","Pilot 6: feedback + text"
38,"SUPPRF13138",0,24,33,-14,-13,60,46,47,"Pilot 6","Pilot 6: feedback + text"
39,"SUPPRF13138",0,31,63,12,0,69,63,51,"Pilot 6","Pilot 6: feedback + text"
40,"SUPPRF13138",0,34,37,-18,0,88,37,55,"Pilot 6","Pilot 6: feedback + text"
41,"SUPPRF13138",0,43,37,25,17,88,20,12,"Pilot 6","Pilot 6: feedback + text"
42,"SUPPRF13138",0,50,55,4,-16,7,71,51,"Pilot 6","Pilot 6: feedback + text"
43,"SUPPRF13138",0,61,22,3,-15,72,37,19,"Pilot 6","Pilot 6: feedback + text"
44,"SUPPRF13138",0,66,83,33,12,0,71,50,"Pilot 6","Pilot 6: feedback + text"
45,"SUPPRF13138",0,66,84,19,13,88,71,65,"Pilot 6","Pilot 6: feedback + text"
46,"SUPPRF13138",0,71,8,-42,-12,2,20,50,"Pilot 6","Pilot 6: feedback + text"
47,"SUPPRF13138",0,74,45,-3,-1,81,46,48,"Pilot 6","Pilot 6: feedback + text"
48,"SUPPRF13138",0,77,16,-36,-13,0,29,52,"Pilot 6","Pilot 6: feedback + text"
1,"SUPPRF95014",47,57,62,-19,-1,82,63,81,"Pilot 6","Pilot 6: feedback + text"
2,"SUPPRF95014",38,37,50,-17,-13,60,63,67,"Pilot 6","Pilot 6: feedback + text"
3,"SUPPRF95014",35,27,34,-8,-12,22,46,42,"Pilot 6","Pilot 6: feedback + text"
4,"SUPPRF95014",32,31,46,20,17,28,29,26,"Pilot 6","Pilot 6: feedback + text"
5,"SUPPRF95014",30,35,29,-8,0,35,29,37,"Pilot 6","Pilot 6: feedback + text"
6,"SUPPRF95014",30,32,35,8,15,30,20,27,"Pilot 6","Pilot 6: feedback + text"
7,"SUPPRF95014",41,42,77,49,14,25,63,28,"Pilot 6","Pilot 6: feedback + text"
8,"SUPPRF95014",34,35,84,45,13,37,71,39,"Pilot 6","Pilot 6: feedback + text"
9,"SUPPRF95014",45,46,66,29,12,41,54,37,"Pilot 6","Pilot 6: feedback + text"
10,"SUPPRF95014",47,45,47,-22,-16,71,63,69,"Pilot 6","Pilot 6: feedback + text"
11,"SUPPRF95014",52,28,49,-1,12,59,37,50,"Pilot 6","Pilot 6: feedback + text"
12,"SUPPRF95014",39,36,6,-58,-14,66,20,64,"Pilot 6","Pilot 6: feedback + text"
13,"SUPPRF95014",38,40,83,40,12,39,71,43,"Pilot 6","Pilot 6: feedback + text"
14,"SUPPRF95014",33,32,15,-36,-14,33,29,51,"Pilot 6","Pilot 6: feedback + text"
15,"SUPPRF95014",26,36,68,9,-12,66,80,59,"Pilot 6","Pilot 6: feedback + text"
16,"SUPPRF95014",38,32,70,38,-1,36,71,32,"Pilot 6","Pilot 6: feedback + text"
17,"SUPPRF95014",19,4,45,-4,-1,57,46,49,"Pilot 6","Pilot 6: feedback + text"
18,"SUPPRF95014",11,24,55,23,1,33,54,32,"Pilot 6","Pilot 6: feedback + text"
19,"SUPPRF95014",24,27,22,-48,-15,86,37,70,"Pilot 6","Pilot 6: feedback + text"
20,"SUPPRF95014",14,42,38,-61,1,100,37,99,"Pilot 6","Pilot 6: feedback + text"
21,"SUPPRF95014",6,5,58,-33,12,87,46,91,"Pilot 6","Pilot 6: feedback + text"
22,"SUPPRF95014",15,80,80,29,0,46,80,51,"Pilot 6","Pilot 6: feedback + text"
23,"SUPPRF95014",34,37,16,-40,-13,63,29,56,"Pilot 6","Pilot 6: feedback + text"
24,"SUPPRF95014",22,23,96,60,16,34,80,36,"Pilot 6","Pilot 6: feedback + text"
25,"SUPPRF95014",0,100,68,-19,14,94,54,87,"Pilot 6","Pilot 6: feedback + text"
26,"SUPPRF95014",29,37,20,-14,0,38,20,34,"Pilot 6","Pilot 6: feedback + text"
27,"SUPPRF95014",37,34,41,15,-13,33,54,26,"Pilot 6","Pilot 6: feedback + text"
28,"SUPPRF95014",34,50,65,13,19,56,46,52,"Pilot 6","Pilot 6: feedback + text"
29,"SUPPRF95014",27,32,54,26,0,42,54,28,"Pilot 6","Pilot 6: feedback + text"
30,"SUPPRF95014",0,33,56,4,-15,53,71,52,"Pilot 6","Pilot 6: feedback + text"
31,"SUPPRF95014",32,32,8,-19,-12,29,20,27,"Pilot 6","Pilot 6: feedback + text"
32,"SUPPRF95014",22,17,51,50,14,99,37,1,"Pilot 6","Pilot 6: feedback + text"
33,"SUPPRF95014",14,5,37,17,0,86,37,20,"Pilot 6","Pilot 6: feedback + text"
34,"SUPPRF95014",1,82,46,43,0,5,46,3,"Pilot 6","Pilot 6: feedback + text"
35,"SUPPRF95014",0,40,63,50,0,38,63,13,"Pilot 6","Pilot 6: feedback + text"
36,"SUPPRF95014",27,29,28,17,-1,95,29,11,"Pilot 6","Pilot 6: feedback + text"
37,"SUPPRF95014",14,5,33,3,-13,34,46,30,"Pilot 6","Pilot 6: feedback + text"
38,"SUPPRF95014",22,24,37,22,17,16,20,15,"Pilot 6","Pilot 6: feedback + text"
39,"SUPPRF95014",2,45,97,15,17,82,80,82,"Pilot 6","Pilot 6: feedback + text"
40,"SUPPRF95014",4,9,55,17,-16,48,71,38,"Pilot 6","Pilot 6: feedback + text"
41,"SUPPRF95014",11,22,19,-69,-1,83,20,88,"Pilot 6","Pilot 6: feedback + text"
42,"SUPPRF95014",43,43,78,40,15,35,63,38,"Pilot 6","Pilot 6: feedback + text"
43,"SUPPRF95014",30,12,71,15,0,67,71,56,"Pilot 6","Pilot 6: feedback + text"
44,"SUPPRF95014",44,41,38,-8,-16,53,54,46,"Pilot 6","Pilot 6: feedback + text"
45,"SUPPRF95014",14,100,81,13,1,82,80,68,"Pilot 6","Pilot 6: feedback + text"
46,"SUPPRF95014",14,12,24,-74,-13,99,37,98,"Pilot 6","Pilot 6: feedback + text"
47,"SUPPRF95014",2,97,48,-48,19,98,29,96,"Pilot 6","Pilot 6: feedback + text"
48,"SUPPRF95014",15,10,67,-30,-13,97,80,97,"Pilot 6","Pilot 6: feedback + text"
1,"SUPPRF98941",55,45,55,-2,1,47,54,57,"Pilot 6","Pilot 6: feedback + text"
2,"SUPPRF98941",46,44,65,14,19,60,46,51,"Pilot 6","Pilot 6: feedback + text"
3,"SUPPRF98941",44,54,54,3,0,56,54,51,"Pilot 6","Pilot 6: feedback + text"
4,"SUPPRF98941",51,50,50,-13,-13,75,63,63,"Pilot 6","Pilot 6: feedback + text"
5,"SUPPRF98941",49,54,46,5,17,52,29,41,"Pilot 6","Pilot 6: feedback + text"
6,"SUPPRF98941",47,61,6,-32,-14,58,20,38,"Pilot 6","Pilot 6: feedback + text"
7,"SUPPRF98941",50,60,68,3,-12,51,80,65,"Pilot 6","Pilot 6: feedback + text"
8,"SUPPRF98941",49,56,15,-47,-14,55,29,62,"Pilot 6","Pilot 6: feedback + text"
9,"SUPPRF98941",59,51,37,-17,0,47,37,54,"Pilot 6","Pilot 6: feedback + text"
10,"SUPPRF98941",47,49,66,34,12,40,54,32,"Pilot 6","Pilot 6: feedback + text"
11,"SUPPRF98941",53,56,46,11,0,39,46,35,"Pilot 6","Pilot 6: feedback + text"
12,"SUPPRF98941",66,53,67,1,-13,68,80,66,"Pilot 6","Pilot 6: feedback + text"
13,"SUPPRF98941",55,53,83,14,12,58,71,69,"Pilot 6","Pilot 6: feedback + text"
14,"SUPPRF98941",34,64,49,-14,12,54,37,63,"Pilot 6","Pilot 6: feedback + text"
15,"SUPPRF98941",56,51,22,-39,-15,49,37,61,"Pilot 6","Pilot 6: feedback + text"
16,"SUPPRF98941",49,58,20,-41,0,52,20,61,"Pilot 6","Pilot 6: feedback + text"
17,"SUPPRF98941",51,57,84,37,13,48,71,47,"Pilot 6","Pilot 6: feedback + text"
18,"SUPPRF98941",61,62,96,37,16,49,80,59,"Pilot 6","Pilot 6: feedback + text"
19,"SUPPRF98941",59,44,45,-13,-1,49,46,58,"Pilot 6","Pilot 6: feedback + text"
20,"SUPPRF98941",46,60,51,5,14,53,37,46,"Pilot 6","Pilot 6: feedback + text"
21,"SUPPRF98941",53,41,8,-50,-12,51,20,58,"Pilot 6","Pilot 6: feedback + text"
22,"SUPPRF98941",55,63,33,32,-13,83,46,1,"Pilot 6","Pilot 6: feedback + text"
23,"SUPPRF98941",53,51,24,-35,-13,55,37,59,"Pilot 6","Pilot 6: feedback + text"
24,"SUPPRF98941",50,53,29,-3,0,41,29,32,"Pilot 6","Pilot 6: feedback + text"
25,"SUPPRF98941",56,49,62,-7,-1,60,63,69,"Pilot 6","Pilot 6: feedback + text"
26,"SUPPRF98941",60,43,47,8,-16,60,63,39,"Pilot 6","Pilot 6: feedback + text"
27,"SUPPRF98941",38,37,34,10,-12,71,46,24,"Pilot 6","Pilot 6: feedback + text"
28,"SUPPRF98941",44,56,16,-1,-13,67,29,17,"Pilot 6","Pilot 6: feedback + text"
29,"SUPPRF98941",63,37,77,25,14,55,63,52,"Pilot 6","Pilot 6: feedback + text"
30,"SUPPRF98941",48,57,56,25,-15,33,71,31,"Pilot 6","Pilot 6: feedback + text"
31,"SUPPRF98941",46,51,38,0,1,48,37,38,"Pilot 6","Pilot 6: feedback + text"
32,"SUPPRF98941",59,53,80,17,0,52,80,63,"Pilot 6","Pilot 6: feedback + text"
33,"SUPPRF98941",58,49,55,-6,-16,49,71,61,"Pilot 6","Pilot 6: feedback + text"
34,"SUPPRF98941",53,60,41,-13,-13,40,54,54,"Pilot 6","Pilot 6: feedback + text"
35,"SUPPRF98941",38,47,19,-11,-1,38,20,30,"Pilot 6","Pilot 6: feedback + text"
36,"SUPPRF98941",63,54,68,16,14,43,54,52,"Pilot 6","Pilot 6: feedback + text"
37,"SUPPRF98941",56,51,71,13,0,53,71,58,"Pilot 6","Pilot 6: feedback + text"
38,"SUPPRF98941",54,48,28,-32,-1,43,29,60,"Pilot 6","Pilot 6: feedback + text"
39,"SUPPRF98941",48,56,38,-30,-16,51,54,68,"Pilot 6","Pilot 6: feedback + text"
40,"SUPPRF98941",61,42,70,7,-1,54,71,63,"Pilot 6","Pilot 6: feedback + text"
41,"SUPPRF98941",48,58,37,19,17,68,20,18,"Pilot 6","Pilot 6: feedback + text"
42,"SUPPRF98941",62,53,97,32,17,48,80,65,"Pilot 6","Pilot 6: feedback + text"
43,"SUPPRF98941",55,63,63,3,0,47,63,60,"Pilot 6","Pilot 6: feedback + text"
44,"SUPPRF98941",53,60,48,-9,19,51,29,57,"Pilot 6","Pilot 6: feedback + text"
45,"SUPPRF98941",52,51,78,17,15,53,63,61,"Pilot 6","Pilot 6: feedback + text"
46,"SUPPRF98941",50,58,35,20,15,28,20,15,"Pilot 6","Pilot 6: feedback + text"
47,"SUPPRF98941",52,64,81,11,1,48,80,70,"Pilot 6","Pilot 6: feedback + text"
48,"SUPPRF98941",39,45,58,23,12,55,46,35,"Pilot 6","Pilot 6: feedback + text"
1,"SUPPRF77780",20,42,8,-64,-12,52,20,72,"Pilot 6","Pilot 6: feedback + text"
2,"SUPPRF77780",27,32,28,-35,-1,54,29,63,"Pilot 6","Pilot 6: feedback + text"
3,"SUPPRF77780",29,32,46,-15,0,79,46,61,"Pilot 6","Pilot 6: feedback + text"
4,"SUPPRF77780",30,71,80,9,0,96,80,71,"Pilot 6","Pilot 6: feedback + text"
5,"SUPPRF77780",1,98,6,3,-14,55,20,3,"Pilot 6","Pilot 6: feedback + text"
6,"SUPPRF77780",57,53,63,7,0,57,63,56,"Pilot 6","Pilot 6: feedback + text"
7,"SUPPRF77780",62,35,68,10,14,46,54,58,"Pilot 6","Pilot 6: feedback + text"
8,"SUPPRF77780",58,23,51,20,14,78,37,31,"Pilot 6","Pilot 6: feedback + text"
9,"SUPPRF77780",56,44,35,35,15,50,20,0,"Pilot 6","Pilot 6: feedback + text"
10,"SUPPRF77780",57,51,50,-2,-13,41,63,52,"Pilot 6","Pilot 6: feedback + text"
11,"SUPPRF77780",52,51,55,3,1,51,54,52,"Pilot 6","Pilot 6: feedback + text"
12,"SUPPRF77780",81,32,83,32,12,55,71,51,"Pilot 6","Pilot 6: feedback + text"
13,"SUPPRF77780",43,71,22,-33,-15,44,37,55,"Pilot 6","Pilot 6: feedback + text"
14,"SUPPRF77780",35,65,33,-13,-13,45,46,46,"Pilot 6","Pilot 6: feedback + text"
15,"SUPPRF77780",51,46,65,16,19,53,46,49,"Pilot 6","Pilot 6: feedback + text"
16,"SUPPRF77780",42,66,38,-10,1,56,37,48,"Pilot 6","Pilot 6: feedback + text"
17,"SUPPRF77780",47,57,67,11,-13,43,80,56,"Pilot 6","Pilot 6: feedback + text"
18,"SUPPRF77780",56,47,46,10,17,54,29,36,"Pilot 6","Pilot 6: feedback + text"
19,"SUPPRF77780",24,64,54,-17,0,60,54,71,"Pilot 6","Pilot 6: feedback + text"
20,"SUPPRF77780",47,65,37,-16,17,42,20,53,"Pilot 6","Pilot 6: feedback + text"
21,"SUPPRF77780",47,48,34,-6,-12,57,46,40,"Pilot 6","Pilot 6: feedback + text"
22,"SUPPRF77780",35,68,16,-39,-13,46,29,55,"Pilot 6","Pilot 6: feedback + text"
23,"SUPPRF77780",55,43,71,22,0,55,71,49,"Pilot 6","Pilot 6: feedback + text"
24,"SUPPRF77780",50,66,81,35,1,43,80,46,"Pilot 6","Pilot 6: feedback + text"
25,"SUPPRF77780",27,70,84,49,13,50,71,35,"Pilot 6","Pilot 6: feedback + text"
26,"SUPPRF77780",19,94,24,-7,-13,30,37,31,"Pilot 6","Pilot 6: feedback + text"
27,"SUPPRF77780",4,73,48,0,19,54,29,48,"Pilot 6","Pilot 6: feedback + text"
28,"SUPPRF77780",35,86,20,13,0,76,20,7,"Pilot 6","Pilot 6: feedback + text"
29,"SUPPRF77780",58,46,47,-1,-16,43,63,48,"Pilot 6","Pilot 6: feedback + text"
30,"SUPPRF77780",50,61,62,20,-1,59,63,42,"Pilot 6","Pilot 6: feedback + text"
31,"SUPPRF77780",63,47,70,31,-1,61,71,39,"Pilot 6","Pilot 6: feedback + text"
32,"SUPPRF77780",57,51,77,27,14,54,63,50,"Pilot 6","Pilot 6: feedback + text"
33,"SUPPRF77780",52,47,38,-60,-16,54,54,98,"Pilot 6","Pilot 6: feedback + text"
34,"SUPPRF77780",51,49,58,11,12,42,46,47,"Pilot 6","Pilot 6: feedback + text"
35,"SUPPRF77780",50,50,56,9,-15,51,71,47,"Pilot 6","Pilot 6: feedback + text"
36,"SUPPRF77780",41,50,55,2,-16,42,71,53,"Pilot 6","Pilot 6: feedback + text"
37,"SUPPRF77780",41,48,41,-15,-13,50,54,56,"Pilot 6","Pilot 6: feedback + text"
38,"SUPPRF77780",50,52,15,-37,-14,44,29,52,"Pilot 6","Pilot 6: feedback + text"
39,"SUPPRF77780",58,53,66,10,12,51,54,56,"Pilot 6","Pilot 6: feedback + text"
40,"SUPPRF77780",49,54,96,49,16,53,80,47,"Pilot 6","Pilot 6: feedback + text"
41,"SUPPRF77780",50,47,45,-7,-1,47,46,52,"Pilot 6","Pilot 6: feedback + text"
42,"SUPPRF77780",50,63,29,-22,0,55,29,51,"Pilot 6","Pilot 6: feedback + text"
43,"SUPPRF77780",61,52,68,18,-12,62,80,50,"Pilot 6","Pilot 6: feedback + text"
44,"SUPPRF77780",45,52,37,-14,0,58,37,51,"Pilot 6","Pilot 6: feedback + text"
45,"SUPPRF77780",45,55,19,-32,-1,59,20,51,"Pilot 6","Pilot 6: feedback + text"
46,"SUPPRF77780",54,44,49,-5,12,42,37,54,"Pilot 6","Pilot 6: feedback + text"
47,"SUPPRF77780",48,53,97,43,17,44,80,54,"Pilot 6","Pilot 6: feedback + text"
48,"SUPPRF77780",53,52,78,28,15,51,63,50,"Pilot 6","Pilot 6: feedback + text"
1,"SUPPRF94218",25,64,20,-4,0,88,20,24,"Pilot 6","Pilot 6: feedback + text"
2,"SUPPRF94218",23,70,56,-9,-15,72,71,65,"Pilot 6","Pilot 6: feedback + text"
3,"SUPPRF94218",50,20,83,20,12,63,71,63,"Pilot 6","Pilot 6: feedback + text"
4,"SUPPRF94218",16,66,46,28,17,78,29,18,"Pilot 6","Pilot 6: feedback + text"
5,"SUPPRF94218",22,62,37,10,0,50,37,27,"Pilot 6","Pilot 6: feedback + text"
6,"SUPPRF94218",25,54,24,-12,-13,79,37,36,"Pilot 6","Pilot 6: feedback + text"
7,"SUPPRF94218",22,70,68,13,-12,56,80,55,"Pilot 6","Pilot 6: feedback + text"
8,"SUPPRF94218",26,74,62,20,-1,31,63,42,"Pilot 6","Pilot 6: feedback + text"
9,"SUPPRF94218",19,75,8,-23,-12,28,20,31,"Pilot 6","Pilot 6: feedback + text"
10,"SUPPRF94218",31,66,58,27,12,83,46,31,"Pilot 6","Pilot 6: feedback + text"
11,"SUPPRF94218",26,68,55,-1,1,67,54,56,"Pilot 6","Pilot 6: feedback + text"
12,"SUPPRF94218",26,63,41,-4,-13,79,54,45,"Pilot 6","Pilot 6: feedback + text"
13,"SUPPRF94218",20,74,34,21,-12,84,46,13,"Pilot 6","Pilot 6: feedback + text"
14,"SUPPRF94218",31,62,84,24,13,76,71,60,"Pilot 6","Pilot 6: feedback + text"
15,"SUPPRF94218",27,55,16,-36,-13,44,29,52,"Pilot 6","Pilot 6: feedback + text"
16,"SUPPRF94218",25,58,19,-10,-1,76,20,29,"Pilot 6","Pilot 6: feedback + text"
17,"SUPPRF94218",25,67,80,57,0,38,80,23,"Pilot 6","Pilot 6: feedback + text"
18,"SUPPRF94218",27,66,29,-13,0,56,29,42,"Pilot 6","Pilot 6: feedback + text"
19,"SUPPRF94218",27,60,46,7,0,51,46,39,"Pilot 6","Pilot 6: feedback + text"
20,"SUPPRF94218",29,70,51,17,14,41,37,34,"Pilot 6","Pilot 6: feedback + text"
21,"SUPPRF94218",26,69,6,-15,-14,78,20,21,"Pilot 6","Pilot 6: feedback + text"
22,"SUPPRF94218",22,72,35,15,15,76,20,20,"Pilot 6","Pilot 6: feedback + text"
23,"SUPPRF94218",25,65,22,-8,-15,65,37,30,"Pilot 6","Pilot 6: feedback + text"
24,"SUPPRF94218",25,70,47,17,-16,46,63,30,"Pilot 6","Pilot 6: feedback + text"
25,"SUPPRF94218",29,64,96,33,16,63,80,63,"Pilot 6","Pilot 6: feedback + text"
26,"SUPPRF94218",40,64,77,29,14,47,63,48,"Pilot 6","Pilot 6: feedback + text"
27,"SUPPRF94218",26,70,49,0,12,8,37,49,"Pilot 6","Pilot 6: feedback + text"
28,"SUPPRF94218",27,64,45,6,-1,32,46,39,"Pilot 6","Pilot 6: feedback + text"
29,"SUPPRF94218",33,63,71,14,0,74,71,57,"Pilot 6","Pilot 6: feedback + text"
30,"SUPPRF94218",30,69,67,-10,-13,70,80,77,"Pilot 6","Pilot 6: feedback + text"
31,"SUPPRF94218",41,65,50,8,-13,55,63,42,"Pilot 6","Pilot 6: feedback + text"
32,"SUPPRF94218",34,53,33,-23,-13,28,46,56,"Pilot 6","Pilot 6: feedback + text"
33,"SUPPRF94218",36,60,68,13,14,19,54,55,"Pilot 6","Pilot 6: feedback + text"
34,"SUPPRF94218",58,56,78,33,15,25,63,45,"Pilot 6","Pilot 6: feedback + text"
35,"SUPPRF94218",35,53,15,-10,-14,64,29,25,"Pilot 6","Pilot 6: feedback + text"
36,"SUPPRF94218",38,53,66,27,12,48,54,39,"Pilot 6","Pilot 6: feedback + text"
37,"SUPPRF94218",32,56,28,11,-1,62,29,17,"Pilot 6","Pilot 6: feedback + text"
38,"SUPPRF94218",43,56,70,19,-1,36,71,51,"Pilot 6","Pilot 6: feedback + text"
39,"SUPPRF94218",34,55,97,42,17,67,80,55,"Pilot 6","Pilot 6: feedback + text"
40,"SUPPRF94218",36,53,38,-19,-16,53,54,57,"Pilot 6","Pilot 6: feedback + text"
41,"SUPPRF94218",32,56,48,35,19,79,29,13,"Pilot 6","Pilot 6: feedback + text"
42,"SUPPRF94218",34,57,63,14,0,61,63,49,"Pilot 6","Pilot 6: feedback + text"
43,"SUPPRF94218",40,63,81,-1,1,85,80,82,"Pilot 6","Pilot 6: feedback + text"
44,"SUPPRF94218",30,58,38,9,1,32,37,29,"Pilot 6","Pilot 6: feedback + text"
45,"SUPPRF94218",36,58,65,38,19,15,46,27,"Pilot 6","Pilot 6: feedback + text"
46,"SUPPRF94218",33,56,55,9,-16,52,71,46,"Pilot 6","Pilot 6: feedback + text"
47,"SUPPRF94218",28,52,37,14,17,71,20,23,"Pilot 6","Pilot 6: feedback + text"
48,"SUPPRF94218",33,52,54,17,0,57,54,37,"Pilot 6","Pilot 6: feedback + text"
1,"SUPPRF69479",53,35,97,14,17,73,80,83,"Pilot 6","Pilot 6: feedback + text"
2,"SUPPRF69479",41,41,62,3,-1,58,63,59,"Pilot 6","Pilot 6: feedback + text"
3,"SUPPRF69479",38,26,48,19,19,79,29,29,"Pilot 6","Pilot 6: feedback + text"
4,"SUPPRF69479",31,44,70,8,-1,68,71,62,"Pilot 6","Pilot 6: feedback + text"
5,"SUPPRF69479",27,47,34,-16,-12,31,46,50,"Pilot 6","Pilot 6: feedback + text"
6,"SUPPRF69479",44,32,81,11,1,62,80,70,"Pilot 6","Pilot 6: feedback + text"
7,"SUPPRF69479",45,43,38,-7,-16,47,54,45,"Pilot 6","Pilot 6: feedback + text"
8,"SUPPRF69479",46,49,38,-9,1,18,37,47,"Pilot 6","Pilot 6: feedback + text"
9,"SUPPRF69479",36,36,56,-26,-15,83,71,82,"Pilot 6","Pilot 6: feedback + text"
10,"SUPPRF69479",21,26,16,-2,-13,90,29,18,"Pilot 6","Pilot 6: feedback + text"
11,"SUPPRF69479",44,39,78,55,15,31,63,23,"Pilot 6","Pilot 6: feedback + text"
12,"SUPPRF69479",41,40,66,33,12,23,54,33,"Pilot 6","Pilot 6: feedback + text"
13,"SUPPRF69479",44,46,96,30,16,48,80,66,"Pilot 6","Pilot 6: feedback + text"
14,"SUPPRF69479",43,44,41,-18,-13,35,54,59,"Pilot 6","Pilot 6: feedback + text"
15,"SUPPRF69479",23,46,51,32,14,76,37,19,"Pilot 6","Pilot 6: feedback + text"
16,"SUPPRF69479",34,35,55,-27,1,79,54,82,"Pilot 6","Pilot 6: feedback + text"
17,"SUPPRF69479",41,49,15,-27,-14,37,29,42,"Pilot 6","Pilot 6: feedback + text"
18,"SUPPRF69479",42,43,80,-2,0,81,80,82,"Pilot 6","Pilot 6: feedback + text"
19,"SUPPRF69479",36,35,20,-31,0,29,20,51,"Pilot 6","Pilot 6: feedback + text"
20,"SUPPRF69479",34,37,54,16,0,61,54,38,"Pilot 6","Pilot 6: feedback + text"
21,"SUPPRF69479",40,37,37,-37,0,11,37,74,"Pilot 6","Pilot 6: feedback + text"
22,"SUPPRF69479",36,44,58,32,12,78,46,26,"Pilot 6","Pilot 6: feedback + text"
23,"SUPPRF69479",36,56,6,-44,-14,49,20,50,"Pilot 6","Pilot 6: feedback + text"
24,"SUPPRF69479",27,53,83,45,12,0,71,38,"Pilot 6","Pilot 6: feedback + text"
25,"SUPPRF69479",32,64,37,-28,17,20,20,65,"Pilot 6","Pilot 6: feedback + text"
26,"SUPPRF69479",36,63,22,-13,-15,33,37,35,"Pilot 6","Pilot 6: feedback + text"
27,"SUPPRF69479",29,60,63,30,0,62,63,33,"Pilot 6","Pilot 6: feedback + text"
28,"SUPPRF69479",30,54,8,-27,-12,35,20,35,"Pilot 6","Pilot 6: feedback + text"
29,"SUPPRF69479",28,50,77,9,14,74,63,68,"Pilot 6","Pilot 6: feedback + text"
30,"SUPPRF69479",49,38,71,-3,0,41,71,74,"Pilot 6","Pilot 6: feedback + text"
31,"SUPPRF69479",47,30,29,5,0,6,29,24,"Pilot 6","Pilot 6: feedback + text"
32,"SUPPRF69479",36,55,19,-42,-1,22,20,61,"Pilot 6","Pilot 6: feedback + text"
33,"SUPPRF69479",30,62,50,-12,-13,64,63,62,"Pilot 6","Pilot 6: feedback + text"
34,"SUPPRF69479",35,58,46,18,17,77,29,28,"Pilot 6","Pilot 6: feedback + text"
35,"SUPPRF69479",36,62,33,-43,-13,76,46,76,"Pilot 6","Pilot 6: feedback + text"
36,"SUPPRF69479",37,52,47,-21,-16,66,63,68,"Pilot 6","Pilot 6: feedback + text"
37,"SUPPRF69479",34,59,67,13,-13,19,80,54,"Pilot 6","Pilot 6: feedback + text"
38,"SUPPRF69479",27,58,68,68,14,0,54,0,"Pilot 6","Pilot 6: feedback + text"
39,"SUPPRF69479",6,28,46,-13,0,55,46,59,"Pilot 6","Pilot 6: feedback + text"
40,"SUPPRF69479",32,56,49,25,12,73,37,24,"Pilot 6","Pilot 6: feedback + text"
41,"SUPPRF69479",31,62,84,17,13,76,71,67,"Pilot 6","Pilot 6: feedback + text"
42,"SUPPRF69479",27,63,28,-15,-1,32,29,43,"Pilot 6","Pilot 6: feedback + text"
43,"SUPPRF69479",27,58,55,21,-16,56,71,34,"Pilot 6","Pilot 6: feedback + text"
44,"SUPPRF69479",33,63,24,-9,-13,30,37,33,"Pilot 6","Pilot 6: feedback + text"
45,"SUPPRF69479",36,58,45,15,-1,5,46,30,"Pilot 6","Pilot 6: feedback + text"
46,"SUPPRF69479",34,58,65,24,19,39,46,41,"Pilot 6","Pilot 6: feedback + text"
47,"SUPPRF69479",36,60,68,-5,-12,33,80,73,"Pilot 6","Pilot 6: feedback + text"
48,"SUPPRF69479",27,64,35,15,15,58,20,20,"Pilot 6","Pilot 6: feedback + text"
1,"SUPPRF59606",60,32,58,11,12,56,46,47,"Pilot 7","Pilot 7: bigger feedback + text"
2,"SUPPRF59606",62,28,84,6,13,87,71,78,"Pilot 7","Pilot 7: bigger feedback + text"
3,"SUPPRF59606",67,32,38,-2,1,35,37,40,"Pilot 7","Pilot 7: bigger feedback + text"
4,"SUPPRF59606",68,20,68,23,14,26,54,45,"Pilot 7","Pilot 7: bigger feedback + text"
5,"SUPPRF59606",71,30,77,11,14,69,63,66,"Pilot 7","Pilot 7: bigger feedback + text"
6,"SUPPRF59606",83,22,97,10,17,87,80,87,"Pilot 7","Pilot 7: bigger feedback + text"
7,"SUPPRF59606",35,61,15,-14,-14,31,29,29,"Pilot 7","Pilot 7: bigger feedback + text"
8,"SUPPRF59606",57,40,46,7,17,36,29,39,"Pilot 7","Pilot 7: bigger feedback + text"
9,"SUPPRF59606",77,24,54,-3,0,74,54,57,"Pilot 7","Pilot 7: bigger feedback + text"
10,"SUPPRF59606",74,28,96,23,16,61,80,73,"Pilot 7","Pilot 7: bigger feedback + text"
11,"SUPPRF59606",80,17,71,-1,0,79,71,72,"Pilot 7","Pilot 7: bigger feedback + text"
12,"SUPPRF59606",66,33,37,-10,17,35,20,47,"Pilot 7","Pilot 7: bigger feedback + text"
13,"SUPPRF59606",75,26,63,0,0,37,63,63,"Pilot 7","Pilot 7: bigger feedback + text"
14,"SUPPRF59606",52,28,20,-12,0,46,20,32,"Pilot 7","Pilot 7: bigger feedback + text"
15,"SUPPRF59606",37,62,6,-52,-14,42,20,58,"Pilot 7","Pilot 7: bigger feedback + text"
16,"SUPPRF59606",55,29,41,-2,-13,43,54,43,"Pilot 7","Pilot 7: bigger feedback + text"
17,"SUPPRF59606",57,34,66,13,12,31,54,53,"Pilot 7","Pilot 7: bigger feedback + text"
18,"SUPPRF59606",74,14,80,23,0,69,80,57,"Pilot 7","Pilot 7: bigger feedback + text"
19,"SUPPRF59606",59,45,22,-16,-15,61,37,38,"Pilot 7","Pilot 7: bigger feedback + text"
20,"SUPPRF59606",31,56,35,-30,15,69,20,65,"Pilot 7","Pilot 7: bigger feedback + text"
21,"SUPPRF59606",61,41,70,19,-1,28,71,51,"Pilot 7","Pilot 7: bigger feedback + text"
22,"SUPPRF59606",59,38,55,-20,-16,76,71,75,"Pilot 7","Pilot 7: bigger feedback + text"
23,"SUPPRF59606",22,62,16,-37,-13,46,29,53,"Pilot 7","Pilot 7: bigger feedback + text"
24,"SUPPRF59606",56,35,65,14,19,39,46,51,"Pilot 7","Pilot 7: bigger feedback + text"
25,"SUPPRF59606",70,28,50,7,-13,21,63,43,"Pilot 7","Pilot 7: bigger feedback + text"
26,"SUPPRF59606",70,23,48,23,19,61,29,25,"Pilot 7","Pilot 7: bigger feedback + text"
27,"SUPPRF59606",57,30,37,-5,0,25,37,42,"Pilot 7","Pilot 7: bigger feedback + text"
28,"SUPPRF59606",42,54,56,-32,-15,78,71,88,"Pilot 7","Pilot 7: bigger feedback + text"
29,"SUPPRF59606",12,64,8,-12,-12,32,20,20,"Pilot 7","Pilot 7: bigger feedback + text"
30,"SUPPRF59606",49,53,51,10,14,40,37,41,"Pilot 7","Pilot 7: bigger feedback + text"
31,"SUPPRF59606",65,26,62,1,-1,43,63,61,"Pilot 7","Pilot 7: bigger feedback + text"
32,"SUPPRF59606",70,37,49,11,12,29,37,38,"Pilot 7","Pilot 7: bigger feedback + text"
33,"SUPPRF59606",25,61,38,-26,-16,34,54,64,"Pilot 7","Pilot 7: bigger feedback + text"
34,"SUPPRF59606",56,30,33,1,-13,19,46,32,"Pilot 7","Pilot 7: bigger feedback + text"
35,"SUPPRF59606",67,24,46,3,0,28,46,43,"Pilot 7","Pilot 7: bigger feedback + text"
36,"SUPPRF59606",57,49,24,-19,-13,30,37,43,"Pilot 7","Pilot 7: bigger feedback + text"
37,"SUPPRF59606",62,40,45,-10,-1,29,46,55,"Pilot 7","Pilot 7: bigger feedback + text"
38,"SUPPRF59606",68,22,55,-4,1,52,54,59,"Pilot 7","Pilot 7: bigger feedback + text"
39,"SUPPRF59606",85,29,83,12,12,76,71,71,"Pilot 7","Pilot 7: bigger feedback + text"
40,"SUPPRF59606",40,65,67,-18,-13,83,80,85,"Pilot 7","Pilot 7: bigger feedback + text"
41,"SUPPRF59606",36,60,47,-14,-16,35,63,61,"Pilot 7","Pilot 7: bigger feedback + text"
42,"SUPPRF59606",84,20,81,37,1,27,80,44,"Pilot 7","Pilot 7: bigger feedback + text"
43,"SUPPRF59606",15,77,29,-16,0,31,29,45,"Pilot 7","Pilot 7: bigger feedback + text"
44,"SUPPRF59606",10,84,19,-31,-1,21,20,50,"Pilot 7","Pilot 7: bigger feedback + text"
45,"SUPPRF59606",59,31,34,2,-12,30,46,32,"Pilot 7","Pilot 7: bigger feedback + text"
46,"SUPPRF59606",78,29,68,4,-12,27,80,64,"Pilot 7","Pilot 7: bigger feedback + text"
47,"SUPPRF59606",79,23,78,27,15,29,63,51,"Pilot 7","Pilot 7: bigger feedback + text"
48,"SUPPRF59606",49,16,28,-11,-1,21,29,39,"Pilot 7","Pilot 7: bigger feedback + text"
1,"SUPPRF37681",71,80,48,4,19,41,29,44,"Pilot 7","Pilot 7: bigger feedback + text"
2,"SUPPRF37681",46,48,58,-12,12,19,46,70,"Pilot 7","Pilot 7: bigger feedback + text"
3,"SUPPRF37681",75,78,46,-7,0,45,46,53,"Pilot 7","Pilot 7: bigger feedback + text"
4,"SUPPRF37681",78,31,55,-5,1,42,54,60,"Pilot 7","Pilot 7: bigger feedback + text"
5,"SUPPRF37681",78,33,54,-5,0,49,54,59,"Pilot 7","Pilot 7: bigger feedback + text"
6,"SUPPRF37681",71,46,66,40,12,34,54,26,"Pilot 7","Pilot 7: bigger feedback + text"
7,"SUPPRF37681",67,33,15,-34,-14,55,29,49,"Pilot 7","Pilot 7: bigger feedback + text"
8,"SUPPRF37681",82,22,33,-6,-13,0,46,39,"Pilot 7","Pilot 7: bigger feedback + text"
9,"SUPPRF37681",81,18,77,38,14,13,63,39,"Pilot 7","Pilot 7: bigger feedback + text"
10,"SUPPRF37681",62,23,19,-53,-1,21,20,72,"Pilot 7","Pilot 7: bigger feedback + text"
11,"SUPPRF37681",68,75,56,23,-15,46,71,33,"Pilot 7","Pilot 7: bigger feedback + text"
12,"SUPPRF37681",73,50,38,-33,-16,53,54,71,"Pilot 7","Pilot 7: bigger feedback + text"
13,"SUPPRF37681",56,39,62,-6,-1,53,63,68,"Pilot 7","Pilot 7: bigger feedback + text"
14,"SUPPRF37681",52,29,34,-24,-12,48,46,58,"Pilot 7","Pilot 7: bigger feedback + text"
15,"SUPPRF37681",70,36,37,-23,0,58,37,60,"Pilot 7","Pilot 7: bigger feedback + text"
16,"SUPPRF37681",63,17,63,20,0,20,63,43,"Pilot 7","Pilot 7: bigger feedback + text"
17,"SUPPRF37681",75,43,49,-8,12,76,37,57,"Pilot 7","Pilot 7: bigger feedback + text"
18,"SUPPRF37681",57,27,29,-34,0,47,29,63,"Pilot 7","Pilot 7: bigger feedback + text"
19,"SUPPRF37681",67,13,51,8,14,0,37,43,"Pilot 7","Pilot 7: bigger feedback + text"
20,"SUPPRF37681",7,19,8,-27,-12,31,20,35,"Pilot 7","Pilot 7: bigger feedback + text"
21,"SUPPRF37681",72,17,70,68,-1,65,71,2,"Pilot 7","Pilot 7: bigger feedback + text"
22,"SUPPRF37681",90,13,83,45,12,25,71,38,"Pilot 7","Pilot 7: bigger feedback + text"
23,"SUPPRF37681",80,13,80,39,0,2,80,41,"Pilot 7","Pilot 7: bigger feedback + text"
24,"SUPPRF37681",69,37,24,-2,-13,75,37,26,"Pilot 7","Pilot 7: bigger feedback + text"
25,"SUPPRF37681",76,17,96,61,16,13,80,35,"Pilot 7","Pilot 7: bigger feedback + text"
26,"SUPPRF37681",79,12,46,34,17,90,29,12,"Pilot 7","Pilot 7: bigger feedback + text"
27,"SUPPRF37681",61,23,67,41,-13,19,80,26,"Pilot 7","Pilot 7: bigger feedback + text"
28,"SUPPRF37681",79,23,37,5,17,15,20,32,"Pilot 7","Pilot 7: bigger feedback + text"
29,"SUPPRF37681",83,12,97,73,17,54,80,24,"Pilot 7","Pilot 7: bigger feedback + text"
30,"SUPPRF37681",85,9,41,22,-13,16,54,19,"Pilot 7","Pilot 7: bigger feedback + text"
31,"SUPPRF37681",85,9,68,-16,14,64,54,84,"Pilot 7","Pilot 7: bigger feedback + text"
32,"SUPPRF37681",76,9,55,-5,-16,50,71,60,"Pilot 7","Pilot 7: bigger feedback + text"
33,"SUPPRF37681",84,18,47,34,-16,73,63,13,"Pilot 7","Pilot 7: bigger feedback + text"
34,"SUPPRF37681",13,31,22,-6,-15,21,37,28,"Pilot 7","Pilot 7: bigger feedback + text"
35,"SUPPRF37681",72,79,68,53,-12,4,80,15,"Pilot 7","Pilot 7: bigger feedback + text"
36,"SUPPRF37681",20,36,28,6,-1,7,29,22,"Pilot 7","Pilot 7: bigger feedback + text"
37,"SUPPRF37681",77,8,20,3,0,98,20,17,"Pilot 7","Pilot 7: bigger feedback + text"
38,"SUPPRF37681",10,45,78,56,15,15,63,22,"Pilot 7","Pilot 7: bigger feedback + text"
39,"SUPPRF37681",79,22,71,51,0,0,71,20,"Pilot 7","Pilot 7: bigger feedback + text"
40,"SUPPRF37681",83,30,35,12,15,9,20,23,"Pilot 7","Pilot 7: bigger feedback + text"
41,"SUPPRF37681",94,13,65,43,19,1,46,22,"Pilot 7","Pilot 7: bigger feedback + text"
42,"SUPPRF37681",87,27,50,-2,-13,25,63,52,"Pilot 7","Pilot 7: bigger feedback + text"
43,"SUPPRF37681",50,7,81,73,1,8,80,8,"Pilot 7","Pilot 7: bigger feedback + text"
44,"SUPPRF37681",27,3,16,12,-13,78,29,4,"Pilot 7","Pilot 7: bigger feedback + text"
45,"SUPPRF37681",74,8,45,8,-1,8,46,37,"Pilot 7","Pilot 7: bigger feedback + text"
46,"SUPPRF37681",92,8,6,-10,-14,5,20,16,"Pilot 7","Pilot 7: bigger feedback + text"
47,"SUPPRF37681",89,13,84,64,13,11,71,20,"Pilot 7","Pilot 7: bigger feedback + text"
48,"SUPPRF37681",71,10,38,28,1,5,37,10,"Pilot 7","Pilot 7: bigger feedback + text"
1,"SUPPRF11139",31,65,29,-15,0,18,29,44,"Pilot 7","Pilot 7: bigger feedback + text"
2,"SUPPRF11139",84,59,96,30,16,52,80,66,"Pilot 7","Pilot 7: bigger feedback + text"
3,"SUPPRF11139",41,58,67,-17,-13,53,80,84,"Pilot 7","Pilot 7: bigger feedback + text"
4,"SUPPRF11139",48,74,20,1,0,30,20,19,"Pilot 7","Pilot 7: bigger feedback + text"
5,"SUPPRF11139",24,86,24,-24,-13,29,37,48,"Pilot 7","Pilot 7: bigger feedback + text"
6,"SUPPRF11139",65,57,56,10,-15,31,71,46,"Pilot 7","Pilot 7: bigger feedback + text"
7,"SUPPRF11139",57,47,49,11,12,52,37,38,"Pilot 7","Pilot 7: bigger feedback + text"
8,"SUPPRF11139",20,57,28,-11,-1,52,29,39,"Pilot 7","Pilot 7: bigger feedback + text"
9,"SUPPRF11139",50,54,46,18,17,49,29,28,"Pilot 7","Pilot 7: bigger feedback + text"
10,"SUPPRF11139",42,79,16,-11,-13,27,29,27,"Pilot 7","Pilot 7: bigger feedback + text"
11,"SUPPRF11139",58,43,68,7,14,52,54,61,"Pilot 7","Pilot 7: bigger feedback + text"
12,"SUPPRF11139",45,50,47,-18,-16,34,63,65,"Pilot 7","Pilot 7: bigger feedback + text"
13,"SUPPRF11139",42,57,51,14,14,44,37,37,"Pilot 7","Pilot 7: bigger feedback + text"
14,"SUPPRF11139",37,52,66,24,12,45,54,42,"Pilot 7","Pilot 7: bigger feedback + text"
15,"SUPPRF11139",61,48,78,28,15,42,63,50,"Pilot 7","Pilot 7: bigger feedback + text"
16,"SUPPRF11139",59,63,54,-5,0,42,54,59,"Pilot 7","Pilot 7: bigger feedback + text"
17,"SUPPRF11139",78,62,80,13,0,27,80,67,"Pilot 7","Pilot 7: bigger feedback + text"
18,"SUPPRF11139",43,50,46,-11,0,49,46,57,"Pilot 7","Pilot 7: bigger feedback + text"
19,"SUPPRF11139",64,63,71,20,0,33,71,51,"Pilot 7","Pilot 7: bigger feedback + text"
20,"SUPPRF11139",51,57,63,10,0,38,63,53,"Pilot 7","Pilot 7: bigger feedback + text"
21,"SUPPRF11139",68,56,55,-5,1,42,54,60,"Pilot 7","Pilot 7: bigger feedback + text"
22,"SUPPRF11139",52,37,41,-9,-13,35,54,50,"Pilot 7","Pilot 7: bigger feedback + text"
23,"SUPPRF11139",21,63,33,-9,-13,63,46,42,"Pilot 7","Pilot 7: bigger feedback + text"
24,"SUPPRF11139",8,63,8,-2,-12,63,20,10,"Pilot 7","Pilot 7: bigger feedback + text"
25,"SUPPRF11139",51,48,70,2,-1,37,71,68,"Pilot 7","Pilot 7: bigger feedback + text"
26,"SUPPRF11139",19,69,55,-20,-16,55,71,75,"Pilot 7","Pilot 7: bigger feedback + text"
27,"SUPPRF11139",60,32,81,5,1,57,80,76,"Pilot 7","Pilot 7: bigger feedback + text"
28,"SUPPRF11139",36,56,50,-5,-13,27,63,55,"Pilot 7","Pilot 7: bigger feedback + text"
29,"SUPPRF11139",59,47,77,24,14,66,63,53,"Pilot 7","Pilot 7: bigger feedback + text"
30,"SUPPRF11139",59,51,62,-7,-1,49,63,69,"Pilot 7","Pilot 7: bigger feedback + text"
31,"SUPPRF11139",47,62,97,30,17,48,80,67,"Pilot 7","Pilot 7: bigger feedback + text"
32,"SUPPRF11139",7,77,38,-27,1,13,37,65,"Pilot 7","Pilot 7: bigger feedback + text"
33,"SUPPRF11139",42,54,45,14,-1,27,46,31,"Pilot 7","Pilot 7: bigger feedback + text"
34,"SUPPRF11139",0,88,6,-19,-14,54,20,25,"Pilot 7","Pilot 7: bigger feedback + text"
35,"SUPPRF11139",59,39,48,28,19,37,29,20,"Pilot 7","Pilot 7: bigger feedback + text"
36,"SUPPRF11139",55,46,35,18,15,16,20,17,"Pilot 7","Pilot 7: bigger feedback + text"
37,"SUPPRF11139",54,62,19,1,-1,39,20,18,"Pilot 7","Pilot 7: bigger feedback + text"
38,"SUPPRF11139",54,43,83,8,12,48,71,75,"Pilot 7","Pilot 7: bigger feedback + text"
39,"SUPPRF11139",52,63,37,17,17,18,20,20,"Pilot 7","Pilot 7: bigger feedback + text"
40,"SUPPRF11139",48,56,34,4,-12,15,46,30,"Pilot 7","Pilot 7: bigger feedback + text"
41,"SUPPRF11139",53,31,84,11,13,45,71,73,"Pilot 7","Pilot 7: bigger feedback + text"
42,"SUPPRF11139",53,67,65,24,19,17,46,41,"Pilot 7","Pilot 7: bigger feedback + text"
43,"SUPPRF11139",29,61,38,-17,-16,51,54,55,"Pilot 7","Pilot 7: bigger feedback + text"
44,"SUPPRF11139",32,70,22,-24,-15,30,37,46,"Pilot 7","Pilot 7: bigger feedback + text"
45,"SUPPRF11139",40,49,58,9,12,28,46,49,"Pilot 7","Pilot 7: bigger feedback + text"
46,"SUPPRF11139",39,34,68,-4,-12,36,80,72,"Pilot 7","Pilot 7: bigger feedback + text"
47,"SUPPRF11139",53,45,37,-9,0,38,37,46,"Pilot 7","Pilot 7: bigger feedback + text"
48,"SUPPRF11139",30,44,15,2,-14,34,29,13,"Pilot 7","Pilot 7: bigger feedback + text"
1,"SUPPRF01788",15,68,55,-2,-16,67,71,57,"Pilot 7","Pilot 7: bigger feedback + text"
2,"SUPPRF01788",35,58,46,20,17,79,29,26,"Pilot 7","Pilot 7: bigger feedback + text"
3,"SUPPRF01788",30,63,29,-12,0,83,29,41,"Pilot 7","Pilot 7: bigger feedback + text"
4,"SUPPRF01788",27,64,56,35,-15,12,71,21,"Pilot 7","Pilot 7: bigger feedback + text"
5,"SUPPRF01788",16,73,15,-14,-14,74,29,29,"Pilot 7","Pilot 7: bigger feedback + text"
6,"SUPPRF01788",33,57,62,9,-1,65,63,53,"Pilot 7","Pilot 7: bigger feedback + text"
7,"SUPPRF01788",35,65,84,24,13,64,71,60,"Pilot 7","Pilot 7: bigger feedback + text"
8,"SUPPRF01788",29,55,68,0,-12,73,80,68,"Pilot 7","Pilot 7: bigger feedback + text"
9,"SUPPRF01788",35,56,41,-12,-13,65,54,53,"Pilot 7","Pilot 7: bigger feedback + text"
10,"SUPPRF01788",34,52,63,30,0,52,63,33,"Pilot 7","Pilot 7: bigger feedback + text"
11,"SUPPRF01788",30,48,67,-1,-13,81,80,68,"Pilot 7","Pilot 7: bigger feedback + text"
12,"SUPPRF01788",26,59,38,-24,-16,89,54,62,"Pilot 7","Pilot 7: bigger feedback + text"
13,"SUPPRF01788",11,66,6,-9,-14,91,20,15,"Pilot 7","Pilot 7: bigger feedback + text"
14,"SUPPRF01788",31,70,49,17,12,74,37,32,"Pilot 7","Pilot 7: bigger feedback + text"
15,"SUPPRF01788",34,51,48,13,19,21,29,35,"Pilot 7","Pilot 7: bigger feedback + text"
16,"SUPPRF01788",27,42,70,8,-1,69,71,62,"Pilot 7","Pilot 7: bigger feedback + text"
17,"SUPPRF01788",24,43,80,25,0,25,80,55,"Pilot 7","Pilot 7: bigger feedback + text"
18,"SUPPRF01788",39,55,83,31,12,58,71,52,"Pilot 7","Pilot 7: bigger feedback + text"
19,"SUPPRF01788",41,47,19,12,-1,94,20,7,"Pilot 7","Pilot 7: bigger feedback + text"
20,"SUPPRF01788",23,41,22,-11,-15,75,37,33,"Pilot 7","Pilot 7: bigger feedback + text"
21,"SUPPRF01788",41,48,50,10,-13,69,63,40,"Pilot 7","Pilot 7: bigger feedback + text"
22,"SUPPRF01788",31,61,16,-21,-13,69,29,37,"Pilot 7","Pilot 7: bigger feedback + text"
23,"SUPPRF01788",40,41,78,41,15,57,63,37,"Pilot 7","Pilot 7: bigger feedback + text"
24,"SUPPRF01788",26,65,24,-14,-13,83,37,38,"Pilot 7","Pilot 7: bigger feedback + text"
25,"SUPPRF01788",35,35,65,30,19,71,46,35,"Pilot 7","Pilot 7: bigger feedback + text"
26,"SUPPRF01788",31,65,34,-9,-12,76,46,43,"Pilot 7","Pilot 7: bigger feedback + text"
27,"SUPPRF01788",25,40,81,7,1,89,80,74,"Pilot 7","Pilot 7: bigger feedback + text"
28,"SUPPRF01788",27,62,46,-12,0,81,46,58,"Pilot 7","Pilot 7: bigger feedback + text"
29,"SUPPRF01788",10,66,28,-4,-1,73,29,32,"Pilot 7","Pilot 7: bigger feedback + text"
30,"SUPPRF01788",31,56,71,18,0,79,71,53,"Pilot 7","Pilot 7: bigger feedback + text"
31,"SUPPRF01788",29,61,47,2,-16,64,63,45,"Pilot 7","Pilot 7: bigger feedback + text"
32,"SUPPRF01788",34,54,58,6,12,63,46,52,"Pilot 7","Pilot 7: bigger feedback + text"
33,"SUPPRF01788",35,61,33,-21,-13,60,46,54,"Pilot 7","Pilot 7: bigger feedback + text"
34,"SUPPRF01788",45,56,77,37,14,58,63,40,"Pilot 7","Pilot 7: bigger feedback + text"
35,"SUPPRF01788",44,63,55,22,1,28,54,33,"Pilot 7","Pilot 7: bigger feedback + text"
36,"SUPPRF01788",39,63,45,-8,-1,58,46,53,"Pilot 7","Pilot 7: bigger feedback + text"
37,"SUPPRF01788",42,70,35,27,15,86,20,8,"Pilot 7","Pilot 7: bigger feedback + text"
38,"SUPPRF01788",34,59,66,18,12,58,54,48,"Pilot 7","Pilot 7: bigger feedback + text"
39,"SUPPRF01788",36,51,68,23,14,70,54,45,"Pilot 7","Pilot 7: bigger feedback + text"
40,"SUPPRF01788",42,56,51,39,14,4,37,12,"Pilot 7","Pilot 7: bigger feedback + text"
41,"SUPPRF01788",42,62,96,25,16,73,80,71,"Pilot 7","Pilot 7: bigger feedback + text"
42,"SUPPRF01788",35,58,38,-2,1,64,37,40,"Pilot 7","Pilot 7: bigger feedback + text"
43,"SUPPRF01788",31,58,97,16,17,70,80,81,"Pilot 7","Pilot 7: bigger feedback + text"
44,"SUPPRF01788",36,59,37,4,0,71,37,33,"Pilot 7","Pilot 7: bigger feedback + text"
45,"SUPPRF01788",36,58,8,-2,-12,74,20,10,"Pilot 7","Pilot 7: bigger feedback + text"
46,"SUPPRF01788",43,58,37,31,17,79,20,6,"Pilot 7","Pilot 7: bigger feedback + text"
47,"SUPPRF01788",37,60,54,21,0,23,54,33,"Pilot 7","Pilot 7: bigger feedback + text"
48,"SUPPRF01788",36,52,20,4,0,64,20,16,"Pilot 7","Pilot 7: bigger feedback + text"
1,"SUPPRF93027",51,12,8,-18,-12,29,20,26,"Pilot 7","Pilot 7: bigger feedback + text"
2,"SUPPRF93027",58,14,46,15,17,25,29,31,"Pilot 7","Pilot 7: bigger feedback + text"
3,"SUPPRF93027",64,12,38,5,1,13,37,33,"Pilot 7","Pilot 7: bigger feedback + text"
4,"SUPPRF93027",14,61,15,-36,-14,20,29,51,"Pilot 7","Pilot 7: bigger feedback + text"
5,"SUPPRF93027",63,7,22,-17,-15,26,37,39,"Pilot 7","Pilot 7: bigger feedback + text"
6,"SUPPRF93027",66,11,28,-10,-1,15,29,38,"Pilot 7","Pilot 7: bigger feedback + text"
7,"SUPPRF93027",62,11,70,-3,-1,10,71,73,"Pilot 7","Pilot 7: bigger feedback + text"
8,"SUPPRF93027",64,7,83,16,12,9,71,67,"Pilot 7","Pilot 7: bigger feedback + text"
9,"SUPPRF93027",61,10,54,8,0,12,54,46,"Pilot 7","Pilot 7: bigger feedback + text"
10,"SUPPRF93027",61,8,47,-8,-16,17,63,55,"Pilot 7","Pilot 7: bigger feedback + text"
11,"SUPPRF93027",69,8,66,17,12,8,54,49,"Pilot 7","Pilot 7: bigger feedback + text"
12,"SUPPRF93027",60,21,80,32,0,10,80,48,"Pilot 7","Pilot 7: bigger feedback + text"
13,"SUPPRF93027",65,22,84,4,13,25,71,80,"Pilot 7","Pilot 7: bigger feedback + text"
14,"SUPPRF93027",59,20,45,-3,-1,26,46,48,"Pilot 7","Pilot 7: bigger feedback + text"
15,"SUPPRF93027",61,20,16,-12,-13,27,29,28,"Pilot 7","Pilot 7: bigger feedback + text"
16,"SUPPRF93027",66,21,77,14,14,30,63,63,"Pilot 7","Pilot 7: bigger feedback + text"
17,"SUPPRF93027",68,25,29,-7,0,23,29,36,"Pilot 7","Pilot 7: bigger feedback + text"
18,"SUPPRF93027",62,25,33,0,-13,23,46,33,"Pilot 7","Pilot 7: bigger feedback + text"
19,"SUPPRF93027",60,25,49,18,12,19,37,31,"Pilot 7","Pilot 7: bigger feedback + text"
20,"SUPPRF93027",66,21,78,12,15,20,63,66,"Pilot 7","Pilot 7: bigger feedback + text"
21,"SUPPRF93027",52,21,55,-13,-16,14,71,68,"Pilot 7","Pilot 7: bigger feedback + text"
22,"SUPPRF93027",62,28,71,7,0,32,71,64,"Pilot 7","Pilot 7: bigger feedback + text"
23,"SUPPRF93027",65,35,65,21,19,27,46,44,"Pilot 7","Pilot 7: bigger feedback + text"
24,"SUPPRF93027",65,24,68,12,14,38,54,56,"Pilot 7","Pilot 7: bigger feedback + text"
25,"SUPPRF93027",65,20,81,-2,1,22,80,83,"Pilot 7","Pilot 7: bigger feedback + text"
26,"SUPPRF93027",68,22,63,0,0,27,63,63,"Pilot 7","Pilot 7: bigger feedback + text"
27,"SUPPRF93027",63,24,37,-9,0,23,37,46,"Pilot 7","Pilot 7: bigger feedback + text"
28,"SUPPRF93027",61,37,96,18,16,20,80,78,"Pilot 7","Pilot 7: bigger feedback + text"
29,"SUPPRF93027",57,27,24,-13,-13,18,37,37,"Pilot 7","Pilot 7: bigger feedback + text"
30,"SUPPRF93027",60,35,48,22,19,15,29,26,"Pilot 7","Pilot 7: bigger feedback + text"
31,"SUPPRF93027",68,23,20,-5,0,11,20,25,"Pilot 7","Pilot 7: bigger feedback + text"
32,"SUPPRF93027",69,26,97,18,17,21,80,79,"Pilot 7","Pilot 7: bigger feedback + text"
33,"SUPPRF93027",56,23,50,-11,-13,18,63,61,"Pilot 7","Pilot 7: bigger feedback + text"
34,"SUPPRF93027",58,36,38,-22,-16,25,54,60,"Pilot 7","Pilot 7: bigger feedback + text"
35,"SUPPRF93027",67,26,46,-2,0,18,46,48,"Pilot 7","Pilot 7: bigger feedback + text"
36,"SUPPRF93027",62,29,58,11,12,17,46,47,"Pilot 7","Pilot 7: bigger feedback + text"
37,"SUPPRF93027",54,29,67,-22,-13,22,80,89,"Pilot 7","Pilot 7: bigger feedback + text"
38,"SUPPRF93027",57,21,68,-11,-12,28,80,79,"Pilot 7","Pilot 7: bigger feedback + text"
39,"SUPPRF93027",62,26,35,9,15,16,20,26,"Pilot 7","Pilot 7: bigger feedback + text"
40,"SUPPRF93027",66,21,51,9,14,21,37,42,"Pilot 7","Pilot 7: bigger feedback + text"
41,"SUPPRF93027",61,22,34,-15,-12,19,46,49,"Pilot 7","Pilot 7: bigger feedback + text"
42,"SUPPRF93027",67,22,37,12,17,20,20,25,"Pilot 7","Pilot 7: bigger feedback + text"
43,"SUPPRF93027",66,30,62,5,-1,20,63,57,"Pilot 7","Pilot 7: bigger feedback + text"
44,"SUPPRF93027",61,31,55,3,1,12,54,52,"Pilot 7","Pilot 7: bigger feedback + text"
45,"SUPPRF93027",61,26,56,-6,-15,28,71,62,"Pilot 7","Pilot 7: bigger feedback + text"
46,"SUPPRF93027",63,26,6,-21,-14,17,20,27,"Pilot 7","Pilot 7: bigger feedback + text"
47,"SUPPRF93027",70,23,41,-8,-13,12,54,49,"Pilot 7","Pilot 7: bigger feedback + text"
48,"SUPPRF93027",59,17,19,3,-1,13,20,16,"Pilot 7","Pilot 7: bigger feedback + text"
1,"SUPPRF97235",48,70,68,-12,-12,63,80,80,"Pilot 7","Pilot 7: bigger feedback + text"
2,"SUPPRF97235",58,58,49,15,12,54,37,34,"Pilot 7","Pilot 7: bigger feedback + text"
3,"SUPPRF97235",51,58,33,-10,-13,59,46,43,"Pilot 7","Pilot 7: bigger feedback + text"
4,"SUPPRF97235",50,45,37,13,17,41,20,24,"Pilot 7","Pilot 7: bigger feedback + text"
5,"SUPPRF97235",49,48,63,17,0,42,63,46,"Pilot 7","Pilot 7: bigger feedback + text"
6,"SUPPRF97235",49,44,62,9,-1,27,63,53,"Pilot 7","Pilot 7: bigger feedback + text"
7,"SUPPRF97235",49,49,16,-16,-13,27,29,32,"Pilot 7","Pilot 7: bigger feedback + text"
8,"SUPPRF97235",50,32,70,-6,-1,64,71,76,"Pilot 7","Pilot 7: bigger feedback + text"
9,"SUPPRF97235",52,29,45,-11,-1,11,46,56,"Pilot 7","Pilot 7: bigger feedback + text"
10,"SUPPRF97235",57,21,78,14,15,44,63,64,"Pilot 7","Pilot 7: bigger feedback + text"
11,"SUPPRF97235",50,23,38,-19,-16,48,54,57,"Pilot 7","Pilot 7: bigger feedback + text"
12,"SUPPRF97235",50,49,84,24,13,57,71,60,"Pilot 7","Pilot 7: bigger feedback + text"
13,"SUPPRF97235",48,21,19,-2,-1,72,20,21,"Pilot 7","Pilot 7: bigger feedback + text"
14,"SUPPRF97235",51,15,77,-2,14,25,63,79,"Pilot 7","Pilot 7: bigger feedback + text"
15,"SUPPRF97235",48,17,41,-24,-13,61,54,65,"Pilot 7","Pilot 7: bigger feedback + text"
16,"SUPPRF97235",51,19,55,4,1,39,54,51,"Pilot 7","Pilot 7: bigger feedback + text"
17,"SUPPRF97235",48,12,46,-4,0,32,46,50,"Pilot 7","Pilot 7: bigger feedback + text"
18,"SUPPRF97235",52,15,80,-6,0,36,80,86,"Pilot 7","Pilot 7: bigger feedback + text"
19,"SUPPRF97235",53,14,68,23,14,27,54,45,"Pilot 7","Pilot 7: bigger feedback + text"
20,"SUPPRF97235",48,13,51,9,14,27,37,42,"Pilot 7","Pilot 7: bigger feedback + text"
21,"SUPPRF97235",51,17,47,-7,-16,39,63,54,"Pilot 7","Pilot 7: bigger feedback + text"
22,"SUPPRF97235",47,14,20,9,0,47,20,11,"Pilot 7","Pilot 7: bigger feedback + text"
23,"SUPPRF97235",42,17,38,-15,1,33,37,53,"Pilot 7","Pilot 7: bigger feedback + text"
24,"SUPPRF97235",43,27,24,-7,-13,42,37,31,"Pilot 7","Pilot 7: bigger feedback + text"
25,"SUPPRF97235",45,19,67,-11,-13,53,80,78,"Pilot 7","Pilot 7: bigger feedback + text"
26,"SUPPRF97235",42,21,96,23,16,28,80,73,"Pilot 7","Pilot 7: bigger feedback + text"
27,"SUPPRF97235",42,19,35,15,15,34,20,20,"Pilot 7","Pilot 7: bigger feedback + text"
28,"SUPPRF97235",43,11,58,27,12,40,46,31,"Pilot 7","Pilot 7: bigger feedback + text"
29,"SUPPRF97235",45,22,29,4,0,32,29,25,"Pilot 7","Pilot 7: bigger feedback + text"
30,"SUPPRF97235",43,22,97,12,17,48,80,85,"Pilot 7","Pilot 7: bigger feedback + text"
31,"SUPPRF97235",45,30,56,-2,-15,41,71,58,"Pilot 7","Pilot 7: bigger feedback + text"
32,"SUPPRF97235",42,29,54,-2,0,38,54,56,"Pilot 7","Pilot 7: bigger feedback + text"
33,"SUPPRF97235",46,25,46,25,17,50,29,21,"Pilot 7","Pilot 7: bigger feedback + text"
34,"SUPPRF97235",42,32,71,33,0,37,71,38,"Pilot 7","Pilot 7: bigger feedback + text"
35,"SUPPRF97235",39,29,55,-17,-16,59,71,72,"Pilot 7","Pilot 7: bigger feedback + text"
36,"SUPPRF97235",50,25,15,0,-14,46,29,15,"Pilot 7","Pilot 7: bigger feedback + text"
37,"SUPPRF97235",39,25,28,16,-1,46,29,12,"Pilot 7","Pilot 7: bigger feedback + text"
38,"SUPPRF97235",42,30,8,-9,-12,39,20,17,"Pilot 7","Pilot 7: bigger feedback + text"
39,"SUPPRF97235",34,22,6,-16,-14,41,20,22,"Pilot 7","Pilot 7: bigger feedback + text"
40,"SUPPRF97235",42,28,65,12,19,30,46,53,"Pilot 7","Pilot 7: bigger feedback + text"
41,"SUPPRF97235",40,25,37,-15,0,33,37,52,"Pilot 7","Pilot 7: bigger feedback + text"
42,"SUPPRF97235",40,23,48,26,19,27,29,22,"Pilot 7","Pilot 7: bigger feedback + text"
43,"SUPPRF97235",42,24,66,17,12,27,54,49,"Pilot 7","Pilot 7: bigger feedback + text"
44,"SUPPRF97235",40,25,34,-2,-12,18,46,36,"Pilot 7","Pilot 7: bigger feedback + text"
45,"SUPPRF97235",42,23,50,-9,-13,31,63,59,"Pilot 7","Pilot 7: bigger feedback + text"
46,"SUPPRF97235",37,16,22,-10,-15,35,37,32,"Pilot 7","Pilot 7: bigger feedback + text"
47,"SUPPRF97235",42,21,81,-5,1,66,80,86,"Pilot 7","Pilot 7: bigger feedback + text"
48,"SUPPRF97235",42,23,83,8,12,53,71,75,"Pilot 7","Pilot 7: bigger feedback + text"
1,"SUPPRF43235",74,13,65,22,19,64,46,43,"Pilot 7","Pilot 7: bigger feedback + text"
2,"SUPPRF43235",66,5,37,7,17,67,20,30,"Pilot 7","Pilot 7: bigger feedback + text"
3,"SUPPRF43235",81,1,34,-10,-12,53,46,44,"Pilot 7","Pilot 7: bigger feedback + text"
4,"SUPPRF43235",80,3,38,19,1,54,37,19,"Pilot 7","Pilot 7: bigger feedback + text"
5,"SUPPRF43235",78,1,20,-5,0,56,20,25,"Pilot 7","Pilot 7: bigger feedback + text"
6,"SUPPRF43235",84,4,48,13,19,59,29,35,"Pilot 7","Pilot 7: bigger feedback + text"
7,"SUPPRF43235",85,5,55,16,1,62,54,39,"Pilot 7","Pilot 7: bigger feedback + text"
8,"SUPPRF43235",75,1,70,16,-1,58,71,54,"Pilot 7","Pilot 7: bigger feedback + text"
9,"SUPPRF43235",76,2,56,7,-15,54,71,49,"Pilot 7","Pilot 7: bigger feedback + text"
10,"SUPPRF43235",75,1,49,-3,12,51,37,52,"Pilot 7","Pilot 7: bigger feedback + text"
11,"SUPPRF43235",66,6,41,-5,-13,56,54,46,"Pilot 7","Pilot 7: bigger feedback + text"
12,"SUPPRF43235",91,7,71,33,0,50,71,38,"Pilot 7","Pilot 7: bigger feedback + text"
13,"SUPPRF43235",82,4,29,6,0,56,29,23,"Pilot 7","Pilot 7: bigger feedback + text"
14,"SUPPRF43235",89,3,80,41,0,55,80,39,"Pilot 7","Pilot 7: bigger feedback + text"
15,"SUPPRF43235",96,0,51,28,14,49,37,23,"Pilot 7","Pilot 7: bigger feedback + text"
16,"SUPPRF43235",94,6,66,28,12,59,54,38,"Pilot 7","Pilot 7: bigger feedback + text"
17,"SUPPRF43235",90,4,28,-2,-1,55,29,30,"Pilot 7","Pilot 7: bigger feedback + text"
18,"SUPPRF43235",97,3,84,78,13,62,71,6,"Pilot 7","Pilot 7: bigger feedback + text"
19,"SUPPRF43235",82,6,83,41,12,65,71,42,"Pilot 7","Pilot 7: bigger feedback + text"
20,"SUPPRF43235",93,5,54,42,0,66,54,12,"Pilot 7","Pilot 7: bigger feedback + text"
21,"SUPPRF43235",88,6,15,14,-14,74,29,1,"Pilot 7","Pilot 7: bigger feedback + text"
22,"SUPPRF43235",95,4,97,96,17,64,80,1,"Pilot 7","Pilot 7: bigger feedback + text"
23,"SUPPRF43235",95,2,81,44,1,66,80,37,"Pilot 7","Pilot 7: bigger feedback + text"
24,"SUPPRF43235",91,9,67,27,-13,66,80,40,"Pilot 7","Pilot 7: bigger feedback + text"
25,"SUPPRF43235",93,7,38,-7,-16,50,54,45,"Pilot 7","Pilot 7: bigger feedback + text"
26,"SUPPRF43235",82,9,6,-8,-14,54,20,14,"Pilot 7","Pilot 7: bigger feedback + text"
27,"SUPPRF43235",93,10,55,9,-16,48,71,46,"Pilot 7","Pilot 7: bigger feedback + text"
28,"SUPPRF43235",88,11,96,65,16,28,80,31,"Pilot 7","Pilot 7: bigger feedback + text"
29,"SUPPRF43235",75,5,77,52,14,39,63,25,"Pilot 7","Pilot 7: bigger feedback + text"
30,"SUPPRF43235",91,8,37,12,0,40,37,25,"Pilot 7","Pilot 7: bigger feedback + text"
31,"SUPPRF43235",95,7,62,34,-1,23,63,28,"Pilot 7","Pilot 7: bigger feedback + text"
32,"SUPPRF43235",96,6,47,21,-16,20,63,26,"Pilot 7","Pilot 7: bigger feedback + text"
33,"SUPPRF43235",94,10,46,24,17,16,29,22,"Pilot 7","Pilot 7: bigger feedback + text"
34,"SUPPRF43235",91,9,58,35,12,20,46,23,"Pilot 7","Pilot 7: bigger feedback + text"
35,"SUPPRF43235",76,10,63,29,0,26,63,34,"Pilot 7","Pilot 7: bigger feedback + text"
36,"SUPPRF43235",95,5,8,-16,-12,25,20,24,"Pilot 7","Pilot 7: bigger feedback + text"
1,"SUPPRF06488",79,17,48,19,19,79,29,29,"Pilot 7","Pilot 7: bigger feedback + text"
2,"SUPPRF06488",83,14,34,5,-12,81,46,29,"Pilot 7","Pilot 7: bigger feedback + text"
3,"SUPPRF06488",47,27,20,-21,0,92,20,41,"Pilot 7","Pilot 7: bigger feedback + text"
4,"SUPPRF06488",45,27,8,-13,-12,97,20,21,"Pilot 7","Pilot 7: bigger feedback + text"
5,"SUPPRF06488",58,27,37,24,17,99,20,13,"Pilot 7","Pilot 7: bigger feedback + text"
6,"SUPPRF06488",72,16,77,15,14,84,63,62,"Pilot 7","Pilot 7: bigger feedback + text"
7,"SUPPRF06488",85,19,78,-4,15,83,63,82,"Pilot 7","Pilot 7: bigger feedback + text"
8,"SUPPRF06488",80,20,56,-12,-15,90,71,68,"Pilot 7","Pilot 7: bigger feedback + text"
9,"SUPPRF06488",47,23,41,-18,-13,77,54,59,"Pilot 7","Pilot 7: bigger feedback + text"
10,"SUPPRF06488",75,22,84,27,13,55,71,57,"Pilot 7","Pilot 7: bigger feedback + text"
11,"SUPPRF06488",76,27,45,-4,-1,87,46,49,"Pilot 7","Pilot 7: bigger feedback + text"
12,"SUPPRF06488",92,13,71,3,0,88,71,68,"Pilot 7","Pilot 7: bigger feedback + text"
13,"SUPPRF06488",76,25,38,-6,1,82,37,44,"Pilot 7","Pilot 7: bigger feedback + text"
14,"SUPPRF06488",97,13,97,13,17,99,80,84,"Pilot 7","Pilot 7: bigger feedback + text"
15,"SUPPRF06488",65,12,19,10,-1,99,20,9,"Pilot 7","Pilot 7: bigger feedback + text"
16,"SUPPRF06488",82,14,51,15,14,83,37,36,"Pilot 7","Pilot 7: bigger feedback + text"
17,"SUPPRF06488",42,29,22,-20,-15,96,37,42,"Pilot 7","Pilot 7: bigger feedback + text"
18,"SUPPRF06488",63,20,33,1,-13,90,46,32,"Pilot 7","Pilot 7: bigger feedback + text"
19,"SUPPRF06488",59,40,6,-9,-14,91,20,15,"Pilot 7","Pilot 7: bigger feedback + text"
20,"SUPPRF06488",45,53,67,-15,-13,96,80,82,"Pilot 7","Pilot 7: bigger feedback + text"
21,"SUPPRF06488",66,34,55,5,1,77,54,50,"Pilot 7","Pilot 7: bigger feedback + text"
22,"SUPPRF06488",77,16,62,3,-1,71,63,59,"Pilot 7","Pilot 7: bigger feedback + text"
23,"SUPPRF06488",87,20,96,28,16,35,80,68,"Pilot 7","Pilot 7: bigger feedback + text"
24,"SUPPRF06488",73,20,58,10,12,62,46,48,"Pilot 7","Pilot 7: bigger feedback + text"
25,"SUPPRF06488",69,31,68,14,14,87,54,54,"Pilot 7","Pilot 7: bigger feedback + text"
26,"SUPPRF06488",33,61,24,-24,-13,74,37,48,"Pilot 7","Pilot 7: bigger feedback + text"
27,"SUPPRF06488",74,33,35,24,15,86,20,11,"Pilot 7","Pilot 7: bigger feedback + text"
28,"SUPPRF06488",81,16,46,2,0,80,46,44,"Pilot 7","Pilot 7: bigger feedback + text"
29,"SUPPRF06488",67,33,28,8,-1,47,29,20,"Pilot 7","Pilot 7: bigger feedback + text"
30,"SUPPRF06488",69,22,37,-3,0,58,37,40,"Pilot 7","Pilot 7: bigger feedback + text"
31,"SUPPRF06488",85,10,49,16,12,87,37,33,"Pilot 7","Pilot 7: bigger feedback + text"
32,"SUPPRF06488",75,21,29,-5,0,80,29,34,"Pilot 7","Pilot 7: bigger feedback + text"
33,"SUPPRF06488",89,12,46,22,17,76,29,24,"Pilot 7","Pilot 7: bigger feedback + text"
34,"SUPPRF06488",37,56,47,-17,-16,77,63,64,"Pilot 7","Pilot 7: bigger feedback + text"
35,"SUPPRF06488",65,33,68,-5,-12,54,80,73,"Pilot 7","Pilot 7: bigger feedback + text"
36,"SUPPRF06488",81,19,81,5,1,50,80,76,"Pilot 7","Pilot 7: bigger feedback + text"
37,"SUPPRF06488",77,23,70,-3,-1,76,71,73,"Pilot 7","Pilot 7: bigger feedback + text"
38,"SUPPRF06488",33,57,16,-7,-13,84,29,23,"Pilot 7","Pilot 7: bigger feedback + text"
39,"SUPPRF06488",33,66,50,-15,-13,69,63,65,"Pilot 7","Pilot 7: bigger feedback + text"
40,"SUPPRF06488",74,23,80,8,0,49,80,72,"Pilot 7","Pilot 7: bigger feedback + text"
41,"SUPPRF06488",82,15,54,7,0,89,54,47,"Pilot 7","Pilot 7: bigger feedback + text"
42,"SUPPRF06488",82,21,83,15,12,74,71,68,"Pilot 7","Pilot 7: bigger feedback + text"
43,"SUPPRF06488",79,15,66,17,12,74,54,49,"Pilot 7","Pilot 7: bigger feedback + text"
44,"SUPPRF06488",64,27,63,-8,0,93,63,71,"Pilot 7","Pilot 7: bigger feedback + text"
45,"SUPPRF06488",64,23,65,10,19,41,46,55,"Pilot 7","Pilot 7: bigger feedback + text"
46,"SUPPRF06488",26,67,38,-20,-16,69,54,58,"Pilot 7","Pilot 7: bigger feedback + text"
47,"SUPPRF06488",48,25,15,-1,-14,69,29,16,"Pilot 7","Pilot 7: bigger feedback + text"
48,"SUPPRF06488",30,63,55,-20,-16,90,71,75,"Pilot 7","Pilot 7: bigger feedback + text"
1,"SUPPRF78020",27,15,78,13,15,75,63,65,"Pilot 7","Pilot 7: bigger feedback + text"
2,"SUPPRF78020",28,9,49,19,12,79,37,30,"Pilot 7","Pilot 7: bigger feedback + text"
3,"SUPPRF78020",32,12,8,-18,-12,72,20,26,"Pilot 7","Pilot 7: bigger feedback + text"
4,"SUPPRF78020",30,12,33,-12,-13,81,46,45,"Pilot 7","Pilot 7: bigger feedback + text"
5,"SUPPRF78020",26,14,55,16,-16,38,71,39,"Pilot 7","Pilot 7: bigger feedback + text"
6,"SUPPRF78020",28,7,45,-2,-1,76,46,47,"Pilot 7","Pilot 7: bigger feedback + text"
7,"SUPPRF78020",26,10,84,14,13,71,71,70,"Pilot 7","Pilot 7: bigger feedback + text"
8,"SUPPRF78020",29,4,46,22,17,79,29,24,"Pilot 7","Pilot 7: bigger feedback + text"
9,"SUPPRF78020",27,6,22,-12,-15,78,37,34,"Pilot 7","Pilot 7: bigger feedback + text"
10,"SUPPRF78020",31,3,16,-11,-13,79,29,27,"Pilot 7","Pilot 7: bigger feedback + text"
11,"SUPPRF78020",29,3,97,22,17,78,80,75,"Pilot 7","Pilot 7: bigger feedback + text"
12,"SUPPRF78020",29,2,77,9,14,75,63,68,"Pilot 7","Pilot 7: bigger feedback + text"
13,"SUPPRF78020",28,2,29,0,0,80,29,29,"Pilot 7","Pilot 7: bigger feedback + text"
14,"SUPPRF78020",29,3,63,25,0,74,63,38,"Pilot 7","Pilot 7: bigger feedback + text"
15,"SUPPRF78020",30,1,28,1,-1,72,29,27,"Pilot 7","Pilot 7: bigger feedback + text"
16,"SUPPRF78020",36,2,51,19,14,75,37,32,"Pilot 7","Pilot 7: bigger feedback + text"
17,"SUPPRF78020",38,1,68,-6,-12,76,80,74,"Pilot 7","Pilot 7: bigger feedback + text"
18,"SUPPRF78020",30,1,62,22,-1,74,63,40,"Pilot 7","Pilot 7: bigger feedback + text"
19,"SUPPRF78020",32,2,34,-6,-12,79,46,40,"Pilot 7","Pilot 7: bigger feedback + text"
20,"SUPPRF78020",34,1,55,17,1,76,54,38,"Pilot 7","Pilot 7: bigger feedback + text"
21,"SUPPRF78020",34,2,48,23,19,77,29,25,"Pilot 7","Pilot 7: bigger feedback + text"
22,"SUPPRF78020",31,1,47,-24,-16,78,63,71,"Pilot 7","Pilot 7: bigger feedback + text"
23,"SUPPRF78020",31,1,67,38,-13,47,80,29,"Pilot 7","Pilot 7: bigger feedback + text"
24,"SUPPRF78020",33,2,96,24,16,77,80,72,"Pilot 7","Pilot 7: bigger feedback + text"
25,"SUPPRF78020",37,2,65,26,19,78,46,39,"Pilot 7","Pilot 7: bigger feedback + text"
26,"SUPPRF78020",36,2,66,14,12,71,54,52,"Pilot 7","Pilot 7: bigger feedback + text"
27,"SUPPRF78020",33,1,24,-19,-13,74,37,43,"Pilot 7","Pilot 7: bigger feedback + text"
28,"SUPPRF78020",36,2,50,-18,-13,74,63,68,"Pilot 7","Pilot 7: bigger feedback + text"
29,"SUPPRF78020",34,1,38,-11,-16,23,54,49,"Pilot 7","Pilot 7: bigger feedback + text"
30,"SUPPRF78020",37,1,81,1,1,72,80,80,"Pilot 7","Pilot 7: bigger feedback + text"
31,"SUPPRF78020",34,1,20,-1,0,81,20,21,"Pilot 7","Pilot 7: bigger feedback + text"
32,"SUPPRF78020",33,1,37,17,17,71,20,20,"Pilot 7","Pilot 7: bigger feedback + text"
33,"SUPPRF78020",31,3,19,-6,-1,71,20,25,"Pilot 7","Pilot 7: bigger feedback + text"
34,"SUPPRF78020",35,2,71,-3,0,77,71,74,"Pilot 7","Pilot 7: bigger feedback + text"
35,"SUPPRF78020",34,2,35,10,15,73,20,25,"Pilot 7","Pilot 7: bigger feedback + text"
36,"SUPPRF78020",34,0,15,-31,-14,23,29,46,"Pilot 7","Pilot 7: bigger feedback + text"
37,"SUPPRF78020",28,1,6,-20,-14,79,20,26,"Pilot 7","Pilot 7: bigger feedback + text"
38,"SUPPRF78020",39,1,68,17,14,18,54,51,"Pilot 7","Pilot 7: bigger feedback + text"
39,"SUPPRF78020",31,2,38,-13,1,18,37,51,"Pilot 7","Pilot 7: bigger feedback + text"
40,"SUPPRF78020",33,1,83,9,12,76,71,74,"Pilot 7","Pilot 7: bigger feedback + text"
41,"SUPPRF78020",32,2,41,-26,-13,74,54,67,"Pilot 7","Pilot 7: bigger feedback + text"
42,"SUPPRF78020",31,1,46,-22,0,18,46,68,"Pilot 7","Pilot 7: bigger feedback + text"
43,"SUPPRF78020",33,2,37,-12,0,17,37,49,"Pilot 7","Pilot 7: bigger feedback + text"
44,"SUPPRF78020",36,1,56,-13,-15,76,71,69,"Pilot 7","Pilot 7: bigger feedback + text"
45,"SUPPRF78020",34,1,54,-9,0,75,54,63,"Pilot 7","Pilot 7: bigger feedback + text"
46,"SUPPRF78020",32,1,80,14,0,72,80,66,"Pilot 7","Pilot 7: bigger feedback + text"
47,"SUPPRF78020",22,1,70,-4,-1,75,71,74,"Pilot 7","Pilot 7: bigger feedback + text"
48,"SUPPRF78020",17,1,58,25,12,74,46,33,"Pilot 7","Pilot 7: bigger feedback + text"
1,"SUPPRF45081",36,35,8,-14,-12,59,20,22,"Pilot 7","Pilot 7: bigger feedback + text"
2,"SUPPRF45081",41,34,56,52,-15,5,71,4,"Pilot 7","Pilot 7: bigger feedback + text"
3,"SUPPRF45081",54,38,24,-6,-13,57,37,30,"Pilot 7","Pilot 7: bigger feedback + text"
4,"SUPPRF45081",30,33,6,-10,-14,23,20,16,"Pilot 7","Pilot 7: bigger feedback + text"
5,"SUPPRF45081",48,27,54,8,0,46,54,46,"Pilot 7","Pilot 7: bigger feedback + text"
6,"SUPPRF45081",36,28,38,12,1,33,37,26,"Pilot 7","Pilot 7: bigger feedback + text"
7,"SUPPRF45081",38,18,45,15,-1,25,46,30,"Pilot 7","Pilot 7: bigger feedback + text"
8,"SUPPRF45081",35,23,33,-6,-13,40,46,39,"Pilot 7","Pilot 7: bigger feedback + text"
9,"SUPPRF45081",43,20,38,-10,-16,45,54,48,"Pilot 7","Pilot 7: bigger feedback + text"
10,"SUPPRF45081",44,16,65,24,19,47,46,41,"Pilot 7","Pilot 7: bigger feedback + text"
11,"SUPPRF45081",52,20,28,16,-1,53,29,12,"Pilot 7","Pilot 7: bigger feedback + text"
12,"SUPPRF45081",53,16,84,30,13,28,71,54,"Pilot 7","Pilot 7: bigger feedback + text"
13,"SUPPRF45081",43,17,55,7,1,25,54,48,"Pilot 7","Pilot 7: bigger feedback + text"
14,"SUPPRF45081",49,13,97,43,17,22,80,54,"Pilot 7","Pilot 7: bigger feedback + text"
15,"SUPPRF45081",49,22,62,7,-1,28,63,55,"Pilot 7","Pilot 7: bigger feedback + text"
16,"SUPPRF45081",48,18,71,12,0,56,71,59,"Pilot 7","Pilot 7: bigger feedback + text"
17,"SUPPRF45081",44,21,29,19,0,48,29,10,"Pilot 7","Pilot 7: bigger feedback + text"
18,"SUPPRF45081",35,16,46,32,17,46,29,14,"Pilot 7","Pilot 7: bigger feedback + text"
19,"SUPPRF45081",48,7,46,0,0,24,46,46,"Pilot 7","Pilot 7: bigger feedback + text"
20,"SUPPRF45081",42,22,19,3,-1,8,20,16,"Pilot 7","Pilot 7: bigger feedback + text"
21,"SUPPRF45081",35,9,67,-3,-13,48,80,70,"Pilot 7","Pilot 7: bigger feedback + text"
22,"SUPPRF45081",49,8,50,-1,-13,25,63,51,"Pilot 7","Pilot 7: bigger feedback + text"
23,"SUPPRF45081",54,15,47,-2,-16,29,63,49,"Pilot 7","Pilot 7: bigger feedback + text"
24,"SUPPRF45081",27,4,37,13,0,7,37,24,"Pilot 7","Pilot 7: bigger feedback + text"
25,"SUPPRF45081",18,5,16,2,-13,53,29,14,"Pilot 7","Pilot 7: bigger feedback + text"
26,"SUPPRF45081",23,7,70,20,-1,15,71,50,"Pilot 7","Pilot 7: bigger feedback + text"
27,"SUPPRF45081",11,6,63,17,0,14,63,46,"Pilot 7","Pilot 7: bigger feedback + text"
28,"SUPPRF45081",16,8,96,28,16,38,80,68,"Pilot 7","Pilot 7: bigger feedback + text"
29,"SUPPRF45081",13,3,51,6,14,25,37,45,"Pilot 7","Pilot 7: bigger feedback + text"
30,"SUPPRF45081",12,4,48,36,19,31,29,12,"Pilot 7","Pilot 7: bigger feedback + text"
31,"SUPPRF45081",10,3,49,17,12,35,37,32,"Pilot 7","Pilot 7: bigger feedback + text"
32,"SUPPRF45081",12,3,66,13,12,39,54,53,"Pilot 7","Pilot 7: bigger feedback + text"
33,"SUPPRF45081",11,1,15,-8,-14,22,29,23,"Pilot 7","Pilot 7: bigger feedback + text"
34,"SUPPRF45081",10,1,35,23,15,27,20,12,"Pilot 7","Pilot 7: bigger feedback + text"
35,"SUPPRF45081",10,1,83,18,12,45,71,65,"Pilot 7","Pilot 7: bigger feedback + text"
36,"SUPPRF45081",5,0,41,-7,-13,31,54,48,"Pilot 7","Pilot 7: bigger feedback + text"
37,"SUPPRF45081",4,2,22,-9,-15,6,37,31,"Pilot 7","Pilot 7: bigger feedback + text"
38,"SUPPRF45081",7,1,20,10,0,26,20,10,"Pilot 7","Pilot 7: bigger feedback + text"
39,"SUPPRF45081",9,0,81,5,1,39,80,76,"Pilot 7","Pilot 7: bigger feedback + text"
40,"SUPPRF45081",13,1,80,10,0,41,80,70,"Pilot 7","Pilot 7: bigger feedback + text"
41,"SUPPRF45081",14,0,78,37,15,13,63,41,"Pilot 7","Pilot 7: bigger feedback + text"
42,"SUPPRF45081",11,1,77,22,14,27,63,55,"Pilot 7","Pilot 7: bigger feedback + text"
43,"SUPPRF45081",8,1,58,26,12,14,46,32,"Pilot 7","Pilot 7: bigger feedback + text"
44,"SUPPRF45081",11,3,37,26,17,30,20,11,"Pilot 7","Pilot 7: bigger feedback + text"
45,"SUPPRF45081",11,1,68,-2,-12,46,80,70,"Pilot 7","Pilot 7: bigger feedback + text"
46,"SUPPRF45081",7,1,55,2,-16,23,71,53,"Pilot 7","Pilot 7: bigger feedback + text"
47,"SUPPRF45081",6,1,34,-13,-12,20,46,47,"Pilot 7","Pilot 7: bigger feedback + text"
48,"SUPPRF45081",7,1,68,20,14,25,54,48,"Pilot 7","Pilot 7: bigger feedback + text"
1,"SUPPRF55923",47,48,41,-8,-13,27,54,49,"Pilot 7","Pilot 7: bigger feedback + text"
2,"SUPPRF55923",50,49,80,6,0,44,80,74,"Pilot 7","Pilot 7: bigger feedback + text"
3,"SUPPRF55923",46,50,71,7,0,51,71,64,"Pilot 7","Pilot 7: bigger feedback + text"
4,"SUPPRF55923",49,47,37,1,17,24,20,36,"Pilot 7","Pilot 7: bigger feedback + text"
5,"SUPPRF55923",64,32,19,0,-1,28,20,19,"Pilot 7","Pilot 7: bigger feedback + text"
6,"SUPPRF55923",46,23,55,11,1,43,54,44,"Pilot 7","Pilot 7: bigger feedback + text"
7,"SUPPRF55923",63,30,46,-5,17,30,29,51,"Pilot 7","Pilot 7: bigger feedback + text"
8,"SUPPRF55923",47,43,6,-32,-14,32,20,38,"Pilot 7","Pilot 7: bigger feedback + text"
9,"SUPPRF55923",51,22,97,63,17,12,80,34,"Pilot 7","Pilot 7: bigger feedback + text"
10,"SUPPRF55923",54,51,45,6,-1,23,46,39,"Pilot 7","Pilot 7: bigger feedback + text"
11,"SUPPRF55923",48,28,83,22,12,47,71,61,"Pilot 7","Pilot 7: bigger feedback + text"
12,"SUPPRF55923",41,30,34,-33,-12,34,46,67,"Pilot 7","Pilot 7: bigger feedback + text"
13,"SUPPRF55923",41,21,20,3,0,61,20,17,"Pilot 7","Pilot 7: bigger feedback + text"
14,"SUPPRF55923",28,26,70,23,-1,23,71,47,"Pilot 7","Pilot 7: bigger feedback + text"
15,"SUPPRF55923",28,17,35,13,15,83,20,22,"Pilot 7","Pilot 7: bigger feedback + text"
16,"SUPPRF55923",36,23,62,21,-1,53,63,41,"Pilot 7","Pilot 7: bigger feedback + text"
17,"SUPPRF55923",29,27,96,47,16,39,80,49,"Pilot 7","Pilot 7: bigger feedback + text"
18,"SUPPRF55923",40,22,68,5,14,36,54,63,"Pilot 7","Pilot 7: bigger feedback + text"
19,"SUPPRF55923",22,19,77,40,14,36,63,37,"Pilot 7","Pilot 7: bigger feedback + text"
20,"SUPPRF55923",25,36,49,19,12,52,37,30,"Pilot 7","Pilot 7: bigger feedback + text"
21,"SUPPRF55923",42,34,67,-5,-13,37,80,72,"Pilot 7","Pilot 7: bigger feedback + text"
22,"SUPPRF55923",29,33,24,-6,-13,38,37,30,"Pilot 7","Pilot 7: bigger feedback + text"
23,"SUPPRF55923",33,33,48,9,19,31,29,39,"Pilot 7","Pilot 7: bigger feedback + text"
24,"SUPPRF55923",42,41,58,22,12,34,46,36,"Pilot 7","Pilot 7: bigger feedback + text"
25,"SUPPRF55923",45,37,56,7,-15,56,71,49,"Pilot 7","Pilot 7: bigger feedback + text"
26,"SUPPRF55923",33,38,81,42,1,37,80,39,"Pilot 7","Pilot 7: bigger feedback + text"
27,"SUPPRF55923",25,26,37,5,0,21,37,32,"Pilot 7","Pilot 7: bigger feedback + text"
28,"SUPPRF55923",22,23,63,23,0,6,63,40,"Pilot 7","Pilot 7: bigger feedback + text"
29,"SUPPRF55923",29,26,28,-22,-1,42,29,50,"Pilot 7","Pilot 7: bigger feedback + text"
30,"SUPPRF55923",24,34,78,30,15,41,63,48,"Pilot 7","Pilot 7: bigger feedback + text"
31,"SUPPRF55923",27,22,38,-8,1,60,37,46,"Pilot 7","Pilot 7: bigger feedback + text"
32,"SUPPRF55923",30,36,66,27,12,21,54,39,"Pilot 7","Pilot 7: bigger feedback + text"
33,"SUPPRF55923",26,19,8,-7,-12,74,20,15,"Pilot 7","Pilot 7: bigger feedback + text"
34,"SUPPRF55923",29,28,55,0,-16,21,71,55,"Pilot 7","Pilot 7: bigger feedback + text"
35,"SUPPRF55923",23,26,33,-19,-13,26,46,52,"Pilot 7","Pilot 7: bigger feedback + text"
36,"SUPPRF55923",34,31,50,-13,-13,66,63,63,"Pilot 7","Pilot 7: bigger feedback + text"
37,"SUPPRF55923",46,44,38,-18,-16,49,54,56,"Pilot 7","Pilot 7: bigger feedback + text"
38,"SUPPRF55923",45,37,68,-16,-12,57,80,84,"Pilot 7","Pilot 7: bigger feedback + text"
39,"SUPPRF55923",32,30,46,1,0,21,46,45,"Pilot 7","Pilot 7: bigger feedback + text"
40,"SUPPRF55923",45,30,84,20,13,41,71,64,"Pilot 7","Pilot 7: bigger feedback + text"
41,"SUPPRF55923",26,25,22,-21,-15,66,37,43,"Pilot 7","Pilot 7: bigger feedback + text"
42,"SUPPRF55923",38,39,47,16,-16,31,63,31,"Pilot 7","Pilot 7: bigger feedback + text"
43,"SUPPRF55923",11,21,65,26,19,13,46,39,"Pilot 7","Pilot 7: bigger feedback + text"
44,"SUPPRF55923",13,33,29,-1,0,33,29,30,"Pilot 7","Pilot 7: bigger feedback + text"
45,"SUPPRF55923",11,30,54,-6,0,13,54,60,"Pilot 7","Pilot 7: bigger feedback + text"
46,"SUPPRF55923",0,19,51,5,14,21,37,46,"Pilot 7","Pilot 7: bigger feedback + text"
47,"SUPPRF55923",19,16,15,-45,-14,18,29,60,"Pilot 7","Pilot 7: bigger feedback + text"
48,"SUPPRF55923",16,14,16,-4,-13,44,29,20,"Pilot 7","Pilot 7: bigger feedback + text"
1,"SUPPRF05688",63,61,78,8,15,45,63,70,"Pilot 7","Pilot 7: bigger feedback + text"
2,"SUPPRF05688",51,40,68,-19,-12,41,80,87,"Pilot 7","Pilot 7: bigger feedback + text"
3,"SUPPRF05688",31,34,28,-44,-1,41,29,72,"Pilot 7","Pilot 7: bigger feedback + text"
4,"SUPPRF05688",54,31,81,20,1,76,80,61,"Pilot 7","Pilot 7: bigger feedback + text"
5,"SUPPRF05688",75,15,84,51,13,49,71,33,"Pilot 7","Pilot 7: bigger feedback + text"
6,"SUPPRF05688",18,43,38,-24,1,15,37,62,"Pilot 7","Pilot 7: bigger feedback + text"
7,"SUPPRF05688",60,41,62,59,-1,100,63,3,"Pilot 7","Pilot 7: bigger feedback + text"
8,"SUPPRF05688",12,41,6,-38,-14,45,20,44,"Pilot 7","Pilot 7: bigger feedback + text"
9,"SUPPRF05688",82,0,97,41,17,32,80,56,"Pilot 7","Pilot 7: bigger feedback + text"
10,"SUPPRF05688",74,0,56,28,-15,24,71,28,"Pilot 7","Pilot 7: bigger feedback + text"
11,"SUPPRF05688",51,23,49,30,12,56,37,19,"Pilot 7","Pilot 7: bigger feedback + text"
12,"SUPPRF05688",29,63,16,-52,-13,38,29,68,"Pilot 7","Pilot 7: bigger feedback + text"
13,"SUPPRF05688",11,35,41,5,-13,33,54,36,"Pilot 7","Pilot 7: bigger feedback + text"
14,"SUPPRF05688",62,16,63,12,0,47,63,51,"Pilot 7","Pilot 7: bigger feedback + text"
15,"SUPPRF05688",50,33,38,-24,-16,27,54,62,"Pilot 7","Pilot 7: bigger feedback + text"
16,"SUPPRF05688",72,9,58,7,12,29,46,51,"Pilot 7","Pilot 7: bigger feedback + text"
17,"SUPPRF05688",94,9,71,64,0,83,71,7,"Pilot 7","Pilot 7: bigger feedback + text"
18,"SUPPRF05688",74,0,70,27,-1,34,71,43,"Pilot 7","Pilot 7: bigger feedback + text"
19,"SUPPRF05688",67,11,66,47,12,35,54,19,"Pilot 7","Pilot 7: bigger feedback + text"
20,"SUPPRF05688",77,16,46,-21,0,43,46,67,"Pilot 7","Pilot 7: bigger feedback + text"
21,"SUPPRF05688",77,18,68,41,14,35,54,27,"Pilot 7","Pilot 7: bigger feedback + text"
22,"SUPPRF05688",69,0,45,6,-1,59,46,39,"Pilot 7","Pilot 7: bigger feedback + text"
23,"SUPPRF05688",77,7,8,-2,-12,51,20,10,"Pilot 7","Pilot 7: bigger feedback + text"
24,"SUPPRF05688",79,6,80,24,0,38,80,56,"Pilot 7","Pilot 7: bigger feedback + text"
25,"SUPPRF05688",84,18,24,3,-13,33,37,21,"Pilot 7","Pilot 7: bigger feedback + text"
26,"SUPPRF05688",98,0,96,33,16,64,80,63,"Pilot 7","Pilot 7: bigger feedback + text"
27,"SUPPRF05688",97,47,50,50,-13,98,63,0,"Pilot 7","Pilot 7: bigger feedback + text"
28,"SUPPRF05688",66,27,19,-36,-1,65,20,55,"Pilot 7","Pilot 7: bigger feedback + text"
29,"SUPPRF05688",66,16,83,20,12,64,71,63,"Pilot 7","Pilot 7: bigger feedback + text"
30,"SUPPRF05688",81,13,55,5,1,68,54,50,"Pilot 7","Pilot 7: bigger feedback + text"
31,"SUPPRF05688",90,12,54,9,0,80,54,45,"Pilot 7","Pilot 7: bigger feedback + text"
32,"SUPPRF05688",87,9,37,31,17,92,20,6,"Pilot 7","Pilot 7: bigger feedback + text"
33,"SUPPRF05688",51,30,33,-15,-13,16,46,48,"Pilot 7","Pilot 7: bigger feedback + text"
34,"SUPPRF05688",64,32,15,-21,-14,64,29,36,"Pilot 7","Pilot 7: bigger feedback + text"
35,"SUPPRF05688",61,18,55,0,-16,60,71,55,"Pilot 7","Pilot 7: bigger feedback + text"
36,"SUPPRF05688",74,25,67,9,-13,39,80,58,"Pilot 7","Pilot 7: bigger feedback + text"
37,"SUPPRF05688",47,33,34,-26,-12,71,46,60,"Pilot 7","Pilot 7: bigger feedback + text"
38,"SUPPRF05688",70,23,77,15,14,59,63,62,"Pilot 7","Pilot 7: bigger feedback + text"
39,"SUPPRF05688",54,39,47,6,-16,31,63,41,"Pilot 7","Pilot 7: bigger feedback + text"
40,"SUPPRF05688",67,28,37,1,0,66,37,36,"Pilot 7","Pilot 7: bigger feedback + text"
41,"SUPPRF05688",56,31,46,38,17,62,29,8,"Pilot 7","Pilot 7: bigger feedback + text"
42,"SUPPRF05688",60,29,29,13,0,67,29,16,"Pilot 7","Pilot 7: bigger feedback + text"
43,"SUPPRF05688",70,24,20,0,0,70,20,20,"Pilot 7","Pilot 7: bigger feedback + text"
44,"SUPPRF05688",71,17,65,16,19,37,46,49,"Pilot 7","Pilot 7: bigger feedback + text"
45,"SUPPRF05688",71,26,35,21,15,69,20,14,"Pilot 7","Pilot 7: bigger feedback + text"
46,"SUPPRF05688",66,32,51,18,14,71,37,33,"Pilot 7","Pilot 7: bigger feedback + text"
47,"SUPPRF05688",69,41,22,-36,-15,62,37,58,"Pilot 7","Pilot 7: bigger feedback + text"
48,"SUPPRF05688",64,32,48,-7,19,78,29,55,"Pilot 7","Pilot 7: bigger feedback + text"
1,"SUPPRF44350",62,14,48,8,19,75,29,40,"Pilot 7","Pilot 7: bigger feedback + text"
2,"SUPPRF44350",61,17,51,15,14,61,37,36,"Pilot 7","Pilot 7: bigger feedback + text"
3,"SUPPRF44350",57,9,78,3,15,80,63,75,"Pilot 7","Pilot 7: bigger feedback + text"
4,"SUPPRF44350",54,15,34,-13,-12,71,46,47,"Pilot 7","Pilot 7: bigger feedback + text"
5,"SUPPRF44350",58,15,6,-23,-14,80,20,29,"Pilot 7","Pilot 7: bigger feedback + text"
6,"SUPPRF44350",56,14,49,32,12,55,37,17,"Pilot 7","Pilot 7: bigger feedback + text"
7,"SUPPRF44350",54,14,8,-14,-12,62,20,22,"Pilot 7","Pilot 7: bigger feedback + text"
8,"SUPPRF44350",57,8,15,2,-14,74,29,13,"Pilot 7","Pilot 7: bigger feedback + text"
9,"SUPPRF44350",57,7,46,18,17,39,29,28,"Pilot 7","Pilot 7: bigger feedback + text"
10,"SUPPRF44350",57,12,41,-24,-13,60,54,65,"Pilot 7","Pilot 7: bigger feedback + text"
11,"SUPPRF44350",51,14,54,6,0,45,54,48,"Pilot 7","Pilot 7: bigger feedback + text"
12,"SUPPRF44350",55,11,62,-6,-1,48,63,68,"Pilot 7","Pilot 7: bigger feedback + text"
13,"SUPPRF44350",60,11,55,-21,-16,69,71,76,"Pilot 7","Pilot 7: bigger feedback + text"
14,"SUPPRF44350",53,7,46,13,0,79,46,33,"Pilot 7","Pilot 7: bigger feedback + text"
15,"SUPPRF44350",56,8,65,20,19,22,46,45,"Pilot 7","Pilot 7: bigger feedback + text"
16,"SUPPRF44350",56,8,45,33,-1,89,46,12,"Pilot 7","Pilot 7: bigger feedback + text"
17,"SUPPRF44350",51,8,67,-9,-13,37,80,76,"Pilot 7","Pilot 7: bigger feedback + text"
18,"SUPPRF44350",58,13,22,-8,-15,40,37,30,"Pilot 7","Pilot 7: bigger feedback + text"
19,"SUPPRF44350",50,15,55,-1,1,63,54,56,"Pilot 7","Pilot 7: bigger feedback + text"
20,"SUPPRF44350",59,5,38,-3,-16,76,54,41,"Pilot 7","Pilot 7: bigger feedback + text"
21,"SUPPRF44350",55,11,50,-10,-13,48,63,60,"Pilot 7","Pilot 7: bigger feedback + text"
22,"SUPPRF44350",52,12,70,2,-1,40,71,68,"Pilot 7","Pilot 7: bigger feedback + text"
23,"SUPPRF44350",50,20,24,-16,-13,60,37,40,"Pilot 7","Pilot 7: bigger feedback + text"
24,"SUPPRF44350",62,12,37,18,17,25,20,19,"Pilot 7","Pilot 7: bigger feedback + text"
25,"SUPPRF44350",62,6,20,2,0,71,20,18,"Pilot 7","Pilot 7: bigger feedback + text"
26,"SUPPRF44350",56,61,68,16,14,73,54,52,"Pilot 7","Pilot 7: bigger feedback + text"
27,"SUPPRF44350",52,10,81,3,1,62,80,78,"Pilot 7","Pilot 7: bigger feedback + text"
28,"SUPPRF44350",59,17,29,9,0,20,29,20,"Pilot 7","Pilot 7: bigger feedback + text"
29,"SUPPRF44350",57,11,58,18,12,65,46,40,"Pilot 7","Pilot 7: bigger feedback + text"
30,"SUPPRF44350",62,9,28,3,-1,39,29,25,"Pilot 7","Pilot 7: bigger feedback + text"
31,"SUPPRF44350",64,8,80,-2,0,61,80,82,"Pilot 7","Pilot 7: bigger feedback + text"
32,"SUPPRF44350",61,10,38,17,1,73,37,21,"Pilot 7","Pilot 7: bigger feedback + text"
33,"SUPPRF44350",60,12,71,2,0,46,71,69,"Pilot 7","Pilot 7: bigger feedback + text"
34,"SUPPRF44350",60,9,56,-3,-15,68,71,59,"Pilot 7","Pilot 7: bigger feedback + text"
35,"SUPPRF44350",74,10,37,0,0,67,37,37,"Pilot 7","Pilot 7: bigger feedback + text"
36,"SUPPRF44350",57,58,66,5,12,32,54,61,"Pilot 7","Pilot 7: bigger feedback + text"
37,"SUPPRF44350",56,61,84,11,13,47,71,73,"Pilot 7","Pilot 7: bigger feedback + text"
38,"SUPPRF44350",55,11,63,5,0,31,63,58,"Pilot 7","Pilot 7: bigger feedback + text"
39,"SUPPRF44350",58,9,77,14,14,52,63,63,"Pilot 7","Pilot 7: bigger feedback + text"
40,"SUPPRF44350",69,14,96,22,16,69,80,74,"Pilot 7","Pilot 7: bigger feedback + text"
41,"SUPPRF44350",60,19,47,-18,-16,70,63,65,"Pilot 7","Pilot 7: bigger feedback + text"
42,"SUPPRF44350",43,21,83,28,12,7,71,55,"Pilot 7","Pilot 7: bigger feedback + text"
43,"SUPPRF44350",50,21,68,-16,-12,68,80,84,"Pilot 7","Pilot 7: bigger feedback + text"
44,"SUPPRF44350",54,10,16,-18,-13,23,29,34,"Pilot 7","Pilot 7: bigger feedback + text"
45,"SUPPRF44350",57,15,33,1,-13,0,46,32,"Pilot 7","Pilot 7: bigger feedback + text"
46,"SUPPRF44350",53,16,19,-8,-1,76,20,27,"Pilot 7","Pilot 7: bigger feedback + text"
47,"SUPPRF44350",54,15,35,10,15,62,20,25,"Pilot 7","Pilot 7: bigger feedback + text"
48,"SUPPRF44350",65,10,97,9,17,83,80,88,"Pilot 7","Pilot 7: bigger feedback + text"
1,"SUPPRF73219",10,76,78,8,15,79,63,70,"Pilot 7","Pilot 7: bigger feedback + text"
2,"SUPPRF73219",16,76,97,11,17,79,80,86,"Pilot 7","Pilot 7: bigger feedback + text"
3,"SUPPRF73219",17,79,37,24,17,82,20,13,"Pilot 7","Pilot 7: bigger feedback + text"
4,"SUPPRF73219",11,88,37,-11,0,84,37,48,"Pilot 7","Pilot 7: bigger feedback + text"
5,"SUPPRF73219",14,90,81,2,1,84,80,79,"Pilot 7","Pilot 7: bigger feedback + text"
6,"SUPPRF73219",15,90,34,-38,-12,78,46,72,"Pilot 7","Pilot 7: bigger feedback + text"
7,"SUPPRF73219",18,82,29,2,0,92,29,27,"Pilot 7","Pilot 7: bigger feedback + text"
8,"SUPPRF73219",24,76,54,0,0,95,54,54,"Pilot 7","Pilot 7: bigger feedback + text"
9,"SUPPRF73219",27,80,51,16,14,77,37,35,"Pilot 7","Pilot 7: bigger feedback + text"
10,"SUPPRF73219",15,90,38,-11,1,78,37,49,"Pilot 7","Pilot 7: bigger feedback + text"
11,"SUPPRF73219",23,82,50,-3,-13,62,63,53,"Pilot 7","Pilot 7: bigger feedback + text"
12,"SUPPRF73219",26,79,55,0,1,75,54,55,"Pilot 7","Pilot 7: bigger feedback + text"
13,"SUPPRF73219",21,74,65,11,19,69,46,54,"Pilot 7","Pilot 7: bigger feedback + text"
14,"SUPPRF73219",31,82,84,8,13,91,71,76,"Pilot 7","Pilot 7: bigger feedback + text"
15,"SUPPRF73219",24,81,46,16,17,87,29,30,"Pilot 7","Pilot 7: bigger feedback + text"
16,"SUPPRF73219",19,84,35,5,15,93,20,30,"Pilot 7","Pilot 7: bigger feedback + text"
17,"SUPPRF73219",20,93,8,0,-12,100,20,8,"Pilot 7","Pilot 7: bigger feedback + text"
18,"SUPPRF73219",17,88,56,-26,-15,100,71,82,"Pilot 7","Pilot 7: bigger feedback + text"
19,"SUPPRF73219",9,95,24,-22,-13,83,37,46,"Pilot 7","Pilot 7: bigger feedback + text"
20,"SUPPRF73219",14,86,63,-4,0,59,63,67,"Pilot 7","Pilot 7: bigger feedback + text"
21,"SUPPRF73219",16,86,20,0,0,81,20,20,"Pilot 7","Pilot 7: bigger feedback + text"
22,"SUPPRF73219",15,90,16,1,-13,84,29,15,"Pilot 7","Pilot 7: bigger feedback + text"
23,"SUPPRF73219",20,87,6,-10,-14,41,20,16,"Pilot 7","Pilot 7: bigger feedback + text"
24,"SUPPRF73219",23,87,83,1,12,79,71,82,"Pilot 7","Pilot 7: bigger feedback + text"
25,"SUPPRF73219",21,88,46,-19,0,83,46,65,"Pilot 7","Pilot 7: bigger feedback + text"
26,"SUPPRF73219",21,80,48,18,19,84,29,30,"Pilot 7","Pilot 7: bigger feedback + text"
27,"SUPPRF73219",14,91,19,-9,-1,78,20,28,"Pilot 7","Pilot 7: bigger feedback + text"
28,"SUPPRF73219",22,82,68,1,-12,49,80,67,"Pilot 7","Pilot 7: bigger feedback + text"
29,"SUPPRF73219",18,84,49,11,12,83,37,38,"Pilot 7","Pilot 7: bigger feedback + text"
30,"SUPPRF73219",29,77,62,-1,-1,74,63,63,"Pilot 7","Pilot 7: bigger feedback + text"
31,"SUPPRF73219",19,86,66,10,12,74,54,56,"Pilot 7","Pilot 7: bigger feedback + text"
32,"SUPPRF73219",11,93,33,-19,-13,89,46,52,"Pilot 7","Pilot 7: bigger feedback + text"
33,"SUPPRF73219",14,88,15,-5,-14,32,29,20,"Pilot 7","Pilot 7: bigger feedback + text"
34,"SUPPRF73219",20,87,77,5,14,96,63,72,"Pilot 7","Pilot 7: bigger feedback + text"
35,"SUPPRF73219",13,80,80,28,0,4,80,52,"Pilot 7","Pilot 7: bigger feedback + text"
36,"SUPPRF73219",6,93,22,-33,-15,30,37,55,"Pilot 7","Pilot 7: bigger feedback + text"
37,"SUPPRF73219",21,86,45,-6,-1,70,46,51,"Pilot 7","Pilot 7: bigger feedback + text"
38,"SUPPRF73219",10,84,47,-9,-16,68,63,56,"Pilot 7","Pilot 7: bigger feedback + text"
39,"SUPPRF73219",11,86,41,0,-13,69,54,41,"Pilot 7","Pilot 7: bigger feedback + text"
40,"SUPPRF73219",16,79,68,18,14,82,54,50,"Pilot 7","Pilot 7: bigger feedback + text"
41,"SUPPRF73219",13,79,71,-1,0,86,71,72,"Pilot 7","Pilot 7: bigger feedback + text"
42,"SUPPRF73219",8,91,38,-14,-16,0,54,52,"Pilot 7","Pilot 7: bigger feedback + text"
43,"SUPPRF73219",18,83,58,7,12,77,46,51,"Pilot 7","Pilot 7: bigger feedback + text"
44,"SUPPRF73219",26,74,96,22,16,83,80,74,"Pilot 7","Pilot 7: bigger feedback + text"
45,"SUPPRF73219",16,89,55,-20,-16,80,71,75,"Pilot 7","Pilot 7: bigger feedback + text"
46,"SUPPRF73219",22,79,70,-2,-1,61,71,72,"Pilot 7","Pilot 7: bigger feedback + text"
47,"SUPPRF73219",12,87,67,-20,-13,88,80,87,"Pilot 7","Pilot 7: bigger feedback + text"
48,"SUPPRF73219",13,85,28,-42,-1,71,29,70,"Pilot 7","Pilot 7: bigger feedback + text"
1,"SUPPRF38095",54,20,47,-5,-16,18,63,52,"Pilot 7","Pilot 7: bigger feedback + text"
2,"SUPPRF38095",64,19,70,43,-1,13,71,27,"Pilot 7","Pilot 7: bigger feedback + text"
3,"SUPPRF38095",64,52,83,18,12,61,71,65,"Pilot 7","Pilot 7: bigger feedback + text"
4,"SUPPRF38095",58,41,20,-35,0,28,20,55,"Pilot 7","Pilot 7: bigger feedback + text"
5,"SUPPRF38095",54,26,38,-34,1,37,37,72,"Pilot 7","Pilot 7: bigger feedback + text"
6,"SUPPRF38095",64,29,46,-19,17,19,29,65,"Pilot 7","Pilot 7: bigger feedback + text"
7,"SUPPRF38095",56,20,24,-26,-13,65,37,50,"Pilot 7","Pilot 7: bigger feedback + text"
8,"SUPPRF38095",65,23,50,-28,-13,78,63,78,"Pilot 7","Pilot 7: bigger feedback + text"
9,"SUPPRF38095",51,23,55,19,1,71,54,36,"Pilot 7","Pilot 7: bigger feedback + text"
10,"SUPPRF38095",54,28,37,-23,17,61,20,60,"Pilot 7","Pilot 7: bigger feedback + text"
11,"SUPPRF38095",60,30,84,33,13,77,71,51,"Pilot 7","Pilot 7: bigger feedback + text"
12,"SUPPRF38095",65,32,51,-23,14,37,37,74,"Pilot 7","Pilot 7: bigger feedback + text"
13,"SUPPRF38095",42,29,16,-39,-13,19,29,55,"Pilot 7","Pilot 7: bigger feedback + text"
14,"SUPPRF38095",66,31,97,34,17,26,80,63,"Pilot 7","Pilot 7: bigger feedback + text"
15,"SUPPRF38095",54,31,19,-16,-1,70,20,35,"Pilot 7","Pilot 7: bigger feedback + text"
16,"SUPPRF38095",41,32,38,-27,-16,16,54,65,"Pilot 7","Pilot 7: bigger feedback + text"
17,"SUPPRF38095",56,41,68,10,14,0,54,58,"Pilot 7","Pilot 7: bigger feedback + text"
18,"SUPPRF38095",61,25,80,54,0,6,80,26,"Pilot 7","Pilot 7: bigger feedback + text"
19,"SUPPRF38095",56,25,22,-38,-15,20,37,60,"Pilot 7","Pilot 7: bigger feedback + text"
20,"SUPPRF38095",66,36,29,-37,0,41,29,66,"Pilot 7","Pilot 7: bigger feedback + text"
21,"SUPPRF38095",73,26,41,5,-13,24,54,36,"Pilot 7","Pilot 7: bigger feedback + text"
22,"SUPPRF38095",27,58,71,4,0,59,71,67,"Pilot 7","Pilot 7: bigger feedback + text"
23,"SUPPRF38095",65,43,65,35,19,82,46,30,"Pilot 7","Pilot 7: bigger feedback + text"
24,"SUPPRF38095",65,32,54,7,0,53,54,47,"Pilot 7","Pilot 7: bigger feedback + text"
25,"SUPPRF38095",52,39,8,-28,-12,29,20,36,"Pilot 7","Pilot 7: bigger feedback + text"
26,"SUPPRF38095",63,36,34,-14,-12,56,46,48,"Pilot 7","Pilot 7: bigger feedback + text"
27,"SUPPRF38095",53,38,63,22,0,37,63,41,"Pilot 7","Pilot 7: bigger feedback + text"
28,"SUPPRF38095",35,27,68,-2,-12,8,80,70,"Pilot 7","Pilot 7: bigger feedback + text"
29,"SUPPRF38095",55,35,37,-2,0,11,37,39,"Pilot 7","Pilot 7: bigger feedback + text"
30,"SUPPRF38095",59,26,96,59,16,31,80,37,"Pilot 7","Pilot 7: bigger feedback + text"
31,"SUPPRF38095",60,41,55,-35,-16,65,71,90,"Pilot 7","Pilot 7: bigger feedback + text"
32,"SUPPRF38095",44,20,46,-20,0,6,46,66,"Pilot 7","Pilot 7: bigger feedback + text"
33,"SUPPRF38095",67,28,58,10,12,25,46,48,"Pilot 7","Pilot 7: bigger feedback + text"
34,"SUPPRF38095",54,27,81,17,1,27,80,64,"Pilot 7","Pilot 7: bigger feedback + text"
35,"SUPPRF38095",71,34,62,17,-1,16,63,45,"Pilot 7","Pilot 7: bigger feedback + text"
36,"SUPPRF38095",53,32,15,-35,-14,4,29,50,"Pilot 7","Pilot 7: bigger feedback + text"
37,"SUPPRF38095",57,32,45,24,-1,64,46,21,"Pilot 7","Pilot 7: bigger feedback + text"
38,"SUPPRF38095",37,39,66,51,12,13,54,15,"Pilot 7","Pilot 7: bigger feedback + text"
39,"SUPPRF38095",53,29,35,-39,15,60,20,74,"Pilot 7","Pilot 7: bigger feedback + text"
40,"SUPPRF38095",31,28,67,17,-13,65,80,50,"Pilot 7","Pilot 7: bigger feedback + text"
41,"SUPPRF38095",69,35,56,11,-15,24,71,45,"Pilot 7","Pilot 7: bigger feedback + text"
42,"SUPPRF38095",51,36,28,-22,-1,26,29,50,"Pilot 7","Pilot 7: bigger feedback + text"
43,"SUPPRF38095",40,17,48,4,19,19,29,44,"Pilot 7","Pilot 7: bigger feedback + text"
44,"SUPPRF38095",51,63,6,-17,-14,28,20,23,"Pilot 7","Pilot 7: bigger feedback + text"
45,"SUPPRF38095",40,36,33,-22,-13,55,46,55,"Pilot 7","Pilot 7: bigger feedback + text"
46,"SUPPRF38095",58,31,77,20,14,61,63,57,"Pilot 7","Pilot 7: bigger feedback + text"
47,"SUPPRF38095",57,37,78,27,15,65,63,51,"Pilot 7","Pilot 7: bigger feedback + text"
48,"SUPPRF38095",48,41,49,5,12,38,37,44,"Pilot 7","Pilot 7: bigger feedback + text"
1,"SUPPRF56321",65,0,41,-19,-13,83,54,60,"Pilot 7","Pilot 7: bigger feedback + text"
2,"SUPPRF56321",64,0,68,32,14,80,54,36,"Pilot 7","Pilot 7: bigger feedback + text"
3,"SUPPRF56321",65,0,66,11,12,90,54,55,"Pilot 7","Pilot 7: bigger feedback + text"
4,"SUPPRF56321",69,0,50,-22,-13,64,63,72,"Pilot 7","Pilot 7: bigger feedback + text"
5,"SUPPRF56321",63,0,65,17,19,70,46,48,"Pilot 7","Pilot 7: bigger feedback + text"
6,"SUPPRF56321",71,0,67,-3,-13,83,80,70,"Pilot 7","Pilot 7: bigger feedback + text"
7,"SUPPRF56321",63,0,62,-4,-1,84,63,66,"Pilot 7","Pilot 7: bigger feedback + text"
8,"SUPPRF56321",59,0,46,-18,0,88,46,64,"Pilot 7","Pilot 7: bigger feedback + text"
9,"SUPPRF56321",68,0,19,0,-1,99,20,19,"Pilot 7","Pilot 7: bigger feedback + text"
10,"SUPPRF56321",62,0,51,0,14,21,37,51,"Pilot 7","Pilot 7: bigger feedback + text"
11,"SUPPRF56321",62,0,28,-8,-1,67,29,36,"Pilot 7","Pilot 7: bigger feedback + text"
12,"SUPPRF56321",71,0,37,2,0,87,37,35,"Pilot 7","Pilot 7: bigger feedback + text"
13,"SUPPRF56321",74,0,70,-7,-1,100,71,77,"Pilot 7","Pilot 7: bigger feedback + text"
14,"SUPPRF56321",70,0,55,10,1,0,54,45,"Pilot 7","Pilot 7: bigger feedback + text"
15,"SUPPRF56321",65,0,24,-12,-13,93,37,36,"Pilot 7","Pilot 7: bigger feedback + text"
16,"SUPPRF56321",59,0,46,25,17,74,29,21,"Pilot 7","Pilot 7: bigger feedback + text"
17,"SUPPRF56321",65,0,63,7,0,100,63,56,"Pilot 7","Pilot 7: bigger feedback + text"
18,"SUPPRF56321",68,1,54,5,0,84,54,49,"Pilot 7","Pilot 7: bigger feedback + text"
19,"SUPPRF56321",61,10,84,40,13,63,71,44,"Pilot 7","Pilot 7: bigger feedback + text"
20,"SUPPRF56321",55,11,20,2,0,89,20,18,"Pilot 7","Pilot 7: bigger feedback + text"
21,"SUPPRF56321",54,4,58,15,12,35,46,43,"Pilot 7","Pilot 7: bigger feedback + text"
22,"SUPPRF56321",48,3,49,0,12,26,37,49,"Pilot 7","Pilot 7: bigger feedback + text"
23,"SUPPRF56321",50,0,71,-3,0,93,71,74,"Pilot 7","Pilot 7: bigger feedback + text"
24,"SUPPRF56321",11,0,34,-18,-12,78,46,52,"Pilot 7","Pilot 7: bigger feedback + text"
25,"SUPPRF56321",50,0,15,-24,-14,73,29,39,"Pilot 7","Pilot 7: bigger feedback + text"
26,"SUPPRF56321",54,0,8,-16,-12,85,20,24,"Pilot 7","Pilot 7: bigger feedback + text"
27,"SUPPRF56321",59,0,97,17,17,100,80,80,"Pilot 7","Pilot 7: bigger feedback + text"
28,"SUPPRF56321",60,2,68,-32,-12,90,80,100,"Pilot 7","Pilot 7: bigger feedback + text"
29,"SUPPRF56321",48,0,56,1,-15,69,71,55,"Pilot 7","Pilot 7: bigger feedback + text"
30,"SUPPRF56321",53,0,29,-5,0,80,29,34,"Pilot 7","Pilot 7: bigger feedback + text"
31,"SUPPRF56321",49,4,55,-20,-16,93,71,75,"Pilot 7","Pilot 7: bigger feedback + text"
32,"SUPPRF56321",65,0,77,14,14,91,63,63,"Pilot 7","Pilot 7: bigger feedback + text"
33,"SUPPRF56321",50,0,83,24,12,36,71,59,"Pilot 7","Pilot 7: bigger feedback + text"
34,"SUPPRF56321",48,0,45,-3,-1,69,46,48,"Pilot 7","Pilot 7: bigger feedback + text"
35,"SUPPRF56321",49,2,33,-23,-13,36,46,56,"Pilot 7","Pilot 7: bigger feedback + text"
36,"SUPPRF56321",50,0,81,3,1,84,80,78,"Pilot 7","Pilot 7: bigger feedback + text"
37,"SUPPRF56321",48,0,35,26,15,90,20,9,"Pilot 7","Pilot 7: bigger feedback + text"
38,"SUPPRF56321",46,0,22,-26,-15,63,37,48,"Pilot 7","Pilot 7: bigger feedback + text"
39,"SUPPRF56321",44,0,6,-11,-14,97,20,17,"Pilot 7","Pilot 7: bigger feedback + text"
40,"SUPPRF56321",47,3,37,18,17,91,20,19,"Pilot 7","Pilot 7: bigger feedback + text"
41,"SUPPRF56321",45,0,38,6,-16,77,54,32,"Pilot 7","Pilot 7: bigger feedback + text"
42,"SUPPRF56321",47,0,47,-20,-16,84,63,67,"Pilot 7","Pilot 7: bigger feedback + text"
43,"SUPPRF56321",48,0,48,16,19,88,29,32,"Pilot 7","Pilot 7: bigger feedback + text"
44,"SUPPRF56321",47,2,96,23,16,88,80,73,"Pilot 7","Pilot 7: bigger feedback + text"
45,"SUPPRF56321",51,0,38,0,1,80,37,38,"Pilot 7","Pilot 7: bigger feedback + text"
46,"SUPPRF56321",50,0,80,5,0,90,80,75,"Pilot 7","Pilot 7: bigger feedback + text"
47,"SUPPRF56321",49,0,78,22,15,88,63,56,"Pilot 7","Pilot 7: bigger feedback + text"
48,"SUPPRF56321",45,7,16,-6,-13,61,29,22,"Pilot 7","Pilot 7: bigger feedback + text"
1,"SUPPRF46237",58,52,55,11,-16,71,71,44,"Pilot 7","Pilot 7: bigger feedback + text"
2,"SUPPRF46237",47,43,83,52,12,72,71,31,"Pilot 7","Pilot 7: bigger feedback + text"
3,"SUPPRF46237",52,46,78,27,15,61,63,51,"Pilot 7","Pilot 7: bigger feedback + text"
4,"SUPPRF46237",44,40,16,-8,-13,74,29,24,"Pilot 7","Pilot 7: bigger feedback + text"
5,"SUPPRF46237",56,35,48,5,19,53,29,43,"Pilot 7","Pilot 7: bigger feedback + text"
6,"SUPPRF46237",50,34,15,-33,-14,59,29,48,"Pilot 7","Pilot 7: bigger feedback + text"
7,"SUPPRF46237",54,37,6,-39,-14,59,20,45,"Pilot 7","Pilot 7: bigger feedback + text"
8,"SUPPRF46237",59,33,58,20,12,54,46,38,"Pilot 7","Pilot 7: bigger feedback + text"
9,"SUPPRF46237",55,31,19,-20,-1,53,20,39,"Pilot 7","Pilot 7: bigger feedback + text"
10,"SUPPRF46237",59,33,45,13,-1,64,46,32,"Pilot 7","Pilot 7: bigger feedback + text"
11,"SUPPRF46237",62,33,68,9,14,62,54,59,"Pilot 7","Pilot 7: bigger feedback + text"
12,"SUPPRF46237",60,32,80,9,0,70,80,71,"Pilot 7","Pilot 7: bigger feedback + text"
13,"SUPPRF46237",62,24,49,16,12,73,37,33,"Pilot 7","Pilot 7: bigger feedback + text"
14,"SUPPRF46237",70,35,38,-1,1,80,37,39,"Pilot 7","Pilot 7: bigger feedback + text"
15,"SUPPRF46237",53,27,22,-20,-15,76,37,42,"Pilot 7","Pilot 7: bigger feedback + text"
16,"SUPPRF46237",68,32,97,18,17,74,80,79,"Pilot 7","Pilot 7: bigger feedback + text"
17,"SUPPRF46237",58,22,29,-13,0,67,29,42,"Pilot 7","Pilot 7: bigger feedback + text"
18,"SUPPRF46237",63,20,46,9,0,80,46,37,"Pilot 7","Pilot 7: bigger feedback + text"
19,"SUPPRF46237",71,24,65,18,19,76,46,47,"Pilot 7","Pilot 7: bigger feedback + text"
20,"SUPPRF46237",69,29,47,-2,-16,54,63,49,"Pilot 7","Pilot 7: bigger feedback + text"
21,"SUPPRF46237",64,19,77,17,14,70,63,60,"Pilot 7","Pilot 7: bigger feedback + text"
22,"SUPPRF46237",66,19,24,-14,-13,73,37,38,"Pilot 7","Pilot 7: bigger feedback + text"
23,"SUPPRF46237",67,19,34,-5,-12,75,46,39,"Pilot 7","Pilot 7: bigger feedback + text"
24,"SUPPRF46237",75,14,81,-4,1,78,80,85,"Pilot 7","Pilot 7: bigger feedback + text"
25,"SUPPRF46237",67,22,41,-12,-13,70,54,53,"Pilot 7","Pilot 7: bigger feedback + text"
26,"SUPPRF46237",64,21,56,-7,-15,77,71,63,"Pilot 7","Pilot 7: bigger feedback + text"
27,"SUPPRF46237",65,24,37,-10,0,62,37,47,"Pilot 7","Pilot 7: bigger feedback + text"
28,"SUPPRF46237",66,27,20,-7,0,74,20,27,"Pilot 7","Pilot 7: bigger feedback + text"
29,"SUPPRF46237",68,21,96,15,16,83,80,81,"Pilot 7","Pilot 7: bigger feedback + text"
30,"SUPPRF46237",62,18,71,1,0,74,71,70,"Pilot 7","Pilot 7: bigger feedback + text"
31,"SUPPRF46237",68,24,50,-5,-13,67,63,55,"Pilot 7","Pilot 7: bigger feedback + text"
32,"SUPPRF46237",64,23,70,-2,-1,68,71,72,"Pilot 7","Pilot 7: bigger feedback + text"
33,"SUPPRF46237",63,29,46,22,17,75,29,24,"Pilot 7","Pilot 7: bigger feedback + text"
34,"SUPPRF46237",54,34,37,17,17,78,20,20,"Pilot 7","Pilot 7: bigger feedback + text"
35,"SUPPRF46237",48,40,28,-9,-1,61,29,37,"Pilot 7","Pilot 7: bigger feedback + text"
36,"SUPPRF46237",53,40,67,-18,-13,89,80,85,"Pilot 7","Pilot 7: bigger feedback + text"
37,"SUPPRF46237",53,40,33,-15,-13,74,46,48,"Pilot 7","Pilot 7: bigger feedback + text"
38,"SUPPRF46237",53,38,38,-6,-16,81,54,44,"Pilot 7","Pilot 7: bigger feedback + text"
39,"SUPPRF46237",55,43,8,-44,-12,48,20,52,"Pilot 7","Pilot 7: bigger feedback + text"
40,"SUPPRF46237",41,50,55,36,1,26,54,19,"Pilot 7","Pilot 7: bigger feedback + text"
41,"SUPPRF46237",49,45,54,0,0,75,54,54,"Pilot 7","Pilot 7: bigger feedback + text"
42,"SUPPRF46237",45,47,84,24,13,61,71,60,"Pilot 7","Pilot 7: bigger feedback + text"
43,"SUPPRF46237",48,38,68,-18,-12,79,80,86,"Pilot 7","Pilot 7: bigger feedback + text"
44,"SUPPRF46237",42,44,66,15,12,74,54,51,"Pilot 7","Pilot 7: bigger feedback + text"
45,"SUPPRF46237",45,44,51,3,14,65,37,48,"Pilot 7","Pilot 7: bigger feedback + text"
46,"SUPPRF46237",33,44,35,21,15,77,20,14,"Pilot 7","Pilot 7: bigger feedback + text"
47,"SUPPRF46237",30,52,63,44,0,49,63,19,"Pilot 7","Pilot 7: bigger feedback + text"
48,"SUPPRF46237",11,41,62,6,-1,69,63,56,"Pilot 7","Pilot 7: bigger feedback + text"
1,"SUPPRF57890",43,41,34,-7,-12,63,46,41,"Pilot 7","Pilot 7: bigger feedback + text"
2,"SUPPRF57890",50,50,46,20,17,83,29,26,"Pilot 7","Pilot 7: bigger feedback + text"
3,"SUPPRF57890",69,36,45,3,-1,68,46,42,"Pilot 7","Pilot 7: bigger feedback + text"
4,"SUPPRF57890",52,41,66,14,12,80,54,52,"Pilot 7","Pilot 7: bigger feedback + text"
5,"SUPPRF57890",71,22,62,-7,-1,94,63,69,"Pilot 7","Pilot 7: bigger feedback + text"
6,"SUPPRF57890",76,21,49,9,12,66,37,40,"Pilot 7","Pilot 7: bigger feedback + text"
7,"SUPPRF57890",66,27,37,9,17,68,20,28,"Pilot 7","Pilot 7: bigger feedback + text"
8,"SUPPRF57890",57,27,78,47,15,76,63,31,"Pilot 7","Pilot 7: bigger feedback + text"
9,"SUPPRF57890",77,17,51,-3,14,40,37,54,"Pilot 7","Pilot 7: bigger feedback + text"
10,"SUPPRF57890",66,26,28,-2,-1,46,29,30,"Pilot 7","Pilot 7: bigger feedback + text"
11,"SUPPRF57890",53,29,54,-17,0,76,54,71,"Pilot 7","Pilot 7: bigger feedback + text"
12,"SUPPRF57890",83,16,63,23,0,65,63,40,"Pilot 7","Pilot 7: bigger feedback + text"
13,"SUPPRF57890",76,18,80,6,0,76,80,74,"Pilot 7","Pilot 7: bigger feedback + text"
14,"SUPPRF57890",81,19,46,11,0,70,46,35,"Pilot 7","Pilot 7: bigger feedback + text"
15,"SUPPRF57890",76,14,29,-10,0,70,29,39,"Pilot 7","Pilot 7: bigger feedback + text"
16,"SUPPRF57890",60,22,50,10,-13,31,63,40,"Pilot 7","Pilot 7: bigger feedback + text"
17,"SUPPRF57890",76,16,77,6,14,64,63,71,"Pilot 7","Pilot 7: bigger feedback + text"
18,"SUPPRF57890",69,26,6,-30,-14,64,20,36,"Pilot 7","Pilot 7: bigger feedback + text"
19,"SUPPRF57890",72,12,67,23,-13,41,80,44,"Pilot 7","Pilot 7: bigger feedback + text"
20,"SUPPRF57890",74,14,68,-15,-12,66,80,83,"Pilot 7","Pilot 7: bigger feedback + text"
21,"SUPPRF57890",77,12,47,-13,-16,77,63,60,"Pilot 7","Pilot 7: bigger feedback + text"
22,"SUPPRF57890",66,11,58,12,12,46,46,46,"Pilot 7","Pilot 7: bigger feedback + text"
23,"SUPPRF57890",76,12,38,-1,1,47,37,39,"Pilot 7","Pilot 7: bigger feedback + text"
24,"SUPPRF57890",77,19,41,-25,-13,84,54,66,"Pilot 7","Pilot 7: bigger feedback + text"
25,"SUPPRF57890",78,15,70,3,-1,51,71,67,"Pilot 7","Pilot 7: bigger feedback + text"
26,"SUPPRF57890",85,16,83,17,12,87,71,66,"Pilot 7","Pilot 7: bigger feedback + text"
27,"SUPPRF57890",76,11,8,-15,-12,73,20,23,"Pilot 7","Pilot 7: bigger feedback + text"
28,"SUPPRF57890",86,7,97,15,17,68,80,82,"Pilot 7","Pilot 7: bigger feedback + text"
29,"SUPPRF57890",60,12,22,-37,-15,35,37,59,"Pilot 7","Pilot 7: bigger feedback + text"
30,"SUPPRF57890",70,12,71,16,0,53,71,55,"Pilot 7","Pilot 7: bigger feedback + text"
31,"SUPPRF57890",84,15,56,-20,-15,64,71,76,"Pilot 7","Pilot 7: bigger feedback + text"
32,"SUPPRF57890",95,9,96,47,16,25,80,49,"Pilot 7","Pilot 7: bigger feedback + text"
33,"SUPPRF57890",91,9,48,-1,19,67,29,49,"Pilot 7","Pilot 7: bigger feedback + text"
34,"SUPPRF57890",88,21,55,-6,1,83,54,61,"Pilot 7","Pilot 7: bigger feedback + text"
35,"SUPPRF57890",79,15,65,25,19,78,46,40,"Pilot 7","Pilot 7: bigger feedback + text"
36,"SUPPRF57890",77,10,68,8,14,79,54,60,"Pilot 7","Pilot 7: bigger feedback + text"
37,"SUPPRF57890",81,28,33,-43,-13,79,46,76,"Pilot 7","Pilot 7: bigger feedback + text"
38,"SUPPRF57890",90,23,15,-24,-14,71,29,39,"Pilot 7","Pilot 7: bigger feedback + text"
39,"SUPPRF57890",84,8,37,-20,0,53,37,57,"Pilot 7","Pilot 7: bigger feedback + text"
40,"SUPPRF57890",86,9,20,-2,0,83,20,22,"Pilot 7","Pilot 7: bigger feedback + text"
41,"SUPPRF57890",83,14,16,-9,-13,74,29,25,"Pilot 7","Pilot 7: bigger feedback + text"
42,"SUPPRF57890",78,35,84,41,13,68,71,43,"Pilot 7","Pilot 7: bigger feedback + text"
43,"SUPPRF57890",84,13,81,37,1,78,80,44,"Pilot 7","Pilot 7: bigger feedback + text"
44,"SUPPRF57890",86,15,19,-8,-1,85,20,27,"Pilot 7","Pilot 7: bigger feedback + text"
45,"SUPPRF57890",73,14,24,-38,-13,67,37,62,"Pilot 7","Pilot 7: bigger feedback + text"
46,"SUPPRF57890",76,12,55,-13,-16,82,71,68,"Pilot 7","Pilot 7: bigger feedback + text"
47,"SUPPRF57890",79,12,38,-22,-16,71,54,60,"Pilot 7","Pilot 7: bigger feedback + text"
48,"SUPPRF57890",84,13,35,18,15,80,20,17,"Pilot 7","Pilot 7: bigger feedback + text"
1,"SUPPRF67412",100,0,55,-20,-16,100,71,75,"Pilot 7","Pilot 7: bigger feedback + text"
2,"SUPPRF67412",100,0,34,-16,-12,81,46,50,"Pilot 7","Pilot 7: bigger feedback + text"
3,"SUPPRF67412",100,0,28,3,-1,100,29,25,"Pilot 7","Pilot 7: bigger feedback + text"
4,"SUPPRF67412",100,0,38,8,1,86,37,30,"Pilot 7","Pilot 7: bigger feedback + text"
5,"SUPPRF67412",100,0,63,3,0,75,63,60,"Pilot 7","Pilot 7: bigger feedback + text"
6,"SUPPRF67412",100,0,16,-5,-13,100,29,21,"Pilot 7","Pilot 7: bigger feedback + text"
7,"SUPPRF67412",100,0,58,23,12,100,46,35,"Pilot 7","Pilot 7: bigger feedback + text"
8,"SUPPRF67412",100,0,41,-14,-13,100,54,55,"Pilot 7","Pilot 7: bigger feedback + text"
9,"SUPPRF67412",100,0,22,-22,-15,59,37,44,"Pilot 7","Pilot 7: bigger feedback + text"
10,"SUPPRF67412",100,0,46,-2,0,66,46,48,"Pilot 7","Pilot 7: bigger feedback + text"
11,"SUPPRF67412",100,0,70,0,-1,100,71,70,"Pilot 7","Pilot 7: bigger feedback + text"
12,"SUPPRF67412",98,0,33,-9,-13,55,46,42,"Pilot 7","Pilot 7: bigger feedback + text"
13,"SUPPRF67412",100,0,6,-4,-14,100,20,10,"Pilot 7","Pilot 7: bigger feedback + text"
14,"SUPPRF67412",100,0,83,16,12,100,71,67,"Pilot 7","Pilot 7: bigger feedback + text"
15,"SUPPRF67412",100,0,35,25,15,100,20,10,"Pilot 7","Pilot 7: bigger feedback + text"
16,"SUPPRF67412",100,0,84,15,13,100,71,69,"Pilot 7","Pilot 7: bigger feedback + text"
17,"SUPPRF67412",100,0,55,10,1,100,54,45,"Pilot 7","Pilot 7: bigger feedback + text"
18,"SUPPRF67412",100,0,37,6,0,100,37,31,"Pilot 7","Pilot 7: bigger feedback + text"
19,"SUPPRF67412",100,0,38,-6,-16,100,54,44,"Pilot 7","Pilot 7: bigger feedback + text"
20,"SUPPRF67412",100,0,97,17,17,100,80,80,"Pilot 7","Pilot 7: bigger feedback + text"
21,"SUPPRF67412",100,0,48,27,19,100,29,21,"Pilot 7","Pilot 7: bigger feedback + text"
22,"SUPPRF67412",100,0,62,15,-1,95,63,47,"Pilot 7","Pilot 7: bigger feedback + text"
23,"SUPPRF67412",100,1,29,-16,0,59,29,45,"Pilot 7","Pilot 7: bigger feedback + text"
24,"SUPPRF67412",100,0,37,29,17,100,20,8,"Pilot 7","Pilot 7: bigger feedback + text"
25,"SUPPRF67412",100,0,45,-55,-1,0,46,100,"Pilot 7","Pilot 7: bigger feedback + text"
26,"SUPPRF67412",100,0,49,13,12,100,37,36,"Pilot 7","Pilot 7: bigger feedback + text"
27,"SUPPRF67412",100,0,68,20,14,100,54,48,"Pilot 7","Pilot 7: bigger feedback + text"
28,"SUPPRF67412",100,0,80,-10,0,100,80,90,"Pilot 7","Pilot 7: bigger feedback + text"
29,"SUPPRF67412",100,0,20,6,0,48,20,14,"Pilot 7","Pilot 7: bigger feedback + text"
30,"SUPPRF67412",100,0,50,8,-13,87,63,42,"Pilot 7","Pilot 7: bigger feedback + text"
31,"SUPPRF67412",100,0,67,-18,-13,100,80,85,"Pilot 7","Pilot 7: bigger feedback + text"
32,"SUPPRF67412",100,0,68,5,-12,100,80,63,"Pilot 7","Pilot 7: bigger feedback + text"
33,"SUPPRF67412",100,0,51,8,14,71,37,43,"Pilot 7","Pilot 7: bigger feedback + text"
34,"SUPPRF67412",100,0,71,13,0,84,71,58,"Pilot 7","Pilot 7: bigger feedback + text"
35,"SUPPRF67412",100,0,24,-9,-13,100,37,33,"Pilot 7","Pilot 7: bigger feedback + text"
36,"SUPPRF67412",99,1,78,21,15,63,63,57,"Pilot 7","Pilot 7: bigger feedback + text"
37,"SUPPRF67412",100,0,77,32,14,51,63,45,"Pilot 7","Pilot 7: bigger feedback + text"
38,"SUPPRF67412",100,0,81,5,1,100,80,76,"Pilot 7","Pilot 7: bigger feedback + text"
39,"SUPPRF67412",99,1,66,16,12,53,54,50,"Pilot 7","Pilot 7: bigger feedback + text"
40,"SUPPRF67412",100,0,56,2,-15,50,71,54,"Pilot 7","Pilot 7: bigger feedback + text"
41,"SUPPRF67412",98,0,8,-9,-12,54,20,17,"Pilot 7","Pilot 7: bigger feedback + text"
42,"SUPPRF67412",100,0,65,30,19,72,46,35,"Pilot 7","Pilot 7: bigger feedback + text"
43,"SUPPRF67412",100,0,54,4,0,53,54,50,"Pilot 7","Pilot 7: bigger feedback + text"
44,"SUPPRF67412",31,0,15,-34,-14,100,29,49,"Pilot 7","Pilot 7: bigger feedback + text"
45,"SUPPRF67412",100,0,19,5,-1,100,20,14,"Pilot 7","Pilot 7: bigger feedback + text"
46,"SUPPRF67412",100,0,47,-53,-16,48,63,100,"Pilot 7","Pilot 7: bigger feedback + text"
47,"SUPPRF67412",99,0,46,34,17,51,29,12,"Pilot 7","Pilot 7: bigger feedback + text"
48,"SUPPRF67412",100,0,96,21,16,100,80,75,"Pilot 7","Pilot 7: bigger feedback + text"
1,"SUPPRF14083",53,65,15,-17,-14,70,29,32,"Pilot 7","Pilot 7: bigger feedback + text"
2,"SUPPRF14083",46,64,46,-8,0,55,46,54,"Pilot 7","Pilot 7: bigger feedback + text"
3,"SUPPRF14083",51,59,70,-5,-1,48,71,75,"Pilot 7","Pilot 7: bigger feedback + text"
4,"SUPPRF14083",42,63,24,5,-13,3,37,19,"Pilot 7","Pilot 7: bigger feedback + text"
5,"SUPPRF14083",45,53,22,-6,-15,43,37,28,"Pilot 7","Pilot 7: bigger feedback + text"
6,"SUPPRF14083",48,57,65,21,19,59,46,44,"Pilot 7","Pilot 7: bigger feedback + text"
7,"SUPPRF14083",45,53,55,-31,-16,78,71,86,"Pilot 7","Pilot 7: bigger feedback + text"
8,"SUPPRF14083",61,52,84,14,13,61,71,70,"Pilot 7","Pilot 7: bigger feedback + text"
9,"SUPPRF14083",54,55,29,-13,0,61,29,42,"Pilot 7","Pilot 7: bigger feedback + text"
10,"SUPPRF14083",58,48,68,-7,-12,74,80,75,"Pilot 7","Pilot 7: bigger feedback + text"
11,"SUPPRF14083",64,44,54,-6,0,31,54,60,"Pilot 7","Pilot 7: bigger feedback + text"
12,"SUPPRF14083",32,58,6,-23,-14,62,20,29,"Pilot 7","Pilot 7: bigger feedback + text"
13,"SUPPRF14083",43,50,38,-12,-16,56,54,50,"Pilot 7","Pilot 7: bigger feedback + text"
14,"SUPPRF14083",59,54,67,6,-13,68,80,61,"Pilot 7","Pilot 7: bigger feedback + text"
15,"SUPPRF14083",67,48,80,28,0,62,80,52,"Pilot 7","Pilot 7: bigger feedback + text"
16,"SUPPRF14083",23,47,8,-10,-12,70,20,18,"Pilot 7","Pilot 7: bigger feedback + text"
17,"SUPPRF14083",52,44,77,58,14,83,63,19,"Pilot 7","Pilot 7: bigger feedback + text"
18,"SUPPRF14083",56,46,46,-2,17,40,29,48,"Pilot 7","Pilot 7: bigger feedback + text"
19,"SUPPRF14083",58,48,49,-3,12,58,37,52,"Pilot 7","Pilot 7: bigger feedback + text"
20,"SUPPRF14083",58,57,35,30,15,95,20,5,"Pilot 7","Pilot 7: bigger feedback + text"
21,"SUPPRF14083",61,36,83,8,12,66,71,75,"Pilot 7","Pilot 7: bigger feedback + text"
22,"SUPPRF14083",59,44,19,7,-1,76,20,12,"Pilot 7","Pilot 7: bigger feedback + text"
23,"SUPPRF14083",51,59,56,-6,-15,70,71,62,"Pilot 7","Pilot 7: bigger feedback + text"
24,"SUPPRF14083",56,44,50,-13,-13,71,63,63,"Pilot 7","Pilot 7: bigger feedback + text"
25,"SUPPRF14083",70,37,48,21,19,74,29,27,"Pilot 7","Pilot 7: bigger feedback + text"
26,"SUPPRF14083",68,36,55,14,1,63,54,41,"Pilot 7","Pilot 7: bigger feedback + text"
27,"SUPPRF14083",57,45,45,21,-1,40,46,24,"Pilot 7","Pilot 7: bigger feedback + text"
28,"SUPPRF14083",49,49,16,-1,-13,85,29,17,"Pilot 7","Pilot 7: bigger feedback + text"
29,"SUPPRF14083",39,58,41,-32,-13,78,54,73,"Pilot 7","Pilot 7: bigger feedback + text"
30,"SUPPRF14083",56,44,63,2,0,54,63,61,"Pilot 7","Pilot 7: bigger feedback + text"
31,"SUPPRF14083",56,49,62,-6,-1,77,63,68,"Pilot 7","Pilot 7: bigger feedback + text"
32,"SUPPRF14083",58,48,66,15,12,64,54,51,"Pilot 7","Pilot 7: bigger feedback + text"
33,"SUPPRF14083",52,49,20,11,0,66,20,9,"Pilot 7","Pilot 7: bigger feedback + text"
34,"SUPPRF14083",63,43,37,27,17,73,20,10,"Pilot 7","Pilot 7: bigger feedback + text"
35,"SUPPRF14083",68,45,97,27,17,84,80,70,"Pilot 7","Pilot 7: bigger feedback + text"
36,"SUPPRF14083",54,45,51,-9,14,48,37,60,"Pilot 7","Pilot 7: bigger feedback + text"
37,"SUPPRF14083",57,44,58,6,12,80,46,52,"Pilot 7","Pilot 7: bigger feedback + text"
38,"SUPPRF14083",60,41,71,2,0,77,71,69,"Pilot 7","Pilot 7: bigger feedback + text"
39,"SUPPRF14083",61,42,68,7,14,72,54,61,"Pilot 7","Pilot 7: bigger feedback + text"
40,"SUPPRF14083",65,44,81,18,1,71,80,63,"Pilot 7","Pilot 7: bigger feedback + text"
41,"SUPPRF14083",52,46,34,-30,-12,61,46,64,"Pilot 7","Pilot 7: bigger feedback + text"
42,"SUPPRF14083",54,50,33,0,-13,70,46,33,"Pilot 7","Pilot 7: bigger feedback + text"
43,"SUPPRF14083",52,50,38,-12,1,61,37,50,"Pilot 7","Pilot 7: bigger feedback + text"
44,"SUPPRF14083",68,43,96,13,16,79,80,83,"Pilot 7","Pilot 7: bigger feedback + text"
45,"SUPPRF14083",50,47,28,-18,-1,61,29,46,"Pilot 7","Pilot 7: bigger feedback + text"
46,"SUPPRF14083",53,48,37,-15,0,61,37,52,"Pilot 7","Pilot 7: bigger feedback + text"
47,"SUPPRF14083",54,41,47,8,-16,47,63,39,"Pilot 7","Pilot 7: bigger feedback + text"
48,"SUPPRF14083",56,46,78,34,15,56,63,44,"Pilot 7","Pilot 7: bigger feedback + text"
1,"SUPPRF10753",83,9,15,-24,-14,69,29,39,"Pilot 7","Pilot 7: bigger feedback + text"
2,"SUPPRF10753",78,10,83,14,12,49,71,69,"Pilot 7","Pilot 7: bigger feedback + text"
3,"SUPPRF10753",81,15,51,7,14,49,37,44,"Pilot 7","Pilot 7: bigger feedback + text"
4,"SUPPRF10753",79,13,68,17,14,46,54,51,"Pilot 7","Pilot 7: bigger feedback + text"
5,"SUPPRF10753",80,12,71,13,0,50,71,58,"Pilot 7","Pilot 7: bigger feedback + text"
6,"SUPPRF10753",77,16,70,14,-1,14,71,56,"Pilot 7","Pilot 7: bigger feedback + text"
7,"SUPPRF10753",81,19,38,-9,1,52,37,47,"Pilot 7","Pilot 7: bigger feedback + text"
8,"SUPPRF10753",74,16,16,-30,-13,51,29,46,"Pilot 7","Pilot 7: bigger feedback + text"
9,"SUPPRF10753",80,18,24,-17,-13,47,37,41,"Pilot 7","Pilot 7: bigger feedback + text"
10,"SUPPRF10753",82,18,29,-40,0,45,29,69,"Pilot 7","Pilot 7: bigger feedback + text"
11,"SUPPRF10753",79,16,45,-2,-1,48,46,47,"Pilot 7","Pilot 7: bigger feedback + text"
12,"SUPPRF10753",72,17,35,-6,15,52,20,41,"Pilot 7","Pilot 7: bigger feedback + text"
13,"SUPPRF10753",74,19,28,-11,-1,50,29,39,"Pilot 7","Pilot 7: bigger feedback + text"
14,"SUPPRF10753",77,14,20,-21,0,49,20,41,"Pilot 7","Pilot 7: bigger feedback + text"
15,"SUPPRF10753",83,22,22,-21,-15,49,37,43,"Pilot 7","Pilot 7: bigger feedback + text"
16,"SUPPRF10753",73,18,48,10,19,51,29,38,"Pilot 7","Pilot 7: bigger feedback + text"
17,"SUPPRF10753",79,16,19,-22,-1,49,20,41,"Pilot 7","Pilot 7: bigger feedback + text"
18,"SUPPRF10753",75,16,8,-16,-12,18,20,24,"Pilot 7","Pilot 7: bigger feedback + text"
19,"SUPPRF10753",79,19,62,-8,-1,48,63,70,"Pilot 7","Pilot 7: bigger feedback + text"
20,"SUPPRF10753",76,16,37,-13,0,50,37,50,"Pilot 7","Pilot 7: bigger feedback + text"
21,"SUPPRF10753",78,24,37,7,17,51,20,30,"Pilot 7","Pilot 7: bigger feedback + text"
22,"SUPPRF10753",80,20,33,-16,-13,49,46,49,"Pilot 7","Pilot 7: bigger feedback + text"
23,"SUPPRF10753",81,22,6,-30,-14,55,20,36,"Pilot 7","Pilot 7: bigger feedback + text"
24,"SUPPRF10753",81,20,67,-8,-13,50,80,75,"Pilot 7","Pilot 7: bigger feedback + text"
25,"SUPPRF10753",81,17,50,-24,-13,63,63,74,"Pilot 7","Pilot 7: bigger feedback + text"
26,"SUPPRF10753",78,21,38,-24,-16,48,54,62,"Pilot 7","Pilot 7: bigger feedback + text"
27,"SUPPRF10753",18,23,81,14,1,56,80,67,"Pilot 7","Pilot 7: bigger feedback + text"
28,"SUPPRF10753",79,22,55,-2,-16,48,71,57,"Pilot 7","Pilot 7: bigger feedback + text"
29,"SUPPRF10753",73,19,41,-16,-13,30,54,57,"Pilot 7","Pilot 7: bigger feedback + text"
30,"SUPPRF10753",82,15,65,14,19,49,46,51,"Pilot 7","Pilot 7: bigger feedback + text"
31,"SUPPRF10753",77,21,96,26,16,48,80,70,"Pilot 7","Pilot 7: bigger feedback + text"
32,"SUPPRF10753",72,16,49,16,12,49,37,33,"Pilot 7","Pilot 7: bigger feedback + text"
33,"SUPPRF10753",78,22,54,13,0,46,54,41,"Pilot 7","Pilot 7: bigger feedback + text"
34,"SUPPRF10753",78,21,55,4,1,49,54,51,"Pilot 7","Pilot 7: bigger feedback + text"
35,"SUPPRF10753",74,19,58,5,12,23,46,53,"Pilot 7","Pilot 7: bigger feedback + text"
36,"SUPPRF10753",74,26,78,37,15,23,63,41,"Pilot 7","Pilot 7: bigger feedback + text"
37,"SUPPRF10753",76,46,80,6,0,38,80,74,"Pilot 7","Pilot 7: bigger feedback + text"
38,"SUPPRF10753",77,20,46,-10,17,22,29,56,"Pilot 7","Pilot 7: bigger feedback + text"
39,"SUPPRF10753",75,27,77,23,14,27,63,54,"Pilot 7","Pilot 7: bigger feedback + text"
40,"SUPPRF10753",74,25,56,-10,-15,17,71,66,"Pilot 7","Pilot 7: bigger feedback + text"
41,"SUPPRF10753",76,15,66,13,12,23,54,53,"Pilot 7","Pilot 7: bigger feedback + text"
42,"SUPPRF10753",78,20,47,-11,-16,48,63,58,"Pilot 7","Pilot 7: bigger feedback + text"
43,"SUPPRF10753",76,20,68,-6,-12,50,80,74,"Pilot 7","Pilot 7: bigger feedback + text"
44,"SUPPRF10753",80,47,46,-4,0,19,46,50,"Pilot 7","Pilot 7: bigger feedback + text"
45,"SUPPRF10753",78,21,63,7,0,46,63,56,"Pilot 7","Pilot 7: bigger feedback + text"
46,"SUPPRF10753",78,26,97,28,17,48,80,69,"Pilot 7","Pilot 7: bigger feedback + text"
47,"SUPPRF10753",75,19,34,-23,-12,21,46,57,"Pilot 7","Pilot 7: bigger feedback + text"
48,"SUPPRF10753",82,24,84,27,13,47,71,57,"Pilot 7","Pilot 7: bigger feedback + text"
1,"SUPPRF08085",51,56,56,-9,-15,65,71,65,"Pilot 7","Pilot 7: bigger feedback + text"
2,"SUPPRF08085",54,43,46,-4,0,40,46,50,"Pilot 7","Pilot 7: bigger feedback + text"
3,"SUPPRF08085",55,54,63,4,0,60,63,59,"Pilot 7","Pilot 7: bigger feedback + text"
4,"SUPPRF08085",62,38,35,5,15,71,20,30,"Pilot 7","Pilot 7: bigger feedback + text"
5,"SUPPRF08085",36,36,38,-27,-16,56,54,65,"Pilot 7","Pilot 7: bigger feedback + text"
6,"SUPPRF08085",61,40,46,26,17,36,29,20,"Pilot 7","Pilot 7: bigger feedback + text"
7,"SUPPRF08085",61,36,65,15,19,59,46,50,"Pilot 7","Pilot 7: bigger feedback + text"
8,"SUPPRF08085",35,42,55,-20,-16,70,71,75,"Pilot 7","Pilot 7: bigger feedback + text"
9,"SUPPRF08085",57,37,58,8,12,31,46,50,"Pilot 7","Pilot 7: bigger feedback + text"
10,"SUPPRF08085",74,26,70,-2,-1,37,71,72,"Pilot 7","Pilot 7: bigger feedback + text"
11,"SUPPRF08085",60,32,71,11,0,26,71,60,"Pilot 7","Pilot 7: bigger feedback + text"
12,"SUPPRF08085",65,32,29,9,0,58,29,20,"Pilot 7","Pilot 7: bigger feedback + text"
13,"SUPPRF08085",11,35,6,-29,-14,33,20,35,"Pilot 7","Pilot 7: bigger feedback + text"
14,"SUPPRF08085",80,35,22,-10,-15,29,37,32,"Pilot 7","Pilot 7: bigger feedback + text"
15,"SUPPRF08085",74,33,51,12,14,59,37,39,"Pilot 7","Pilot 7: bigger feedback + text"
16,"SUPPRF08085",56,63,37,20,17,14,20,17,"Pilot 7","Pilot 7: bigger feedback + text"
17,"SUPPRF08085",77,35,37,-8,0,66,37,45,"Pilot 7","Pilot 7: bigger feedback + text"
18,"SUPPRF08085",37,46,38,-13,1,67,37,51,"Pilot 7","Pilot 7: bigger feedback + text"
19,"SUPPRF08085",77,24,15,-2,-14,64,29,17,"Pilot 7","Pilot 7: bigger feedback + text"
20,"SUPPRF08085",84,33,34,4,-12,62,46,30,"Pilot 7","Pilot 7: bigger feedback + text"
21,"SUPPRF08085",53,60,78,14,15,57,63,64,"Pilot 7","Pilot 7: bigger feedback + text"
22,"SUPPRF08085",88,23,96,24,16,33,80,72,"Pilot 7","Pilot 7: bigger feedback + text"
23,"SUPPRF08085",41,50,50,-12,-13,61,63,62,"Pilot 7","Pilot 7: bigger feedback + text"
24,"SUPPRF08085",24,71,24,-20,-13,34,37,44,"Pilot 7","Pilot 7: bigger feedback + text"
25,"SUPPRF08085",73,39,28,7,-1,67,29,21,"Pilot 7","Pilot 7: bigger feedback + text"
26,"SUPPRF08085",7,63,8,-13,-12,89,20,21,"Pilot 7","Pilot 7: bigger feedback + text"
27,"SUPPRF08085",91,23,62,19,-1,25,63,43,"Pilot 7","Pilot 7: bigger feedback + text"
28,"SUPPRF08085",94,5,77,2,14,56,63,75,"Pilot 7","Pilot 7: bigger feedback + text"
29,"SUPPRF08085",91,24,20,-8,0,64,20,28,"Pilot 7","Pilot 7: bigger feedback + text"
30,"SUPPRF08085",95,10,68,7,14,95,54,61,"Pilot 7","Pilot 7: bigger feedback + text"
31,"SUPPRF08085",24,67,68,-14,-12,64,80,82,"Pilot 7","Pilot 7: bigger feedback + text"
32,"SUPPRF08085",33,60,19,-11,-1,63,20,30,"Pilot 7","Pilot 7: bigger feedback + text"
33,"SUPPRF08085",73,31,97,11,17,57,80,86,"Pilot 7","Pilot 7: bigger feedback + text"
34,"SUPPRF08085",15,58,47,-25,-16,37,63,72,"Pilot 7","Pilot 7: bigger feedback + text"
35,"SUPPRF08085",39,37,49,16,12,57,37,33,"Pilot 7","Pilot 7: bigger feedback + text"
36,"SUPPRF08085",40,24,83,13,12,78,71,70,"Pilot 7","Pilot 7: bigger feedback + text"
37,"SUPPRF08085",67,62,81,23,1,3,80,58,"Pilot 7","Pilot 7: bigger feedback + text"
38,"SUPPRF08085",77,32,84,14,13,64,71,70,"Pilot 7","Pilot 7: bigger feedback + text"
39,"SUPPRF08085",45,55,67,-13,-13,67,80,80,"Pilot 7","Pilot 7: bigger feedback + text"
40,"SUPPRF08085",23,30,80,16,0,41,80,64,"Pilot 7","Pilot 7: bigger feedback + text"
41,"SUPPRF08085",86,22,45,-4,-1,39,46,49,"Pilot 7","Pilot 7: bigger feedback + text"
42,"SUPPRF08085",58,25,54,-6,0,37,54,60,"Pilot 7","Pilot 7: bigger feedback + text"
43,"SUPPRF08085",14,59,48,38,19,77,29,10,"Pilot 7","Pilot 7: bigger feedback + text"
44,"SUPPRF08085",35,57,66,22,12,33,54,44,"Pilot 7","Pilot 7: bigger feedback + text"
45,"SUPPRF08085",56,34,33,-12,-13,40,46,45,"Pilot 7","Pilot 7: bigger feedback + text"
46,"SUPPRF08085",33,35,41,-19,-13,51,54,60,"Pilot 7","Pilot 7: bigger feedback + text"
47,"SUPPRF08085",7,59,16,-15,-13,69,29,31,"Pilot 7","Pilot 7: bigger feedback + text"
48,"SUPPRF08085",73,25,55,6,1,63,54,49,"Pilot 7","Pilot 7: bigger feedback + text"
1,"SUPPRF20625",79,29,38,-2,1,75,37,40,"Pilot 7","Pilot 7: bigger feedback + text"
2,"SUPPRF20625",90,9,37,12,17,90,20,25,"Pilot 7","Pilot 7: bigger feedback + text"
3,"SUPPRF20625",92,26,71,-6,0,70,71,77,"Pilot 7","Pilot 7: bigger feedback + text"
4,"SUPPRF20625",83,16,81,-1,1,80,80,82,"Pilot 7","Pilot 7: bigger feedback + text"
5,"SUPPRF20625",83,21,45,-5,-1,60,46,50,"Pilot 7","Pilot 7: bigger feedback + text"
6,"SUPPRF20625",91,10,96,21,16,75,80,75,"Pilot 7","Pilot 7: bigger feedback + text"
7,"SUPPRF20625",91,6,65,20,19,80,46,45,"Pilot 7","Pilot 7: bigger feedback + text"
8,"SUPPRF20625",71,12,22,-23,-15,40,37,45,"Pilot 7","Pilot 7: bigger feedback + text"
9,"SUPPRF20625",97,10,97,12,17,60,80,85,"Pilot 7","Pilot 7: bigger feedback + text"
10,"SUPPRF20625",91,10,83,6,12,60,71,77,"Pilot 7","Pilot 7: bigger feedback + text"
11,"SUPPRF20625",85,20,55,-10,1,40,54,65,"Pilot 7","Pilot 7: bigger feedback + text"
12,"SUPPRF20625",88,16,49,11,12,70,37,38,"Pilot 7","Pilot 7: bigger feedback + text"
13,"SUPPRF20625",86,15,63,3,0,45,63,60,"Pilot 7","Pilot 7: bigger feedback + text"
14,"SUPPRF20625",73,24,56,-19,-15,65,71,75,"Pilot 7","Pilot 7: bigger feedback + text"
15,"SUPPRF20625",69,31,50,-16,-13,70,63,66,"Pilot 7","Pilot 7: bigger feedback + text"
16,"SUPPRF20625",71,25,37,2,0,40,37,35,"Pilot 7","Pilot 7: bigger feedback + text"
17,"SUPPRF20625",84,18,78,8,15,55,63,70,"Pilot 7","Pilot 7: bigger feedback + text"
18,"SUPPRF20625",84,17,66,6,12,40,54,60,"Pilot 7","Pilot 7: bigger feedback + text"
19,"SUPPRF20625",66,37,24,-6,-13,60,37,30,"Pilot 7","Pilot 7: bigger feedback + text"
20,"SUPPRF20625",89,17,77,27,14,66,63,50,"Pilot 7","Pilot 7: bigger feedback + text"
21,"SUPPRF20625",89,10,51,19,14,70,37,32,"Pilot 7","Pilot 7: bigger feedback + text"
22,"SUPPRF20625",82,25,48,-7,19,30,29,55,"Pilot 7","Pilot 7: bigger feedback + text"
23,"SUPPRF20625",41,42,28,-27,-1,60,29,55,"Pilot 7","Pilot 7: bigger feedback + text"
24,"SUPPRF20625",35,53,15,-20,-14,35,29,35,"Pilot 7","Pilot 7: bigger feedback + text"
25,"SUPPRF20625",68,26,62,2,-1,40,63,60,"Pilot 7","Pilot 7: bigger feedback + text"
26,"SUPPRF20625",60,32,20,0,0,65,20,20,"Pilot 7","Pilot 7: bigger feedback + text"
27,"SUPPRF20625",71,27,29,4,0,60,29,25,"Pilot 7","Pilot 7: bigger feedback + text"
28,"SUPPRF20625",85,17,84,18,13,55,71,66,"Pilot 7","Pilot 7: bigger feedback + text"
29,"SUPPRF20625",37,37,38,-32,-16,40,54,70,"Pilot 7","Pilot 7: bigger feedback + text"
30,"SUPPRF20625",75,25,80,-5,0,70,80,85,"Pilot 7","Pilot 7: bigger feedback + text"
31,"SUPPRF20625",46,30,33,-14,-13,60,46,47,"Pilot 7","Pilot 7: bigger feedback + text"
32,"SUPPRF20625",57,26,67,-12,-13,55,80,79,"Pilot 7","Pilot 7: bigger feedback + text"
33,"SUPPRF20625",70,25,70,-8,-1,66,71,78,"Pilot 7","Pilot 7: bigger feedback + text"
34,"SUPPRF20625",76,32,35,12,15,60,20,23,"Pilot 7","Pilot 7: bigger feedback + text"
35,"SUPPRF20625",65,25,16,16,-13,30,29,0,"Pilot 7","Pilot 7: bigger feedback + text"
36,"SUPPRF20625",61,27,55,-17,-16,70,71,72,"Pilot 7","Pilot 7: bigger feedback + text"
37,"SUPPRF20625",44,42,6,-16,-14,41,20,22,"Pilot 7","Pilot 7: bigger feedback + text"
38,"SUPPRF20625",63,30,54,-1,0,40,54,55,"Pilot 7","Pilot 7: bigger feedback + text"
39,"SUPPRF20625",30,60,8,-17,-12,61,20,25,"Pilot 7","Pilot 7: bigger feedback + text"
40,"SUPPRF20625",61,27,58,8,12,55,46,50,"Pilot 7","Pilot 7: bigger feedback + text"
41,"SUPPRF20625",54,24,34,-11,-12,40,46,45,"Pilot 7","Pilot 7: bigger feedback + text"
42,"SUPPRF20625",75,30,46,-4,17,25,29,50,"Pilot 7","Pilot 7: bigger feedback + text"
43,"SUPPRF20625",55,35,47,-19,-16,66,63,66,"Pilot 7","Pilot 7: bigger feedback + text"
44,"SUPPRF20625",53,30,19,-2,-1,60,20,21,"Pilot 7","Pilot 7: bigger feedback + text"
45,"SUPPRF20625",47,69,46,-4,0,60,46,50,"Pilot 7","Pilot 7: bigger feedback + text"
46,"SUPPRF20625",61,26,68,-7,-12,60,80,75,"Pilot 7","Pilot 7: bigger feedback + text"
47,"SUPPRF20625",73,24,68,3,14,40,54,65,"Pilot 7","Pilot 7: bigger feedback + text"
48,"SUPPRF20625",48,31,41,-14,-13,55,54,55,"Pilot 7","Pilot 7: bigger feedback + text"
1,"SUPPRF48951",85,23,35,12,15,58,20,23,"Pilot 7","Pilot 7: bigger feedback + text"
2,"SUPPRF48951",84,16,78,11,15,71,63,67,"Pilot 7","Pilot 7: bigger feedback + text"
3,"SUPPRF48951",81,11,33,-24,-13,70,46,57,"Pilot 7","Pilot 7: bigger feedback + text"
4,"SUPPRF48951",83,11,16,-10,-13,66,29,26,"Pilot 7","Pilot 7: bigger feedback + text"
5,"SUPPRF48951",87,11,45,15,-1,75,46,30,"Pilot 7","Pilot 7: bigger feedback + text"
6,"SUPPRF48951",100,1,97,21,17,78,80,76,"Pilot 7","Pilot 7: bigger feedback + text"
7,"SUPPRF48951",99,3,83,6,12,83,71,77,"Pilot 7","Pilot 7: bigger feedback + text"
8,"SUPPRF48951",88,6,34,-12,-12,88,46,46,"Pilot 7","Pilot 7: bigger feedback + text"
9,"SUPPRF48951",87,8,15,-45,-14,72,29,60,"Pilot 7","Pilot 7: bigger feedback + text"
10,"SUPPRF48951",88,7,63,-13,0,87,63,76,"Pilot 7","Pilot 7: bigger feedback + text"
11,"SUPPRF48951",86,9,77,27,14,50,63,50,"Pilot 7","Pilot 7: bigger feedback + text"
12,"SUPPRF48951",85,9,81,13,1,68,80,68,"Pilot 7","Pilot 7: bigger feedback + text"
13,"SUPPRF48951",89,9,41,-16,-13,76,54,57,"Pilot 7","Pilot 7: bigger feedback + text"
14,"SUPPRF48951",92,9,55,-21,-16,89,71,76,"Pilot 7","Pilot 7: bigger feedback + text"
15,"SUPPRF48951",90,8,20,-1,0,85,20,21,"Pilot 7","Pilot 7: bigger feedback + text"
16,"SUPPRF48951",89,9,51,23,14,75,37,28,"Pilot 7","Pilot 7: bigger feedback + text"
17,"SUPPRF48951",90,7,49,8,12,93,37,41,"Pilot 7","Pilot 7: bigger feedback + text"
18,"SUPPRF48951",90,11,66,-1,12,85,54,67,"Pilot 7","Pilot 7: bigger feedback + text"
19,"SUPPRF48951",92,2,96,37,16,84,80,59,"Pilot 7","Pilot 7: bigger feedback + text"
20,"SUPPRF48951",91,7,70,-5,-1,85,71,75,"Pilot 7","Pilot 7: bigger feedback + text"
21,"SUPPRF48951",91,6,24,-13,-13,82,37,37,"Pilot 7","Pilot 7: bigger feedback + text"
22,"SUPPRF48951",89,10,46,12,0,71,46,34,"Pilot 7","Pilot 7: bigger feedback + text"
23,"SUPPRF48951",83,9,67,-10,-13,91,80,77,"Pilot 7","Pilot 7: bigger feedback + text"
24,"SUPPRF48951",82,9,56,-18,-15,87,71,74,"Pilot 7","Pilot 7: bigger feedback + text"
25,"SUPPRF48951",87,21,38,-16,-16,88,54,54,"Pilot 7","Pilot 7: bigger feedback + text"
26,"SUPPRF48951",82,12,38,2,1,79,37,36,"Pilot 7","Pilot 7: bigger feedback + text"
27,"SUPPRF48951",82,16,22,5,-15,86,37,17,"Pilot 7","Pilot 7: bigger feedback + text"
28,"SUPPRF48951",90,6,62,-2,-1,85,63,64,"Pilot 7","Pilot 7: bigger feedback + text"
29,"SUPPRF48951",83,17,50,-3,-13,69,63,53,"Pilot 7","Pilot 7: bigger feedback + text"
30,"SUPPRF48951",80,22,46,-18,17,85,29,64,"Pilot 7","Pilot 7: bigger feedback + text"
31,"SUPPRF48951",75,24,19,-25,-1,65,20,44,"Pilot 7","Pilot 7: bigger feedback + text"
32,"SUPPRF48951",68,28,37,-7,0,59,37,44,"Pilot 7","Pilot 7: bigger feedback + text"
33,"SUPPRF48951",74,19,29,-3,0,89,29,32,"Pilot 7","Pilot 7: bigger feedback + text"
34,"SUPPRF48951",72,25,54,-7,0,90,54,61,"Pilot 7","Pilot 7: bigger feedback + text"
35,"SUPPRF48951",76,20,68,6,14,79,54,62,"Pilot 7","Pilot 7: bigger feedback + text"
36,"SUPPRF48951",15,24,71,3,0,84,71,68,"Pilot 7","Pilot 7: bigger feedback + text"
37,"SUPPRF48951",79,21,58,27,12,82,46,31,"Pilot 7","Pilot 7: bigger feedback + text"
38,"SUPPRF48951",76,17,28,-5,-1,87,29,33,"Pilot 7","Pilot 7: bigger feedback + text"
39,"SUPPRF48951",77,22,8,-9,-12,91,20,17,"Pilot 7","Pilot 7: bigger feedback + text"
40,"SUPPRF48951",87,15,48,2,19,39,29,46,"Pilot 7","Pilot 7: bigger feedback + text"
41,"SUPPRF48951",56,37,68,19,-12,51,80,49,"Pilot 7","Pilot 7: bigger feedback + text"
42,"SUPPRF48951",66,41,47,-24,-16,38,63,71,"Pilot 7","Pilot 7: bigger feedback + text"
43,"SUPPRF48951",75,32,6,-10,-14,94,20,16,"Pilot 7","Pilot 7: bigger feedback + text"
44,"SUPPRF48951",81,25,84,17,13,37,71,67,"Pilot 7","Pilot 7: bigger feedback + text"
45,"SUPPRF48951",46,33,55,-8,1,57,54,63,"Pilot 7","Pilot 7: bigger feedback + text"
46,"SUPPRF48951",83,27,37,24,17,95,20,13,"Pilot 7","Pilot 7: bigger feedback + text"
47,"SUPPRF48951",79,20,65,23,19,86,46,42,"Pilot 7","Pilot 7: bigger feedback + text"
48,"SUPPRF48951",57,39,80,27,0,20,80,53,"Pilot 7","Pilot 7: bigger feedback + text"
1,"SUPPRF69892",91,13,38,4,1,61,37,34,"Pilot 7","Pilot 7: bigger feedback + text"
2,"SUPPRF69892",89,18,15,-9,-14,23,29,24,"Pilot 7","Pilot 7: bigger feedback + text"
3,"SUPPRF69892",81,10,6,-10,-14,61,20,16,"Pilot 7","Pilot 7: bigger feedback + text"
4,"SUPPRF69892",85,13,49,19,12,37,37,30,"Pilot 7","Pilot 7: bigger feedback + text"
5,"SUPPRF69892",78,25,33,-9,-13,28,46,42,"Pilot 7","Pilot 7: bigger feedback + text"
6,"SUPPRF69892",91,7,97,32,17,30,80,65,"Pilot 7","Pilot 7: bigger feedback + text"
7,"SUPPRF69892",90,11,65,23,19,60,46,42,"Pilot 7","Pilot 7: bigger feedback + text"
8,"SUPPRF69892",92,13,37,2,0,34,37,35,"Pilot 7","Pilot 7: bigger feedback + text"
9,"SUPPRF69892",74,13,68,-15,-12,26,80,83,"Pilot 7","Pilot 7: bigger feedback + text"
10,"SUPPRF69892",83,23,55,7,-16,38,71,48,"Pilot 7","Pilot 7: bigger feedback + text"
11,"SUPPRF69892",83,16,56,-22,-15,66,71,78,"Pilot 7","Pilot 7: bigger feedback + text"
12,"SUPPRF69892",92,24,96,25,16,30,80,71,"Pilot 7","Pilot 7: bigger feedback + text"
13,"SUPPRF69892",92,5,68,28,14,33,54,40,"Pilot 7","Pilot 7: bigger feedback + text"
14,"SUPPRF69892",90,13,45,0,-1,15,46,45,"Pilot 7","Pilot 7: bigger feedback + text"
15,"SUPPRF69892",88,9,55,3,1,44,54,52,"Pilot 7","Pilot 7: bigger feedback + text"
16,"SUPPRF69892",90,9,77,30,14,9,63,47,"Pilot 7","Pilot 7: bigger feedback + text"
17,"SUPPRF69892",58,6,80,-20,0,57,80,100,"Pilot 7","Pilot 7: bigger feedback + text"
18,"SUPPRF69892",92,14,34,-11,-12,31,46,45,"Pilot 7","Pilot 7: bigger feedback + text"
19,"SUPPRF69892",95,9,83,17,12,13,71,66,"Pilot 7","Pilot 7: bigger feedback + text"
20,"SUPPRF69892",91,10,84,30,13,19,71,54,"Pilot 7","Pilot 7: bigger feedback + text"
21,"SUPPRF69892",92,7,48,36,19,19,29,12,"Pilot 7","Pilot 7: bigger feedback + text"
22,"SUPPRF69892",91,8,16,-4,-13,36,29,20,"Pilot 7","Pilot 7: bigger feedback + text"
23,"SUPPRF69892",93,6,66,26,12,43,54,40,"Pilot 7","Pilot 7: bigger feedback + text"
24,"SUPPRF69892",94,5,63,24,0,23,63,39,"Pilot 7","Pilot 7: bigger feedback + text"
25,"SUPPRF69892",92,9,35,14,15,23,20,21,"Pilot 7","Pilot 7: bigger feedback + text"
26,"SUPPRF69892",90,12,78,24,15,10,63,54,"Pilot 7","Pilot 7: bigger feedback + text"
27,"SUPPRF69892",89,8,46,26,17,36,29,20,"Pilot 7","Pilot 7: bigger feedback + text"
28,"SUPPRF69892",90,11,24,-13,-13,27,37,37,"Pilot 7","Pilot 7: bigger feedback + text"
29,"SUPPRF69892",96,7,58,25,12,23,46,33,"Pilot 7","Pilot 7: bigger feedback + text"
30,"SUPPRF69892",92,7,51,14,14,6,37,37,"Pilot 7","Pilot 7: bigger feedback + text"
31,"SUPPRF69892",93,6,71,-3,0,10,71,74,"Pilot 7","Pilot 7: bigger feedback + text"
32,"SUPPRF69892",92,6,38,-12,-16,7,54,50,"Pilot 7","Pilot 7: bigger feedback + text"
33,"SUPPRF69892",93,5,37,21,17,6,20,16,"Pilot 7","Pilot 7: bigger feedback + text"
34,"SUPPRF69892",75,11,8,-13,-12,23,20,21,"Pilot 7","Pilot 7: bigger feedback + text"
35,"SUPPRF69892",92,6,41,-16,-13,13,54,57,"Pilot 7","Pilot 7: bigger feedback + text"
36,"SUPPRF69892",92,8,70,8,-1,6,71,62,"Pilot 7","Pilot 7: bigger feedback + text"
37,"SUPPRF69892",78,12,22,-7,-15,7,37,29,"Pilot 7","Pilot 7: bigger feedback + text"
38,"SUPPRF69892",88,12,19,7,-1,16,20,12,"Pilot 7","Pilot 7: bigger feedback + text"
39,"SUPPRF69892",87,11,81,-4,1,63,80,85,"Pilot 7","Pilot 7: bigger feedback + text"
40,"SUPPRF69892",68,14,67,-12,-13,73,80,79,"Pilot 7","Pilot 7: bigger feedback + text"
41,"SUPPRF69892",90,9,29,8,0,10,29,21,"Pilot 7","Pilot 7: bigger feedback + text"
42,"SUPPRF69892",88,9,20,16,0,66,20,4,"Pilot 7","Pilot 7: bigger feedback + text"
43,"SUPPRF69892",87,12,46,-4,0,12,46,50,"Pilot 7","Pilot 7: bigger feedback + text"
44,"SUPPRF69892",87,10,62,-6,-1,54,63,68,"Pilot 7","Pilot 7: bigger feedback + text"
45,"SUPPRF69892",84,11,50,-13,-13,24,63,63,"Pilot 7","Pilot 7: bigger feedback + text"
46,"SUPPRF69892",91,6,28,8,-1,7,29,20,"Pilot 7","Pilot 7: bigger feedback + text"
47,"SUPPRF69892",93,8,47,-7,-16,18,63,54,"Pilot 7","Pilot 7: bigger feedback + text"
48,"SUPPRF69892",94,6,54,3,0,40,54,51,"Pilot 7","Pilot 7: bigger feedback + text"
1,"SUPPRF06979",46,28,24,-1,-13,46,37,25,"Pilot 7","Pilot 7: bigger feedback + text"
2,"SUPPRF06979",59,22,47,-18,-16,81,63,65,"Pilot 7","Pilot 7: bigger feedback + text"
3,"SUPPRF06979",52,27,77,15,14,53,63,62,"Pilot 7","Pilot 7: bigger feedback + text"
4,"SUPPRF06979",65,37,46,28,17,62,29,18,"Pilot 7","Pilot 7: bigger feedback + text"
5,"SUPPRF06979",54,25,56,-17,-15,62,71,73,"Pilot 7","Pilot 7: bigger feedback + text"
6,"SUPPRF06979",68,27,62,-5,-1,84,63,67,"Pilot 7","Pilot 7: bigger feedback + text"
7,"SUPPRF06979",63,18,19,-34,-1,30,20,53,"Pilot 7","Pilot 7: bigger feedback + text"
8,"SUPPRF06979",59,19,15,-17,-14,69,29,32,"Pilot 7","Pilot 7: bigger feedback + text"
9,"SUPPRF06979",62,16,70,-3,-1,48,71,73,"Pilot 7","Pilot 7: bigger feedback + text"
10,"SUPPRF06979",66,16,84,16,13,62,71,68,"Pilot 7","Pilot 7: bigger feedback + text"
11,"SUPPRF06979",69,10,37,14,17,39,20,23,"Pilot 7","Pilot 7: bigger feedback + text"
12,"SUPPRF06979",64,20,34,-21,-12,67,46,55,"Pilot 7","Pilot 7: bigger feedback + text"
13,"SUPPRF06979",65,19,29,6,0,51,29,23,"Pilot 7","Pilot 7: bigger feedback + text"
14,"SUPPRF06979",64,17,50,-13,-13,67,63,63,"Pilot 7","Pilot 7: bigger feedback + text"
15,"SUPPRF06979",55,17,22,-17,-15,23,37,39,"Pilot 7","Pilot 7: bigger feedback + text"
16,"SUPPRF06979",54,10,38,-10,-16,65,54,48,"Pilot 7","Pilot 7: bigger feedback + text"
17,"SUPPRF06979",65,21,63,11,0,55,63,52,"Pilot 7","Pilot 7: bigger feedback + text"
18,"SUPPRF06979",69,14,83,17,12,64,71,66,"Pilot 7","Pilot 7: bigger feedback + text"
19,"SUPPRF06979",60,18,35,8,15,60,20,27,"Pilot 7","Pilot 7: bigger feedback + text"
20,"SUPPRF06979",59,16,51,18,14,66,37,33,"Pilot 7","Pilot 7: bigger feedback + text"
21,"SUPPRF06979",73,10,97,31,17,62,80,66,"Pilot 7","Pilot 7: bigger feedback + text"
22,"SUPPRF06979",63,12,68,4,14,64,54,64,"Pilot 7","Pilot 7: bigger feedback + text"
23,"SUPPRF06979",70,13,81,1,1,55,80,80,"Pilot 7","Pilot 7: bigger feedback + text"
24,"SUPPRF06979",59,16,37,11,0,55,37,26,"Pilot 7","Pilot 7: bigger feedback + text"
25,"SUPPRF06979",55,27,66,26,12,30,54,40,"Pilot 7","Pilot 7: bigger feedback + text"
26,"SUPPRF06979",76,10,96,15,16,63,80,81,"Pilot 7","Pilot 7: bigger feedback + text"
27,"SUPPRF06979",57,19,20,-6,0,37,20,26,"Pilot 7","Pilot 7: bigger feedback + text"
28,"SUPPRF06979",56,18,46,3,0,62,46,43,"Pilot 7","Pilot 7: bigger feedback + text"
29,"SUPPRF06979",74,23,58,8,12,56,46,50,"Pilot 7","Pilot 7: bigger feedback + text"
30,"SUPPRF06979",70,17,38,-2,1,55,37,40,"Pilot 7","Pilot 7: bigger feedback + text"
31,"SUPPRF06979",70,24,67,-16,-13,78,80,83,"Pilot 7","Pilot 7: bigger feedback + text"
32,"SUPPRF06979",66,17,54,2,0,57,54,52,"Pilot 7","Pilot 7: bigger feedback + text"
33,"SUPPRF06979",72,20,49,12,12,65,37,37,"Pilot 7","Pilot 7: bigger feedback + text"
34,"SUPPRF06979",63,13,80,3,0,59,80,77,"Pilot 7","Pilot 7: bigger feedback + text"
35,"SUPPRF06979",64,15,45,-15,-1,56,46,60,"Pilot 7","Pilot 7: bigger feedback + text"
36,"SUPPRF06979",64,19,68,-10,-12,62,80,78,"Pilot 7","Pilot 7: bigger feedback + text"
37,"SUPPRF06979",64,26,16,-15,-13,62,29,31,"Pilot 7","Pilot 7: bigger feedback + text"
38,"SUPPRF06979",70,8,65,13,19,63,46,52,"Pilot 7","Pilot 7: bigger feedback + text"
39,"SUPPRF06979",79,11,71,-3,0,73,71,74,"Pilot 7","Pilot 7: bigger feedback + text"
40,"SUPPRF06979",80,22,48,25,19,37,29,23,"Pilot 7","Pilot 7: bigger feedback + text"
41,"SUPPRF06979",56,20,33,-24,-13,77,46,57,"Pilot 7","Pilot 7: bigger feedback + text"
42,"SUPPRF06979",72,14,78,15,15,73,63,63,"Pilot 7","Pilot 7: bigger feedback + text"
43,"SUPPRF06979",51,41,55,-13,-16,38,71,68,"Pilot 7","Pilot 7: bigger feedback + text"
44,"SUPPRF06979",67,17,28,-5,-1,60,29,33,"Pilot 7","Pilot 7: bigger feedback + text"
45,"SUPPRF06979",51,15,8,-10,-12,64,20,18,"Pilot 7","Pilot 7: bigger feedback + text"
46,"SUPPRF06979",69,14,55,-3,1,67,54,58,"Pilot 7","Pilot 7: bigger feedback + text"
47,"SUPPRF06979",59,9,41,-14,-13,63,54,55,"Pilot 7","Pilot 7: bigger feedback + text"
48,"SUPPRF06979",51,9,6,-14,-14,66,20,20,"Pilot 7","Pilot 7: bigger feedback + text"
1,"SUPPRF59066",57,20,58,12,12,33,46,46,"Pilot 7","Pilot 7: bigger feedback + text"
2,"SUPPRF59066",64,6,20,0,0,29,20,20,"Pilot 7","Pilot 7: bigger feedback + text"
3,"SUPPRF59066",68,25,35,15,15,35,20,20,"Pilot 7","Pilot 7: bigger feedback + text"
4,"SUPPRF59066",40,40,22,-13,-15,16,37,35,"Pilot 7","Pilot 7: bigger feedback + text"
5,"SUPPRF59066",76,19,84,46,13,22,71,38,"Pilot 7","Pilot 7: bigger feedback + text"
6,"SUPPRF59066",43,38,56,6,-15,28,71,50,"Pilot 7","Pilot 7: bigger feedback + text"
7,"SUPPRF59066",40,65,29,-21,0,29,29,50,"Pilot 7","Pilot 7: bigger feedback + text"
8,"SUPPRF59066",58,41,37,-4,0,29,37,41,"Pilot 7","Pilot 7: bigger feedback + text"
9,"SUPPRF59066",75,31,78,18,15,50,63,60,"Pilot 7","Pilot 7: bigger feedback + text"
10,"SUPPRF59066",79,25,83,18,12,60,71,65,"Pilot 7","Pilot 7: bigger feedback + text"
11,"SUPPRF59066",77,14,81,10,1,60,80,71,"Pilot 7","Pilot 7: bigger feedback + text"
12,"SUPPRF59066",41,25,50,0,-13,65,63,50,"Pilot 7","Pilot 7: bigger feedback + text"
13,"SUPPRF59066",81,0,70,0,-1,60,71,70,"Pilot 7","Pilot 7: bigger feedback + text"
14,"SUPPRF59066",23,24,34,-11,-12,70,46,45,"Pilot 7","Pilot 7: bigger feedback + text"
15,"SUPPRF59066",40,29,46,11,0,70,46,35,"Pilot 7","Pilot 7: bigger feedback + text"
16,"SUPPRF59066",35,13,37,7,17,55,20,30,"Pilot 7","Pilot 7: bigger feedback + text"
17,"SUPPRF59066",68,19,66,16,12,35,54,50,"Pilot 7","Pilot 7: bigger feedback + text"
18,"SUPPRF59066",27,18,38,-12,-16,45,54,50,"Pilot 7","Pilot 7: bigger feedback + text"
19,"SUPPRF59066",21,5,15,-9,-14,20,29,24,"Pilot 7","Pilot 7: bigger feedback + text"
20,"SUPPRF59066",97,1,97,47,17,20,80,50,"Pilot 7","Pilot 7: bigger feedback + text"
21,"SUPPRF59066",72,0,68,33,14,25,54,35,"Pilot 7","Pilot 7: bigger feedback + text"
22,"SUPPRF59066",62,8,48,23,19,70,29,25,"Pilot 7","Pilot 7: bigger feedback + text"
23,"SUPPRF59066",27,8,67,-3,-13,25,80,70,"Pilot 7","Pilot 7: bigger feedback + text"
24,"SUPPRF59066",55,18,62,2,-1,25,63,60,"Pilot 7","Pilot 7: bigger feedback + text"
25,"SUPPRF59066",93,8,51,21,14,25,37,30,"Pilot 7","Pilot 7: bigger feedback + text"
26,"SUPPRF59066",84,7,49,25,12,45,37,24,"Pilot 7","Pilot 7: bigger feedback + text"
27,"SUPPRF59066",87,14,63,34,0,69,63,29,"Pilot 7","Pilot 7: bigger feedback + text"
28,"SUPPRF59066",99,0,96,36,16,40,80,60,"Pilot 7","Pilot 7: bigger feedback + text"
29,"SUPPRF59066",38,0,8,-17,-12,70,20,25,"Pilot 7","Pilot 7: bigger feedback + text"
30,"SUPPRF59066",73,7,68,-17,-12,75,80,85,"Pilot 7","Pilot 7: bigger feedback + text"
31,"SUPPRF59066",86,5,77,37,14,10,63,40,"Pilot 7","Pilot 7: bigger feedback + text"
32,"SUPPRF59066",60,6,46,16,17,55,29,30,"Pilot 7","Pilot 7: bigger feedback + text"
33,"SUPPRF59066",93,8,80,31,0,16,80,49,"Pilot 7","Pilot 7: bigger feedback + text"
34,"SUPPRF59066",97,5,54,3,0,30,54,51,"Pilot 7","Pilot 7: bigger feedback + text"
35,"SUPPRF59066",13,6,6,-20,-14,20,20,26,"Pilot 7","Pilot 7: bigger feedback + text"
36,"SUPPRF59066",36,17,41,-4,-13,60,54,45,"Pilot 7","Pilot 7: bigger feedback + text"
37,"SUPPRF59066",76,14,65,25,19,40,46,40,"Pilot 7","Pilot 7: bigger feedback + text"
38,"SUPPRF59066",12,13,24,-24,-13,29,37,48,"Pilot 7","Pilot 7: bigger feedback + text"
39,"SUPPRF59066",56,0,28,28,-1,80,29,0,"Pilot 7","Pilot 7: bigger feedback + text"
40,"SUPPRF59066",11,4,19,9,-1,80,20,10,"Pilot 7","Pilot 7: bigger feedback + text"
41,"SUPPRF59066",65,9,55,6,1,35,54,49,"Pilot 7","Pilot 7: bigger feedback + text"
42,"SUPPRF59066",58,37,47,-8,-16,45,63,55,"Pilot 7","Pilot 7: bigger feedback + text"
43,"SUPPRF59066",61,15,38,14,1,71,37,24,"Pilot 7","Pilot 7: bigger feedback + text"
44,"SUPPRF59066",32,21,16,-9,-13,49,29,25,"Pilot 7","Pilot 7: bigger feedback + text"
45,"SUPPRF59066",29,15,33,-18,-13,34,46,51,"Pilot 7","Pilot 7: bigger feedback + text"
46,"SUPPRF59066",93,16,71,36,0,19,71,35,"Pilot 7","Pilot 7: bigger feedback + text"
47,"SUPPRF59066",37,15,45,5,-1,65,46,40,"Pilot 7","Pilot 7: bigger feedback + text"
48,"SUPPRF59066",85,16,55,-14,-16,48,71,69,"Pilot 7","Pilot 7: bigger feedback + text"
1,"SUPPRF09587",75,1,77,31,14,71,63,46,"Pilot 7","Pilot 7: bigger feedback + text"
2,"SUPPRF09587",77,2,96,9,16,88,80,87,"Pilot 7","Pilot 7: bigger feedback + text"
3,"SUPPRF09587",75,3,45,-2,-1,65,46,47,"Pilot 7","Pilot 7: bigger feedback + text"
4,"SUPPRF09587",72,5,38,-37,-16,90,54,75,"Pilot 7","Pilot 7: bigger feedback + text"
5,"SUPPRF09587",70,12,29,-12,0,55,29,41,"Pilot 7","Pilot 7: bigger feedback + text"
6,"SUPPRF09587",67,30,54,2,0,46,54,52,"Pilot 7","Pilot 7: bigger feedback + text"
7,"SUPPRF09587",79,22,78,-6,15,74,63,84,"Pilot 7","Pilot 7: bigger feedback + text"
8,"SUPPRF09587",67,50,55,25,1,71,54,30,"Pilot 7","Pilot 7: bigger feedback + text"
9,"SUPPRF09587",52,48,33,12,-13,52,46,21,"Pilot 7","Pilot 7: bigger feedback + text"
10,"SUPPRF09587",82,41,70,2,-1,62,71,68,"Pilot 7","Pilot 7: bigger feedback + text"
11,"SUPPRF09587",71,44,71,17,0,69,71,54,"Pilot 7","Pilot 7: bigger feedback + text"
12,"SUPPRF09587",54,37,19,-10,-1,64,20,29,"Pilot 7","Pilot 7: bigger feedback + text"
13,"SUPPRF09587",62,30,81,-3,1,88,80,84,"Pilot 7","Pilot 7: bigger feedback + text"
14,"SUPPRF09587",53,44,55,-23,-16,95,71,78,"Pilot 7","Pilot 7: bigger feedback + text"
15,"SUPPRF09587",59,42,41,-13,-13,65,54,54,"Pilot 7","Pilot 7: bigger feedback + text"
16,"SUPPRF09587",60,36,20,9,0,70,20,11,"Pilot 7","Pilot 7: bigger feedback + text"
17,"SUPPRF09587",62,34,65,15,19,50,46,50,"Pilot 7","Pilot 7: bigger feedback + text"
18,"SUPPRF09587",52,39,22,-4,-15,59,37,26,"Pilot 7","Pilot 7: bigger feedback + text"
19,"SUPPRF09587",83,33,35,23,15,85,20,12,"Pilot 7","Pilot 7: bigger feedback + text"
20,"SUPPRF09587",62,39,68,-11,-12,79,80,79,"Pilot 7","Pilot 7: bigger feedback + text"
21,"SUPPRF09587",63,43,16,-30,-13,38,29,46,"Pilot 7","Pilot 7: bigger feedback + text"
22,"SUPPRF09587",70,39,37,15,0,84,37,22,"Pilot 7","Pilot 7: bigger feedback + text"
23,"SUPPRF09587",77,18,97,23,17,69,80,74,"Pilot 7","Pilot 7: bigger feedback + text"
24,"SUPPRF09587",57,47,67,-27,-13,96,80,94,"Pilot 7","Pilot 7: bigger feedback + text"
25,"SUPPRF09587",49,36,34,-15,-12,85,46,49,"Pilot 7","Pilot 7: bigger feedback + text"
26,"SUPPRF09587",62,31,50,-6,-13,47,63,56,"Pilot 7","Pilot 7: bigger feedback + text"
27,"SUPPRF09587",60,58,80,32,0,61,80,48,"Pilot 7","Pilot 7: bigger feedback + text"
28,"SUPPRF09587",58,42,46,33,17,91,29,13,"Pilot 7","Pilot 7: bigger feedback + text"
29,"SUPPRF09587",67,45,28,-1,-1,56,29,29,"Pilot 7","Pilot 7: bigger feedback + text"
30,"SUPPRF09587",47,43,38,-26,1,70,37,64,"Pilot 7","Pilot 7: bigger feedback + text"
31,"SUPPRF09587",48,51,49,2,12,69,37,47,"Pilot 7","Pilot 7: bigger feedback + text"
32,"SUPPRF09587",50,50,46,-3,0,50,46,49,"Pilot 7","Pilot 7: bigger feedback + text"
33,"SUPPRF09587",51,49,56,13,-15,51,71,43,"Pilot 7","Pilot 7: bigger feedback + text"
34,"SUPPRF09587",42,50,48,22,19,91,29,26,"Pilot 7","Pilot 7: bigger feedback + text"
35,"SUPPRF09587",46,46,84,29,13,71,71,55,"Pilot 7","Pilot 7: bigger feedback + text"
36,"SUPPRF09587",45,54,37,16,17,86,20,21,"Pilot 7","Pilot 7: bigger feedback + text"
37,"SUPPRF09587",48,49,15,-10,-14,76,29,25,"Pilot 7","Pilot 7: bigger feedback + text"
38,"SUPPRF09587",20,71,8,-4,-12,62,20,12,"Pilot 7","Pilot 7: bigger feedback + text"
39,"SUPPRF09587",34,53,51,-2,14,24,37,53,"Pilot 7","Pilot 7: bigger feedback + text"
40,"SUPPRF09587",3,58,6,-11,-14,83,20,17,"Pilot 7","Pilot 7: bigger feedback + text"
41,"SUPPRF09587",41,52,58,9,12,82,46,49,"Pilot 7","Pilot 7: bigger feedback + text"
42,"SUPPRF09587",49,53,63,8,0,66,63,55,"Pilot 7","Pilot 7: bigger feedback + text"
43,"SUPPRF09587",51,50,47,-10,-16,65,63,57,"Pilot 7","Pilot 7: bigger feedback + text"
44,"SUPPRF09587",57,47,66,30,12,70,54,36,"Pilot 7","Pilot 7: bigger feedback + text"
45,"SUPPRF09587",14,59,24,-21,-13,80,37,45,"Pilot 7","Pilot 7: bigger feedback + text"
46,"SUPPRF09587",58,42,62,-2,-1,54,63,64,"Pilot 7","Pilot 7: bigger feedback + text"
47,"SUPPRF09587",22,56,68,20,14,52,54,48,"Pilot 7","Pilot 7: bigger feedback + text"
48,"SUPPRF09587",23,64,83,51,12,76,71,32,"Pilot 7","Pilot 7: bigger feedback + text"
1,"SUPPRF83022",38,77,51,36,14,18,37,15,"Pilot 7","Pilot 7: bigger feedback + text"
2,"SUPPRF83022",7,95,20,-3,0,24,20,23,"Pilot 7","Pilot 7: bigger feedback + text"
3,"SUPPRF83022",42,62,46,34,17,19,29,12,"Pilot 7","Pilot 7: bigger feedback + text"
4,"SUPPRF83022",9,85,34,-12,-12,54,46,46,"Pilot 7","Pilot 7: bigger feedback + text"
5,"SUPPRF83022",30,64,49,20,12,42,37,29,"Pilot 7","Pilot 7: bigger feedback + text"
6,"SUPPRF83022",28,33,56,14,-15,19,71,42,"Pilot 7","Pilot 7: bigger feedback + text"
7,"SUPPRF83022",51,41,66,46,12,32,54,20,"Pilot 7","Pilot 7: bigger feedback + text"
8,"SUPPRF83022",1,100,8,-44,-12,65,20,52,"Pilot 7","Pilot 7: bigger feedback + text"
9,"SUPPRF83022",69,88,38,-7,-16,37,54,45,"Pilot 7","Pilot 7: bigger feedback + text"
10,"SUPPRF83022",64,51,65,7,19,45,46,58,"Pilot 7","Pilot 7: bigger feedback + text"
11,"SUPPRF83022",34,76,16,-34,-13,24,29,50,"Pilot 7","Pilot 7: bigger feedback + text"
12,"SUPPRF83022",53,55,29,12,0,24,29,17,"Pilot 7","Pilot 7: bigger feedback + text"
13,"SUPPRF83022",46,32,33,-25,-13,55,46,58,"Pilot 7","Pilot 7: bigger feedback + text"
14,"SUPPRF83022",53,49,19,-25,-1,41,20,44,"Pilot 7","Pilot 7: bigger feedback + text"
15,"SUPPRF83022",45,34,24,-25,-13,36,37,49,"Pilot 7","Pilot 7: bigger feedback + text"
16,"SUPPRF83022",66,40,50,14,-13,40,63,36,"Pilot 7","Pilot 7: bigger feedback + text"
17,"SUPPRF83022",35,36,38,-4,1,50,37,42,"Pilot 7","Pilot 7: bigger feedback + text"
18,"SUPPRF83022",51,67,28,-8,-1,8,29,36,"Pilot 7","Pilot 7: bigger feedback + text"
19,"SUPPRF83022",49,36,37,-19,0,45,37,56,"Pilot 7","Pilot 7: bigger feedback + text"
20,"SUPPRF83022",42,61,96,71,16,38,80,25,"Pilot 7","Pilot 7: bigger feedback + text"
21,"SUPPRF83022",49,57,48,4,19,41,29,44,"Pilot 7","Pilot 7: bigger feedback + text"
22,"SUPPRF83022",38,34,45,3,-1,37,46,42,"Pilot 7","Pilot 7: bigger feedback + text"
23,"SUPPRF83022",100,65,80,48,0,55,80,32,"Pilot 7","Pilot 7: bigger feedback + text"
24,"SUPPRF83022",58,31,68,32,-12,71,80,36,"Pilot 7","Pilot 7: bigger feedback + text"
25,"SUPPRF83022",27,51,46,36,0,23,46,10,"Pilot 7","Pilot 7: bigger feedback + text"
26,"SUPPRF83022",60,40,54,22,0,54,54,32,"Pilot 7","Pilot 7: bigger feedback + text"
27,"SUPPRF83022",30,73,35,8,15,16,20,27,"Pilot 7","Pilot 7: bigger feedback + text"
28,"SUPPRF83022",79,11,67,35,-13,39,80,32,"Pilot 7","Pilot 7: bigger feedback + text"
29,"SUPPRF83022",25,41,37,7,17,55,20,30,"Pilot 7","Pilot 7: bigger feedback + text"
30,"SUPPRF83022",19,100,15,-48,-14,74,29,63,"Pilot 7","Pilot 7: bigger feedback + text"
31,"SUPPRF83022",97,25,62,-9,-1,74,63,71,"Pilot 7","Pilot 7: bigger feedback + text"
32,"SUPPRF83022",26,6,84,19,13,51,71,65,"Pilot 7","Pilot 7: bigger feedback + text"
33,"SUPPRF83022",85,27,68,6,14,43,54,62,"Pilot 7","Pilot 7: bigger feedback + text"
34,"SUPPRF83022",11,71,6,-3,-14,82,20,9,"Pilot 7","Pilot 7: bigger feedback + text"
35,"SUPPRF83022",66,40,58,10,12,74,46,48,"Pilot 7","Pilot 7: bigger feedback + text"
36,"SUPPRF83022",99,4,81,61,1,0,80,20,"Pilot 7","Pilot 7: bigger feedback + text"
37,"SUPPRF83022",88,37,71,-4,0,59,71,75,"Pilot 7","Pilot 7: bigger feedback + text"
38,"SUPPRF83022",36,83,41,-15,-13,87,54,56,"Pilot 7","Pilot 7: bigger feedback + text"
39,"SUPPRF83022",91,46,55,0,-16,61,71,55,"Pilot 7","Pilot 7: bigger feedback + text"
40,"SUPPRF83022",57,52,22,-22,-15,80,37,44,"Pilot 7","Pilot 7: bigger feedback + text"
41,"SUPPRF83022",85,37,77,11,14,31,63,66,"Pilot 7","Pilot 7: bigger feedback + text"
42,"SUPPRF83022",90,0,97,81,17,3,80,16,"Pilot 7","Pilot 7: bigger feedback + text"
43,"SUPPRF83022",98,7,78,23,15,74,63,55,"Pilot 7","Pilot 7: bigger feedback + text"
44,"SUPPRF83022",59,40,63,-7,0,83,63,70,"Pilot 7","Pilot 7: bigger feedback + text"
45,"SUPPRF83022",67,64,55,17,1,83,54,38,"Pilot 7","Pilot 7: bigger feedback + text"
46,"SUPPRF83022",32,72,47,8,-16,26,63,39,"Pilot 7","Pilot 7: bigger feedback + text"
47,"SUPPRF83022",65,66,83,10,12,97,71,73,"Pilot 7","Pilot 7: bigger feedback + text"
48,"SUPPRF83022",95,0,70,6,-1,30,71,64,"Pilot 7","Pilot 7: bigger feedback + text"
1,"SUPPRF55556",55,42,83,18,12,56,71,65,"Pilot 7","Pilot 7: bigger feedback + text"
2,"SUPPRF55556",60,39,96,40,16,29,80,56,"Pilot 7","Pilot 7: bigger feedback + text"
3,"SUPPRF55556",49,33,63,41,0,54,63,22,"Pilot 7","Pilot 7: bigger feedback + text"
4,"SUPPRF55556",59,30,70,-11,-1,66,71,81,"Pilot 7","Pilot 7: bigger feedback + text"
5,"SUPPRF55556",43,37,54,16,0,62,54,38,"Pilot 7","Pilot 7: bigger feedback + text"
6,"SUPPRF55556",58,32,67,6,-13,61,80,61,"Pilot 7","Pilot 7: bigger feedback + text"
7,"SUPPRF55556",39,55,22,-24,-15,71,37,46,"Pilot 7","Pilot 7: bigger feedback + text"
8,"SUPPRF55556",37,57,37,-20,0,57,37,57,"Pilot 7","Pilot 7: bigger feedback + text"
9,"SUPPRF55556",58,47,58,18,12,24,46,40,"Pilot 7","Pilot 7: bigger feedback + text"
10,"SUPPRF55556",57,35,55,3,1,58,54,52,"Pilot 7","Pilot 7: bigger feedback + text"
11,"SUPPRF55556",39,28,28,3,-1,69,29,25,"Pilot 7","Pilot 7: bigger feedback + text"
12,"SUPPRF55556",47,42,24,-8,-13,73,37,32,"Pilot 7","Pilot 7: bigger feedback + text"
13,"SUPPRF55556",81,14,78,0,15,65,63,78,"Pilot 7","Pilot 7: bigger feedback + text"
14,"SUPPRF55556",81,12,97,65,17,70,80,32,"Pilot 7","Pilot 7: bigger feedback + text"
15,"SUPPRF55556",33,36,15,-11,-14,62,29,26,"Pilot 7","Pilot 7: bigger feedback + text"
16,"SUPPRF55556",52,44,71,14,0,28,71,57,"Pilot 7","Pilot 7: bigger feedback + text"
17,"SUPPRF55556",53,28,81,20,1,24,80,61,"Pilot 7","Pilot 7: bigger feedback + text"
18,"SUPPRF55556",49,53,66,-5,12,56,54,71,"Pilot 7","Pilot 7: bigger feedback + text"
19,"SUPPRF55556",45,40,80,30,0,56,80,50,"Pilot 7","Pilot 7: bigger feedback + text"
20,"SUPPRF55556",62,33,38,-1,-16,66,54,39,"Pilot 7","Pilot 7: bigger feedback + text"
21,"SUPPRF55556",16,49,8,-12,-12,70,20,20,"Pilot 7","Pilot 7: bigger feedback + text"
22,"SUPPRF55556",64,54,45,4,-1,35,46,41,"Pilot 7","Pilot 7: bigger feedback + text"
23,"SUPPRF55556",67,39,62,-1,-1,71,63,63,"Pilot 7","Pilot 7: bigger feedback + text"
24,"SUPPRF55556",45,51,20,7,0,70,20,13,"Pilot 7","Pilot 7: bigger feedback + text"
25,"SUPPRF55556",22,62,16,-10,-13,74,29,26,"Pilot 7","Pilot 7: bigger feedback + text"
26,"SUPPRF55556",33,51,56,-17,-15,75,71,73,"Pilot 7","Pilot 7: bigger feedback + text"
27,"SUPPRF55556",11,56,6,-8,-14,72,20,14,"Pilot 7","Pilot 7: bigger feedback + text"
28,"SUPPRF55556",43,53,46,22,17,61,29,24,"Pilot 7","Pilot 7: bigger feedback + text"
29,"SUPPRF55556",84,19,77,47,14,49,63,30,"Pilot 7","Pilot 7: bigger feedback + text"
30,"SUPPRF55556",18,61,34,-23,-12,33,46,57,"Pilot 7","Pilot 7: bigger feedback + text"
31,"SUPPRF55556",44,48,37,22,17,63,20,15,"Pilot 7","Pilot 7: bigger feedback + text"
32,"SUPPRF55556",51,38,48,9,19,62,29,39,"Pilot 7","Pilot 7: bigger feedback + text"
33,"SUPPRF55556",42,30,68,24,-12,18,80,44,"Pilot 7","Pilot 7: bigger feedback + text"
34,"SUPPRF55556",35,66,33,-5,-13,53,46,38,"Pilot 7","Pilot 7: bigger feedback + text"
35,"SUPPRF55556",58,32,68,41,14,42,54,27,"Pilot 7","Pilot 7: bigger feedback + text"
36,"SUPPRF55556",29,35,49,23,12,69,37,26,"Pilot 7","Pilot 7: bigger feedback + text"
37,"SUPPRF55556",19,87,35,7,15,82,20,28,"Pilot 7","Pilot 7: bigger feedback + text"
38,"SUPPRF55556",17,80,19,-7,-1,57,20,26,"Pilot 7","Pilot 7: bigger feedback + text"
39,"SUPPRF55556",18,78,50,19,-13,10,63,31,"Pilot 7","Pilot 7: bigger feedback + text"
40,"SUPPRF55556",9,90,29,-7,0,14,29,36,"Pilot 7","Pilot 7: bigger feedback + text"
41,"SUPPRF55556",9,88,41,-15,-13,43,54,56,"Pilot 7","Pilot 7: bigger feedback + text"
42,"SUPPRF55556",2,91,38,8,1,52,37,30,"Pilot 7","Pilot 7: bigger feedback + text"
43,"SUPPRF55556",8,94,65,32,19,26,46,33,"Pilot 7","Pilot 7: bigger feedback + text"
44,"SUPPRF55556",7,92,47,-15,-16,61,63,62,"Pilot 7","Pilot 7: bigger feedback + text"
45,"SUPPRF55556",5,93,46,-16,0,32,46,62,"Pilot 7","Pilot 7: bigger feedback + text"
46,"SUPPRF55556",1,99,84,83,13,1,71,1,"Pilot 7","Pilot 7: bigger feedback + text"
47,"SUPPRF55556",2,96,51,29,14,81,37,22,"Pilot 7","Pilot 7: bigger feedback + text"
48,"SUPPRF55556",3,97,55,-7,-16,71,71,62,"Pilot 7","Pilot 7: bigger feedback + text"
1,"SUPPRF37610",0,14,48,10,19,77,29,38,"Pilot 7","Pilot 7: bigger feedback + text"
2,"SUPPRF37610",0,11,38,0,-16,64,54,38,"Pilot 7","Pilot 7: bigger feedback + text"
3,"SUPPRF37610",0,12,70,-5,-1,66,71,75,"Pilot 7","Pilot 7: bigger feedback + text"
4,"SUPPRF37610",0,9,15,-25,-14,68,29,40,"Pilot 7","Pilot 7: bigger feedback + text"
5,"SUPPRF37610",0,10,62,18,-1,74,63,44,"Pilot 7","Pilot 7: bigger feedback + text"
6,"SUPPRF37610",0,8,54,-1,0,73,54,55,"Pilot 7","Pilot 7: bigger feedback + text"
7,"SUPPRF37610",0,8,34,-11,-12,79,46,45,"Pilot 7","Pilot 7: bigger feedback + text"
8,"SUPPRF37610",1,7,68,-10,-12,62,80,78,"Pilot 7","Pilot 7: bigger feedback + text"
9,"SUPPRF37610",0,10,33,-12,-13,63,46,45,"Pilot 7","Pilot 7: bigger feedback + text"
10,"SUPPRF37610",0,7,68,26,14,35,54,42,"Pilot 7","Pilot 7: bigger feedback + text"
11,"SUPPRF37610",0,11,50,-4,-13,47,63,54,"Pilot 7","Pilot 7: bigger feedback + text"
12,"SUPPRF37610",0,8,46,16,17,68,29,30,"Pilot 7","Pilot 7: bigger feedback + text"
13,"SUPPRF37610",0,6,22,-13,-15,16,37,35,"Pilot 7","Pilot 7: bigger feedback + text"
14,"SUPPRF37610",0,12,55,16,-16,72,71,39,"Pilot 7","Pilot 7: bigger feedback + text"
15,"SUPPRF37610",0,11,38,4,1,72,37,34,"Pilot 7","Pilot 7: bigger feedback + text"
16,"SUPPRF37610",0,9,16,-35,-13,47,29,51,"Pilot 7","Pilot 7: bigger feedback + text"
17,"SUPPRF37610",2,7,63,37,0,60,63,26,"Pilot 7","Pilot 7: bigger feedback + text"
18,"SUPPRF37610",7,9,29,-7,0,59,29,36,"Pilot 7","Pilot 7: bigger feedback + text"
19,"SUPPRF37610",0,6,41,-7,-13,86,54,48,"Pilot 7","Pilot 7: bigger feedback + text"
20,"SUPPRF37610",0,6,28,-26,-1,15,29,54,"Pilot 7","Pilot 7: bigger feedback + text"
21,"SUPPRF37610",0,8,58,23,12,71,46,35,"Pilot 7","Pilot 7: bigger feedback + text"
22,"SUPPRF37610",0,7,97,37,17,74,80,60,"Pilot 7","Pilot 7: bigger feedback + text"
23,"SUPPRF37610",0,11,37,-1,0,77,37,38,"Pilot 7","Pilot 7: bigger feedback + text"
24,"SUPPRF37610",0,8,84,11,13,67,71,73,"Pilot 7","Pilot 7: bigger feedback + text"
25,"SUPPRF37610",0,7,35,15,15,64,20,20,"Pilot 7","Pilot 7: bigger feedback + text"
26,"SUPPRF37610",0,0,6,-29,-14,32,20,35,"Pilot 7","Pilot 7: bigger feedback + text"
27,"SUPPRF37610",0,0,80,-1,0,68,80,81,"Pilot 7","Pilot 7: bigger feedback + text"
28,"SUPPRF37610",0,0,55,4,1,51,54,51,"Pilot 7","Pilot 7: bigger feedback + text"
29,"SUPPRF37610",0,0,45,-9,-1,49,46,54,"Pilot 7","Pilot 7: bigger feedback + text"
30,"SUPPRF37610",0,0,47,-18,-16,52,63,65,"Pilot 7","Pilot 7: bigger feedback + text"
31,"SUPPRF37610",1,1,56,-5,-15,16,71,61,"Pilot 7","Pilot 7: bigger feedback + text"
32,"SUPPRF37610",0,7,24,15,-13,17,37,9,"Pilot 7","Pilot 7: bigger feedback + text"
33,"SUPPRF37610",0,0,71,19,0,28,71,52,"Pilot 7","Pilot 7: bigger feedback + text"
34,"SUPPRF37610",4,0,8,-12,-12,64,20,20,"Pilot 7","Pilot 7: bigger feedback + text"
35,"SUPPRF37610",0,18,51,2,14,65,37,49,"Pilot 7","Pilot 7: bigger feedback + text"
36,"SUPPRF37610",0,0,67,-2,-13,67,80,69,"Pilot 7","Pilot 7: bigger feedback + text"
37,"SUPPRF37610",2,0,20,7,0,67,20,13,"Pilot 7","Pilot 7: bigger feedback + text"
38,"SUPPRF37610",0,2,66,19,12,49,54,47,"Pilot 7","Pilot 7: bigger feedback + text"
39,"SUPPRF37610",0,2,46,-9,0,64,46,55,"Pilot 7","Pilot 7: bigger feedback + text"
40,"SUPPRF37610",0,0,65,4,19,4,46,61,"Pilot 7","Pilot 7: bigger feedback + text"
41,"SUPPRF37610",0,3,96,21,16,61,80,75,"Pilot 7","Pilot 7: bigger feedback + text"
42,"SUPPRF37610",0,0,83,26,12,33,71,57,"Pilot 7","Pilot 7: bigger feedback + text"
43,"SUPPRF37610",0,0,78,3,15,69,63,75,"Pilot 7","Pilot 7: bigger feedback + text"
44,"SUPPRF37610",0,0,77,7,14,81,63,70,"Pilot 7","Pilot 7: bigger feedback + text"
45,"SUPPRF37610",0,23,49,42,12,0,37,7,"Pilot 7","Pilot 7: bigger feedback + text"
46,"SUPPRF37610",0,41,37,31,17,38,20,6,"Pilot 7","Pilot 7: bigger feedback + text"
47,"SUPPRF37610",0,58,81,12,1,40,80,69,"Pilot 7","Pilot 7: bigger feedback + text"
48,"SUPPRF37610",0,71,19,-36,-1,5,20,55,"Pilot 7","Pilot 7: bigger feedback + text"
1,"SUPPRF75783",78,23,22,0,-15,19,37,22,"Pilot 7","Pilot 7: bigger feedback + text"
2,"SUPPRF75783",85,18,84,30,13,44,71,54,"Pilot 7","Pilot 7: bigger feedback + text"
3,"SUPPRF75783",80,13,20,-15,0,21,20,35,"Pilot 7","Pilot 7: bigger feedback + text"
4,"SUPPRF75783",75,16,16,-47,-13,34,29,63,"Pilot 7","Pilot 7: bigger feedback + text"
5,"SUPPRF75783",82,13,70,63,-1,92,71,7,"Pilot 7","Pilot 7: bigger feedback + text"
6,"SUPPRF75783",85,8,49,30,12,30,37,19,"Pilot 7","Pilot 7: bigger feedback + text"
7,"SUPPRF75783",84,9,41,-2,-13,73,54,43,"Pilot 7","Pilot 7: bigger feedback + text"
8,"SUPPRF75783",80,12,28,28,-1,100,29,0,"Pilot 7","Pilot 7: bigger feedback + text"
9,"SUPPRF75783",83,15,55,0,1,27,54,55,"Pilot 7","Pilot 7: bigger feedback + text"
10,"SUPPRF75783",82,11,96,42,16,51,80,54,"Pilot 7","Pilot 7: bigger feedback + text"
11,"SUPPRF75783",80,15,81,5,1,79,80,76,"Pilot 7","Pilot 7: bigger feedback + text"
12,"SUPPRF75783",82,15,37,-44,0,82,37,81,"Pilot 7","Pilot 7: bigger feedback + text"
13,"SUPPRF75783",82,7,97,32,17,60,80,65,"Pilot 7","Pilot 7: bigger feedback + text"
14,"SUPPRF75783",87,16,46,36,0,71,46,10,"Pilot 7","Pilot 7: bigger feedback + text"
15,"SUPPRF75783",88,13,34,-38,-12,81,46,72,"Pilot 7","Pilot 7: bigger feedback + text"
16,"SUPPRF75783",85,14,50,12,-13,28,63,38,"Pilot 7","Pilot 7: bigger feedback + text"
17,"SUPPRF75783",84,12,56,-10,-15,58,71,66,"Pilot 7","Pilot 7: bigger feedback + text"
18,"SUPPRF75783",76,13,6,-54,-14,60,20,60,"Pilot 7","Pilot 7: bigger feedback + text"
19,"SUPPRF75783",90,4,63,57,0,79,63,6,"Pilot 7","Pilot 7: bigger feedback + text"
20,"SUPPRF75783",90,13,51,-33,14,75,37,84,"Pilot 7","Pilot 7: bigger feedback + text"
21,"SUPPRF75783",76,13,15,-66,-14,96,29,81,"Pilot 7","Pilot 7: bigger feedback + text"
22,"SUPPRF75783",85,11,83,49,12,33,71,34,"Pilot 7","Pilot 7: bigger feedback + text"
23,"SUPPRF75783",85,12,47,17,-16,28,63,30,"Pilot 7","Pilot 7: bigger feedback + text"
24,"SUPPRF75783",85,10,37,36,17,93,20,1,"Pilot 7","Pilot 7: bigger feedback + text"
25,"SUPPRF75783",85,10,66,29,12,37,54,37,"Pilot 7","Pilot 7: bigger feedback + text"
26,"SUPPRF75783",75,18,29,-32,0,35,29,61,"Pilot 7","Pilot 7: bigger feedback + text"
27,"SUPPRF75783",79,19,8,4,-12,92,20,4,"Pilot 7","Pilot 7: bigger feedback + text"
28,"SUPPRF75783",85,9,46,30,17,85,29,16,"Pilot 7","Pilot 7: bigger feedback + text"
29,"SUPPRF75783",90,10,62,34,-1,48,63,28,"Pilot 7","Pilot 7: bigger feedback + text"
30,"SUPPRF75783",87,9,45,20,-1,50,46,25,"Pilot 7","Pilot 7: bigger feedback + text"
31,"SUPPRF75783",78,20,67,47,-13,26,80,20,"Pilot 7","Pilot 7: bigger feedback + text"
32,"SUPPRF75783",76,15,33,5,-13,57,46,28,"Pilot 7","Pilot 7: bigger feedback + text"
33,"SUPPRF75783",75,22,54,54,0,100,54,0,"Pilot 7","Pilot 7: bigger feedback + text"
34,"SUPPRF75783",83,10,55,18,-16,35,71,37,"Pilot 7","Pilot 7: bigger feedback + text"
35,"SUPPRF75783",89,9,71,-22,0,90,71,93,"Pilot 7","Pilot 7: bigger feedback + text"
36,"SUPPRF75783",85,17,48,24,19,35,29,24,"Pilot 7","Pilot 7: bigger feedback + text"
37,"SUPPRF75783",79,18,38,11,1,55,37,27,"Pilot 7","Pilot 7: bigger feedback + text"
38,"SUPPRF75783",81,15,65,28,19,33,46,37,"Pilot 7","Pilot 7: bigger feedback + text"
39,"SUPPRF75783",76,23,19,6,-1,41,20,13,"Pilot 7","Pilot 7: bigger feedback + text"
40,"SUPPRF75783",80,16,58,32,12,17,46,26,"Pilot 7","Pilot 7: bigger feedback + text"
41,"SUPPRF75783",74,32,35,34,15,92,20,1,"Pilot 7","Pilot 7: bigger feedback + text"
42,"SUPPRF75783",74,28,24,-57,-13,84,37,81,"Pilot 7","Pilot 7: bigger feedback + text"
43,"SUPPRF75783",91,4,80,10,0,63,80,70,"Pilot 7","Pilot 7: bigger feedback + text"
44,"SUPPRF75783",84,13,68,4,14,55,54,64,"Pilot 7","Pilot 7: bigger feedback + text"
45,"SUPPRF75783",94,9,78,35,15,51,63,43,"Pilot 7","Pilot 7: bigger feedback + text"
46,"SUPPRF75783",85,13,77,52,14,42,63,25,"Pilot 7","Pilot 7: bigger feedback + text"
47,"SUPPRF75783",72,32,38,31,-16,22,54,7,"Pilot 7","Pilot 7: bigger feedback + text"
48,"SUPPRF75783",77,18,68,44,-12,42,80,24,"Pilot 7","Pilot 7: bigger feedback + text"
1,"SUPPRF84283",34,45,33,-25,-13,78,46,58,"Pilot 7","Pilot 7: bigger feedback + text"
2,"SUPPRF84283",49,57,66,22,12,80,54,44,"Pilot 7","Pilot 7: bigger feedback + text"
3,"SUPPRF84283",49,59,81,21,1,79,80,60,"Pilot 7","Pilot 7: bigger feedback + text"
4,"SUPPRF84283",44,61,49,10,12,77,37,39,"Pilot 7","Pilot 7: bigger feedback + text"
5,"SUPPRF84283",45,64,56,-15,-15,82,71,71,"Pilot 7","Pilot 7: bigger feedback + text"
6,"SUPPRF84283",42,60,16,-41,-13,53,29,57,"Pilot 7","Pilot 7: bigger feedback + text"
7,"SUPPRF84283",42,65,47,-11,-16,61,63,58,"Pilot 7","Pilot 7: bigger feedback + text"
8,"SUPPRF84283",38,61,58,12,12,80,46,46,"Pilot 7","Pilot 7: bigger feedback + text"
9,"SUPPRF84283",37,62,34,-23,-12,52,46,57,"Pilot 7","Pilot 7: bigger feedback + text"
10,"SUPPRF84283",36,68,62,5,-1,52,63,57,"Pilot 7","Pilot 7: bigger feedback + text"
11,"SUPPRF84283",42,60,77,17,14,77,63,60,"Pilot 7","Pilot 7: bigger feedback + text"
12,"SUPPRF84283",34,67,38,-17,-16,59,54,55,"Pilot 7","Pilot 7: bigger feedback + text"
13,"SUPPRF84283",42,64,80,18,0,70,80,62,"Pilot 7","Pilot 7: bigger feedback + text"
14,"SUPPRF84283",35,64,97,14,17,90,80,83,"Pilot 7","Pilot 7: bigger feedback + text"
15,"SUPPRF84283",32,64,28,-32,-1,77,29,60,"Pilot 7","Pilot 7: bigger feedback + text"
16,"SUPPRF84283",38,64,22,-32,-15,61,37,54,"Pilot 7","Pilot 7: bigger feedback + text"
17,"SUPPRF84283",40,65,37,-44,0,75,37,81,"Pilot 7","Pilot 7: bigger feedback + text"
18,"SUPPRF84283",33,66,38,-11,1,46,37,49,"Pilot 7","Pilot 7: bigger feedback + text"
19,"SUPPRF84283",33,63,50,-25,-13,68,63,75,"Pilot 7","Pilot 7: bigger feedback + text"
20,"SUPPRF84283",31,68,54,-16,0,79,54,70,"Pilot 7","Pilot 7: bigger feedback + text"
21,"SUPPRF84283",39,70,55,-13,-16,71,71,68,"Pilot 7","Pilot 7: bigger feedback + text"
22,"SUPPRF84283",38,63,37,-33,17,58,20,70,"Pilot 7","Pilot 7: bigger feedback + text"
23,"SUPPRF84283",43,59,29,-20,0,52,29,49,"Pilot 7","Pilot 7: bigger feedback + text"
24,"SUPPRF84283",35,68,71,-22,0,84,71,93,"Pilot 7","Pilot 7: bigger feedback + text"
25,"SUPPRF84283",44,61,19,-34,-1,43,20,53,"Pilot 7","Pilot 7: bigger feedback + text"
26,"SUPPRF84283",40,65,78,17,15,81,63,61,"Pilot 7","Pilot 7: bigger feedback + text"
27,"SUPPRF84283",40,67,15,-27,-14,60,29,42,"Pilot 7","Pilot 7: bigger feedback + text"
28,"SUPPRF84283",40,67,68,-14,-12,83,80,82,"Pilot 7","Pilot 7: bigger feedback + text"
29,"SUPPRF84283",36,64,45,-11,-1,66,46,56,"Pilot 7","Pilot 7: bigger feedback + text"
30,"SUPPRF84283",35,68,65,7,19,63,46,58,"Pilot 7","Pilot 7: bigger feedback + text"
31,"SUPPRF84283",35,70,6,-59,-14,83,20,65,"Pilot 7","Pilot 7: bigger feedback + text"
32,"SUPPRF84283",41,64,63,-13,0,78,63,76,"Pilot 7","Pilot 7: bigger feedback + text"
33,"SUPPRF84283",39,60,24,-39,-13,75,37,63,"Pilot 7","Pilot 7: bigger feedback + text"
34,"SUPPRF84283",43,63,48,-17,19,68,29,65,"Pilot 7","Pilot 7: bigger feedback + text"
35,"SUPPRF84283",38,63,84,-16,13,100,71,100,"Pilot 7","Pilot 7: bigger feedback + text"
36,"SUPPRF84283",34,67,46,-25,17,78,29,71,"Pilot 7","Pilot 7: bigger feedback + text"
37,"SUPPRF84283",36,60,35,-31,15,81,20,66,"Pilot 7","Pilot 7: bigger feedback + text"
38,"SUPPRF84283",40,63,51,-13,14,71,37,64,"Pilot 7","Pilot 7: bigger feedback + text"
39,"SUPPRF84283",40,70,96,23,16,86,80,73,"Pilot 7","Pilot 7: bigger feedback + text"
40,"SUPPRF84283",37,72,70,-15,-1,90,71,85,"Pilot 7","Pilot 7: bigger feedback + text"
41,"SUPPRF84283",41,70,8,-58,-12,76,20,66,"Pilot 7","Pilot 7: bigger feedback + text"
42,"SUPPRF84283",32,71,41,-45,-13,83,54,86,"Pilot 7","Pilot 7: bigger feedback + text"
43,"SUPPRF84283",41,62,55,-12,1,72,54,67,"Pilot 7","Pilot 7: bigger feedback + text"
44,"SUPPRF84283",37,69,46,-33,0,85,46,79,"Pilot 7","Pilot 7: bigger feedback + text"
45,"SUPPRF84283",27,64,20,-43,0,78,20,63,"Pilot 7","Pilot 7: bigger feedback + text"
46,"SUPPRF84283",35,64,67,-2,-13,72,80,69,"Pilot 7","Pilot 7: bigger feedback + text"
47,"SUPPRF84283",40,70,83,8,12,92,71,75,"Pilot 7","Pilot 7: bigger feedback + text"
48,"SUPPRF84283",41,62,68,-3,14,88,54,71,"Pilot 7","Pilot 7: bigger feedback + text"
1,"SUPPRF61088",43,40,62,10,-1,66,63,52,"Pilot 7","Pilot 7: bigger feedback + text"
2,"SUPPRF61088",32,39,24,-10,-13,26,37,34,"Pilot 7","Pilot 7: bigger feedback + text"
3,"SUPPRF61088",34,31,46,19,17,79,29,27,"Pilot 7","Pilot 7: bigger feedback + text"
4,"SUPPRF61088",29,23,68,29,14,62,54,39,"Pilot 7","Pilot 7: bigger feedback + text"
5,"SUPPRF61088",34,30,6,-12,-14,70,20,18,"Pilot 7","Pilot 7: bigger feedback + text"
6,"SUPPRF61088",30,32,29,2,0,63,29,27,"Pilot 7","Pilot 7: bigger feedback + text"
7,"SUPPRF61088",40,34,41,5,-13,43,54,36,"Pilot 7","Pilot 7: bigger feedback + text"
8,"SUPPRF61088",36,47,34,-5,-12,29,46,39,"Pilot 7","Pilot 7: bigger feedback + text"
9,"SUPPRF61088",29,28,38,-26,-16,34,54,64,"Pilot 7","Pilot 7: bigger feedback + text"
10,"SUPPRF61088",39,29,63,28,0,31,63,35,"Pilot 7","Pilot 7: bigger feedback + text"
11,"SUPPRF61088",31,21,33,-20,-13,40,46,53,"Pilot 7","Pilot 7: bigger feedback + text"
12,"SUPPRF61088",43,21,49,5,12,31,37,44,"Pilot 7","Pilot 7: bigger feedback + text"
13,"SUPPRF61088",51,12,97,17,17,77,80,80,"Pilot 7","Pilot 7: bigger feedback + text"
14,"SUPPRF61088",38,12,80,9,0,42,80,71,"Pilot 7","Pilot 7: bigger feedback + text"
15,"SUPPRF61088",37,11,56,-10,-15,32,71,66,"Pilot 7","Pilot 7: bigger feedback + text"
16,"SUPPRF61088",43,10,81,6,1,37,80,75,"Pilot 7","Pilot 7: bigger feedback + text"
17,"SUPPRF61088",39,10,71,-6,0,68,71,77,"Pilot 7","Pilot 7: bigger feedback + text"
18,"SUPPRF61088",39,13,35,10,15,63,20,25,"Pilot 7","Pilot 7: bigger feedback + text"
19,"SUPPRF61088",60,20,77,30,14,19,63,47,"Pilot 7","Pilot 7: bigger feedback + text"
20,"SUPPRF61088",39,18,78,14,15,42,63,64,"Pilot 7","Pilot 7: bigger feedback + text"
21,"SUPPRF61088",32,12,50,-6,-13,59,63,56,"Pilot 7","Pilot 7: bigger feedback + text"
22,"SUPPRF61088",31,15,55,15,-16,35,71,40,"Pilot 7","Pilot 7: bigger feedback + text"
23,"SUPPRF61088",25,18,55,-5,1,65,54,60,"Pilot 7","Pilot 7: bigger feedback + text"
24,"SUPPRF61088",34,26,45,-21,-1,44,46,66,"Pilot 7","Pilot 7: bigger feedback + text"
25,"SUPPRF61088",31,15,84,39,13,24,71,45,"Pilot 7","Pilot 7: bigger feedback + text"
26,"SUPPRF61088",22,14,58,5,12,29,46,53,"Pilot 7","Pilot 7: bigger feedback + text"
27,"SUPPRF61088",16,21,96,41,16,49,80,55,"Pilot 7","Pilot 7: bigger feedback + text"
28,"SUPPRF61088",20,14,67,-16,-13,82,80,83,"Pilot 7","Pilot 7: bigger feedback + text"
29,"SUPPRF61088",14,20,8,-46,-12,33,20,54,"Pilot 7","Pilot 7: bigger feedback + text"
30,"SUPPRF61088",26,11,28,2,-1,65,29,26,"Pilot 7","Pilot 7: bigger feedback + text"
31,"SUPPRF61088",20,18,66,40,12,11,54,26,"Pilot 7","Pilot 7: bigger feedback + text"
32,"SUPPRF61088",20,9,83,15,12,27,71,68,"Pilot 7","Pilot 7: bigger feedback + text"
33,"SUPPRF61088",27,7,20,1,0,63,20,19,"Pilot 7","Pilot 7: bigger feedback + text"
34,"SUPPRF61088",30,20,16,-23,-13,32,29,39,"Pilot 7","Pilot 7: bigger feedback + text"
35,"SUPPRF61088",24,20,15,-18,-14,24,29,33,"Pilot 7","Pilot 7: bigger feedback + text"
36,"SUPPRF61088",32,7,65,26,19,33,46,39,"Pilot 7","Pilot 7: bigger feedback + text"
37,"SUPPRF61088",19,12,22,-30,-15,43,37,52,"Pilot 7","Pilot 7: bigger feedback + text"
38,"SUPPRF61088",26,11,37,17,17,79,20,20,"Pilot 7","Pilot 7: bigger feedback + text"
39,"SUPPRF61088",34,13,46,-9,0,61,46,55,"Pilot 7","Pilot 7: bigger feedback + text"
40,"SUPPRF61088",19,8,51,-3,14,62,37,54,"Pilot 7","Pilot 7: bigger feedback + text"
41,"SUPPRF61088",24,9,68,34,-12,30,80,34,"Pilot 7","Pilot 7: bigger feedback + text"
42,"SUPPRF61088",20,9,70,9,-1,59,71,61,"Pilot 7","Pilot 7: bigger feedback + text"
43,"SUPPRF61088",13,9,48,27,19,84,29,21,"Pilot 7","Pilot 7: bigger feedback + text"
44,"SUPPRF61088",23,16,38,24,1,7,37,14,"Pilot 7","Pilot 7: bigger feedback + text"
45,"SUPPRF61088",17,7,47,-6,-16,65,63,53,"Pilot 7","Pilot 7: bigger feedback + text"
46,"SUPPRF61088",16,6,37,21,0,4,37,16,"Pilot 7","Pilot 7: bigger feedback + text"
47,"SUPPRF61088",17,7,19,-1,-1,74,20,20,"Pilot 7","Pilot 7: bigger feedback + text"
48,"SUPPRF61088",23,11,54,1,0,60,54,53,"Pilot 7","Pilot 7: bigger feedback + text"
1,"SUPPRF94460",49,2,50,6,-13,23,63,44,"Pilot 7","Pilot 7: bigger feedback + text"
2,"SUPPRF94460",50,5,37,24,17,6,20,13,"Pilot 7","Pilot 7: bigger feedback + text"
3,"SUPPRF94460",51,4,6,-5,-14,14,20,11,"Pilot 7","Pilot 7: bigger feedback + text"
4,"SUPPRF94460",48,7,29,-2,0,61,29,31,"Pilot 7","Pilot 7: bigger feedback + text"
5,"SUPPRF94460",51,7,58,10,12,49,46,48,"Pilot 7","Pilot 7: bigger feedback + text"
6,"SUPPRF94460",40,10,66,18,12,46,54,48,"Pilot 7","Pilot 7: bigger feedback + text"
7,"SUPPRF94460",52,8,81,-1,1,86,80,82,"Pilot 7","Pilot 7: bigger feedback + text"
8,"SUPPRF94460",50,10,65,12,19,56,46,53,"Pilot 7","Pilot 7: bigger feedback + text"
9,"SUPPRF94460",39,14,22,0,-15,28,37,22,"Pilot 7","Pilot 7: bigger feedback + text"
10,"SUPPRF94460",44,12,68,14,14,54,54,54,"Pilot 7","Pilot 7: bigger feedback + text"
11,"SUPPRF94460",44,12,34,6,-12,27,46,28,"Pilot 7","Pilot 7: bigger feedback + text"
12,"SUPPRF94460",45,14,33,3,-13,29,46,30,"Pilot 7","Pilot 7: bigger feedback + text"
13,"SUPPRF94460",46,7,41,-9,-13,42,54,50,"Pilot 7","Pilot 7: bigger feedback + text"
14,"SUPPRF94460",45,7,83,16,12,60,71,67,"Pilot 7","Pilot 7: bigger feedback + text"
15,"SUPPRF94460",45,6,71,-7,0,65,71,78,"Pilot 7","Pilot 7: bigger feedback + text"
16,"SUPPRF94460",43,12,38,-1,1,24,37,39,"Pilot 7","Pilot 7: bigger feedback + text"
17,"SUPPRF94460",46,16,68,-8,-12,55,80,76,"Pilot 7","Pilot 7: bigger feedback + text"
18,"SUPPRF94460",45,10,45,7,-1,41,46,38,"Pilot 7","Pilot 7: bigger feedback + text"
19,"SUPPRF94460",46,17,84,29,13,50,71,55,"Pilot 7","Pilot 7: bigger feedback + text"
20,"SUPPRF94460",24,47,46,15,0,63,46,31,"Pilot 7","Pilot 7: bigger feedback + text"
21,"SUPPRF94460",41,17,20,7,0,38,20,13,"Pilot 7","Pilot 7: bigger feedback + text"
22,"SUPPRF94460",39,25,56,10,-15,56,71,46,"Pilot 7","Pilot 7: bigger feedback + text"
23,"SUPPRF94460",41,25,55,-2,-16,51,71,57,"Pilot 7","Pilot 7: bigger feedback + text"
24,"SUPPRF94460",35,25,16,-16,-13,28,29,32,"Pilot 7","Pilot 7: bigger feedback + text"
25,"SUPPRF94460",38,25,37,13,0,27,37,24,"Pilot 7","Pilot 7: bigger feedback + text"
26,"SUPPRF94460",33,25,38,-6,-16,37,54,44,"Pilot 7","Pilot 7: bigger feedback + text"
27,"SUPPRF94460",43,27,67,4,-13,45,80,63,"Pilot 7","Pilot 7: bigger feedback + text"
28,"SUPPRF94460",50,28,80,21,0,24,80,59,"Pilot 7","Pilot 7: bigger feedback + text"
29,"SUPPRF94460",38,33,15,-4,-14,34,29,19,"Pilot 7","Pilot 7: bigger feedback + text"
30,"SUPPRF94460",40,18,46,30,17,66,29,16,"Pilot 7","Pilot 7: bigger feedback + text"
31,"SUPPRF94460",37,27,48,25,19,34,29,23,"Pilot 7","Pilot 7: bigger feedback + text"
32,"SUPPRF94460",13,32,54,-5,0,56,54,59,"Pilot 7","Pilot 7: bigger feedback + text"
33,"SUPPRF94460",19,59,19,6,-1,32,20,13,"Pilot 7","Pilot 7: bigger feedback + text"
34,"SUPPRF94460",32,76,97,30,17,51,80,67,"Pilot 7","Pilot 7: bigger feedback + text"
35,"SUPPRF94460",54,67,96,19,16,64,80,77,"Pilot 7","Pilot 7: bigger feedback + text"
36,"SUPPRF94460",29,72,77,20,14,53,63,57,"Pilot 7","Pilot 7: bigger feedback + text"
37,"SUPPRF94460",30,85,35,23,15,33,20,12,"Pilot 7","Pilot 7: bigger feedback + text"
38,"SUPPRF94460",23,77,8,-34,-12,35,20,42,"Pilot 7","Pilot 7: bigger feedback + text"
39,"SUPPRF94460",30,80,47,5,-16,43,63,42,"Pilot 7","Pilot 7: bigger feedback + text"
40,"SUPPRF94460",29,85,78,22,15,49,63,56,"Pilot 7","Pilot 7: bigger feedback + text"
41,"SUPPRF94460",26,86,55,4,1,48,54,51,"Pilot 7","Pilot 7: bigger feedback + text"
42,"SUPPRF94460",19,85,70,5,-1,63,71,65,"Pilot 7","Pilot 7: bigger feedback + text"
43,"SUPPRF94460",26,93,28,10,-1,24,29,18,"Pilot 7","Pilot 7: bigger feedback + text"
44,"SUPPRF94460",5,97,62,17,-1,45,63,45,"Pilot 7","Pilot 7: bigger feedback + text"
45,"SUPPRF94460",8,97,49,6,12,43,37,43,"Pilot 7","Pilot 7: bigger feedback + text"
46,"SUPPRF94460",1,100,24,-21,-13,50,37,45,"Pilot 7","Pilot 7: bigger feedback + text"
47,"SUPPRF94460",1,99,51,21,14,24,37,30,"Pilot 7","Pilot 7: bigger feedback + text"
48,"SUPPRF94460",1,100,63,54,0,42,63,9,"Pilot 7","Pilot 7: bigger feedback + text"
1,"SUPPRF63935",88,3,29,-1,0,74,29,30,"Pilot 7","Pilot 7: bigger feedback + text"
2,"SUPPRF63935",92,2,46,23,17,91,29,23,"Pilot 7","Pilot 7: bigger feedback + text"
3,"SUPPRF63935",87,1,48,21,19,70,29,27,"Pilot 7","Pilot 7: bigger feedback + text"
4,"SUPPRF63935",90,2,66,11,12,85,54,55,"Pilot 7","Pilot 7: bigger feedback + text"
5,"SUPPRF63935",90,2,77,5,14,89,63,72,"Pilot 7","Pilot 7: bigger feedback + text"
6,"SUPPRF63935",87,1,38,-18,-16,83,54,56,"Pilot 7","Pilot 7: bigger feedback + text"
7,"SUPPRF63935",91,1,37,13,0,64,37,24,"Pilot 7","Pilot 7: bigger feedback + text"
8,"SUPPRF63935",79,1,16,-9,-13,78,29,25,"Pilot 7","Pilot 7: bigger feedback + text"
9,"SUPPRF63935",83,2,37,18,17,63,20,19,"Pilot 7","Pilot 7: bigger feedback + text"
10,"SUPPRF63935",88,1,55,0,1,76,54,55,"Pilot 7","Pilot 7: bigger feedback + text"
11,"SUPPRF63935",89,15,71,1,0,87,71,70,"Pilot 7","Pilot 7: bigger feedback + text"
12,"SUPPRF63935",89,1,38,7,1,43,37,31,"Pilot 7","Pilot 7: bigger feedback + text"
13,"SUPPRF63935",84,1,46,-2,0,31,46,48,"Pilot 7","Pilot 7: bigger feedback + text"
14,"SUPPRF63935",91,1,58,14,12,80,46,44,"Pilot 7","Pilot 7: bigger feedback + text"
15,"SUPPRF63935",82,5,15,-18,-14,73,29,33,"Pilot 7","Pilot 7: bigger feedback + text"
16,"SUPPRF63935",77,3,50,-15,-13,90,63,65,"Pilot 7","Pilot 7: bigger feedback + text"
17,"SUPPRF63935",92,2,70,-2,-1,90,71,72,"Pilot 7","Pilot 7: bigger feedback + text"
18,"SUPPRF63935",96,11,65,15,19,22,46,50,"Pilot 7","Pilot 7: bigger feedback + text"
19,"SUPPRF63935",76,7,55,-15,-16,86,71,70,"Pilot 7","Pilot 7: bigger feedback + text"
20,"SUPPRF63935",93,3,34,-11,-12,83,46,45,"Pilot 7","Pilot 7: bigger feedback + text"
21,"SUPPRF63935",93,1,84,5,13,58,71,79,"Pilot 7","Pilot 7: bigger feedback + text"
22,"SUPPRF63935",96,2,97,39,17,27,80,58,"Pilot 7","Pilot 7: bigger feedback + text"
23,"SUPPRF63935",95,1,51,14,14,89,37,37,"Pilot 7","Pilot 7: bigger feedback + text"
24,"SUPPRF63935",94,4,83,9,12,81,71,74,"Pilot 7","Pilot 7: bigger feedback + text"
25,"SUPPRF63935",94,3,47,-13,-16,85,63,60,"Pilot 7","Pilot 7: bigger feedback + text"
26,"SUPPRF63935",96,2,68,9,14,83,54,59,"Pilot 7","Pilot 7: bigger feedback + text"
27,"SUPPRF63935",95,2,81,-7,1,90,80,88,"Pilot 7","Pilot 7: bigger feedback + text"
28,"SUPPRF63935",96,3,80,-10,0,88,80,90,"Pilot 7","Pilot 7: bigger feedback + text"
29,"SUPPRF63935",91,1,22,-17,-15,92,37,39,"Pilot 7","Pilot 7: bigger feedback + text"
30,"SUPPRF63935",92,3,28,-8,-1,53,29,36,"Pilot 7","Pilot 7: bigger feedback + text"
31,"SUPPRF63935",91,2,78,31,15,77,63,47,"Pilot 7","Pilot 7: bigger feedback + text"
32,"SUPPRF63935",70,1,6,-22,-14,86,20,28,"Pilot 7","Pilot 7: bigger feedback + text"
33,"SUPPRF63935",92,2,62,5,-1,91,63,57,"Pilot 7","Pilot 7: bigger feedback + text"
34,"SUPPRF63935",69,1,8,-14,-12,71,20,22,"Pilot 7","Pilot 7: bigger feedback + text"
35,"SUPPRF63935",94,3,96,10,16,94,80,86,"Pilot 7","Pilot 7: bigger feedback + text"
36,"SUPPRF63935",93,2,33,-12,-13,90,46,45,"Pilot 7","Pilot 7: bigger feedback + text"
37,"SUPPRF63935",65,11,56,18,-15,14,71,38,"Pilot 7","Pilot 7: bigger feedback + text"
38,"SUPPRF63935",94,5,41,-16,-13,90,54,57,"Pilot 7","Pilot 7: bigger feedback + text"
39,"SUPPRF63935",90,1,63,0,0,30,63,63,"Pilot 7","Pilot 7: bigger feedback + text"
40,"SUPPRF63935",97,2,19,4,-1,92,20,15,"Pilot 7","Pilot 7: bigger feedback + text"
41,"SUPPRF63935",70,2,68,-19,-12,85,80,87,"Pilot 7","Pilot 7: bigger feedback + text"
42,"SUPPRF63935",59,3,49,11,12,85,37,38,"Pilot 7","Pilot 7: bigger feedback + text"
43,"SUPPRF63935",63,18,54,-11,0,87,54,65,"Pilot 7","Pilot 7: bigger feedback + text"
44,"SUPPRF63935",70,30,35,22,15,87,20,13,"Pilot 7","Pilot 7: bigger feedback + text"
45,"SUPPRF63935",87,7,24,-12,-13,87,37,36,"Pilot 7","Pilot 7: bigger feedback + text"
46,"SUPPRF63935",64,19,67,-15,-13,97,80,82,"Pilot 7","Pilot 7: bigger feedback + text"
47,"SUPPRF63935",64,29,20,-3,0,62,20,23,"Pilot 7","Pilot 7: bigger feedback + text"
48,"SUPPRF63935",67,27,45,0,-1,83,46,45,"Pilot 7","Pilot 7: bigger feedback + text"
1,"SUPPRF78461_p7",49,52,70,37,-1,45,71,33,"Pilot 7","Pilot 7: bigger feedback + text"
2,"SUPPRF78461_p7",31,65,22,-14,-15,35,37,36,"Pilot 7","Pilot 7: bigger feedback + text"
3,"SUPPRF78461_p7",36,67,47,-12,-16,32,63,59,"Pilot 7","Pilot 7: bigger feedback + text"
4,"SUPPRF78461_p7",55,35,51,11,14,35,37,40,"Pilot 7","Pilot 7: bigger feedback + text"
5,"SUPPRF78461_p7",51,51,49,13,12,44,37,36,"Pilot 7","Pilot 7: bigger feedback + text"
6,"SUPPRF78461_p7",41,56,50,2,-13,49,63,48,"Pilot 7","Pilot 7: bigger feedback + text"
7,"SUPPRF78461_p7",35,60,34,-27,-12,34,46,61,"Pilot 7","Pilot 7: bigger feedback + text"
8,"SUPPRF78461_p7",61,38,63,-2,0,41,63,65,"Pilot 7","Pilot 7: bigger feedback + text"
9,"SUPPRF78461_p7",59,47,35,14,15,45,20,21,"Pilot 7","Pilot 7: bigger feedback + text"
10,"SUPPRF78461_p7",55,39,66,-2,12,63,54,68,"Pilot 7","Pilot 7: bigger feedback + text"
11,"SUPPRF78461_p7",61,35,58,15,12,43,46,43,"Pilot 7","Pilot 7: bigger feedback + text"
12,"SUPPRF78461_p7",76,32,80,-5,0,64,80,85,"Pilot 7","Pilot 7: bigger feedback + text"
13,"SUPPRF78461_p7",46,55,20,3,0,49,20,17,"Pilot 7","Pilot 7: bigger feedback + text"
14,"SUPPRF78461_p7",11,87,6,-16,-14,60,20,22,"Pilot 7","Pilot 7: bigger feedback + text"
15,"SUPPRF78461_p7",45,45,67,3,-13,61,80,64,"Pilot 7","Pilot 7: bigger feedback + text"
16,"SUPPRF78461_p7",28,75,33,-15,-13,51,46,48,"Pilot 7","Pilot 7: bigger feedback + text"
17,"SUPPRF78461_p7",74,28,71,2,0,57,71,69,"Pilot 7","Pilot 7: bigger feedback + text"
18,"SUPPRF78461_p7",39,65,29,-5,0,59,29,34,"Pilot 7","Pilot 7: bigger feedback + text"
19,"SUPPRF78461_p7",27,66,54,-8,0,63,54,62,"Pilot 7","Pilot 7: bigger feedback + text"
20,"SUPPRF78461_p7",62,35,48,18,19,47,29,30,"Pilot 7","Pilot 7: bigger feedback + text"
21,"SUPPRF78461_p7",34,69,37,-17,0,51,37,54,"Pilot 7","Pilot 7: bigger feedback + text"
22,"SUPPRF78461_p7",15,80,55,-20,-16,59,71,75,"Pilot 7","Pilot 7: bigger feedback + text"
23,"SUPPRF78461_p7",72,32,78,25,15,63,63,53,"Pilot 7","Pilot 7: bigger feedback + text"
24,"SUPPRF78461_p7",8,79,38,-26,-16,69,54,64,"Pilot 7","Pilot 7: bigger feedback + text"
25,"SUPPRF78461_p7",81,25,68,12,14,59,54,56,"Pilot 7","Pilot 7: bigger feedback + text"
26,"SUPPRF78461_p7",96,6,97,16,17,67,80,81,"Pilot 7","Pilot 7: bigger feedback + text"
27,"SUPPRF78461_p7",11,87,15,-9,-14,42,29,24,"Pilot 7","Pilot 7: bigger feedback + text"
28,"SUPPRF78461_p7",54,51,24,-2,-13,54,37,26,"Pilot 7","Pilot 7: bigger feedback + text"
29,"SUPPRF78461_p7",50,47,28,1,-1,46,29,27,"Pilot 7","Pilot 7: bigger feedback + text"
30,"SUPPRF78461_p7",63,29,84,2,13,59,71,82,"Pilot 7","Pilot 7: bigger feedback + text"
31,"SUPPRF78461_p7",12,79,46,-18,17,62,29,64,"Pilot 7","Pilot 7: bigger feedback + text"
32,"SUPPRF78461_p7",15,83,19,-11,-1,41,20,30,"Pilot 7","Pilot 7: bigger feedback + text"
33,"SUPPRF78461_p7",59,33,37,19,17,71,20,18,"Pilot 7","Pilot 7: bigger feedback + text"
34,"SUPPRF78461_p7",65,36,77,5,14,24,63,72,"Pilot 7","Pilot 7: bigger feedback + text"
35,"SUPPRF78461_p7",76,39,83,15,12,35,71,68,"Pilot 7","Pilot 7: bigger feedback + text"
36,"SUPPRF78461_p7",31,54,8,1,-12,53,20,7,"Pilot 7","Pilot 7: bigger feedback + text"
37,"SUPPRF78461_p7",97,36,96,36,16,43,80,60,"Pilot 7","Pilot 7: bigger feedback + text"
38,"SUPPRF78461_p7",39,50,55,-8,1,45,54,63,"Pilot 7","Pilot 7: bigger feedback + text"
39,"SUPPRF78461_p7",23,63,56,-18,-15,49,71,74,"Pilot 7","Pilot 7: bigger feedback + text"
40,"SUPPRF78461_p7",34,66,41,-17,-13,47,54,58,"Pilot 7","Pilot 7: bigger feedback + text"
41,"SUPPRF78461_p7",67,50,65,27,19,48,46,38,"Pilot 7","Pilot 7: bigger feedback + text"
42,"SUPPRF78461_p7",57,44,62,11,-1,48,63,51,"Pilot 7","Pilot 7: bigger feedback + text"
43,"SUPPRF78461_p7",90,46,81,24,1,54,80,57,"Pilot 7","Pilot 7: bigger feedback + text"
44,"SUPPRF78461_p7",50,52,45,2,-1,49,46,43,"Pilot 7","Pilot 7: bigger feedback + text"
45,"SUPPRF78461_p7",52,54,38,4,1,54,37,34,"Pilot 7","Pilot 7: bigger feedback + text"
46,"SUPPRF78461_p7",52,53,46,-2,0,49,46,48,"Pilot 7","Pilot 7: bigger feedback + text"
47,"SUPPRF78461_p7",22,65,68,-13,-12,60,80,81,"Pilot 7","Pilot 7: bigger feedback + text"
48,"SUPPRF78461_p7",40,53,16,-6,-13,49,29,22,"Pilot 7","Pilot 7: bigger feedback + text"
1,"SUPPRF31333",80,6,37,-3,0,76,37,40,"Pilot 8","Pilot 8: max feedback + text"
2,"SUPPRF31333",79,4,80,9,0,76,80,71,"Pilot 8","Pilot 8: max feedback + text"
3,"SUPPRF31333",85,6,54,-13,0,82,54,67,"Pilot 8","Pilot 8: max feedback + text"
4,"SUPPRF31333",85,11,68,-1,-12,76,80,69,"Pilot 8","Pilot 8: max feedback + text"
5,"SUPPRF31333",87,18,33,-25,-13,67,46,58,"Pilot 8","Pilot 8: max feedback + text"
6,"SUPPRF31333",81,12,75,35,29,74,46,40,"Pilot 8","Pilot 8: max feedback + text"
7,"SUPPRF31333",92,16,50,-22,-13,67,63,72,"Pilot 8","Pilot 8: max feedback + text"
8,"SUPPRF31333",90,4,96,31,16,73,80,65,"Pilot 8","Pilot 8: max feedback + text"
9,"SUPPRF31333",74,20,22,-28,-15,65,37,50,"Pilot 8","Pilot 8: max feedback + text"
10,"SUPPRF31333",75,7,47,-25,-16,27,63,72,"Pilot 8","Pilot 8: max feedback + text"
11,"SUPPRF31333",83,7,41,-16,-13,62,54,57,"Pilot 8","Pilot 8: max feedback + text"
12,"SUPPRF31333",79,21,61,40,24,78,37,21,"Pilot 8","Pilot 8: max feedback + text"
13,"SUPPRF31333",79,11,94,35,23,48,71,59,"Pilot 8","Pilot 8: max feedback + text"
14,"SUPPRF31333",87,14,20,-3,0,57,20,23,"Pilot 8","Pilot 8: max feedback + text"
15,"SUPPRF31333",79,15,70,14,-1,24,71,56,"Pilot 8","Pilot 8: max feedback + text"
16,"SUPPRF31333",85,20,78,33,24,63,54,45,"Pilot 8","Pilot 8: max feedback + text"
17,"SUPPRF31333",88,17,46,13,17,68,29,33,"Pilot 8","Pilot 8: max feedback + text"
18,"SUPPRF31333",80,14,63,1,0,66,63,62,"Pilot 8","Pilot 8: max feedback + text"
19,"SUPPRF31333",76,15,6,-36,-14,78,20,42,"Pilot 8","Pilot 8: max feedback + text"
20,"SUPPRF31333",78,18,83,18,12,66,71,65,"Pilot 8","Pilot 8: max feedback + text"
21,"SUPPRF31333",91,20,29,-27,0,54,29,56,"Pilot 8","Pilot 8: max feedback + text"
22,"SUPPRF31333",79,15,58,23,29,68,29,35,"Pilot 8","Pilot 8: max feedback + text"
23,"SUPPRF31333",79,21,28,2,-1,75,29,26,"Pilot 8","Pilot 8: max feedback + text"
24,"SUPPRF31333",85,13,67,30,-13,65,80,37,"Pilot 8","Pilot 8: max feedback + text"
25,"SUPPRF31333",71,22,88,27,25,59,63,61,"Pilot 8","Pilot 8: max feedback + text"
26,"SUPPRF31333",90,15,55,-2,-16,72,71,57,"Pilot 8","Pilot 8: max feedback + text"
27,"SUPPRF31333",75,14,38,-32,-16,72,54,70,"Pilot 8","Pilot 8: max feedback + text"
28,"SUPPRF31333",79,16,16,-32,-13,66,29,48,"Pilot 8","Pilot 8: max feedback + text"
29,"SUPPRF31333",82,20,56,-13,-15,68,71,69,"Pilot 8","Pilot 8: max feedback + text"
30,"SUPPRF31333",83,27,35,2,15,20,20,33,"Pilot 8","Pilot 8: max feedback + text"
31,"SUPPRF31333",82,14,71,42,0,29,71,29,"Pilot 8","Pilot 8: max feedback + text"
32,"SUPPRF31333",91,20,47,17,27,53,20,30,"Pilot 8","Pilot 8: max feedback + text"
33,"SUPPRF31333",92,6,45,-28,-1,41,46,73,"Pilot 8","Pilot 8: max feedback + text"
34,"SUPPRF31333",91,5,100,75,20,72,80,25,"Pilot 8","Pilot 8: max feedback + text"
35,"SUPPRF31333",93,5,55,-4,1,69,54,59,"Pilot 8","Pilot 8: max feedback + text"
36,"SUPPRF31333",75,29,15,-35,-14,61,29,50,"Pilot 8","Pilot 8: max feedback + text"
37,"SUPPRF31333",76,15,66,4,12,69,54,62,"Pilot 8","Pilot 8: max feedback + text"
38,"SUPPRF31333",87,13,81,6,1,74,80,75,"Pilot 8","Pilot 8: max feedback + text"
39,"SUPPRF31333",75,17,8,-21,-12,73,20,29,"Pilot 8","Pilot 8: max feedback + text"
40,"SUPPRF31333",86,19,58,9,12,59,46,49,"Pilot 8","Pilot 8: max feedback + text"
41,"SUPPRF31333",86,12,38,-25,1,41,37,63,"Pilot 8","Pilot 8: max feedback + text"
42,"SUPPRF31333",82,9,77,17,14,14,63,60,"Pilot 8","Pilot 8: max feedback + text"
43,"SUPPRF31333",78,13,46,3,0,24,46,43,"Pilot 8","Pilot 8: max feedback + text"
44,"SUPPRF31333",76,18,24,-45,-13,19,37,69,"Pilot 8","Pilot 8: max feedback + text"
45,"SUPPRF31333",82,12,62,-1,-1,17,63,63,"Pilot 8","Pilot 8: max feedback + text"
46,"SUPPRF31333",72,25,49,-11,12,25,37,60,"Pilot 8","Pilot 8: max feedback + text"
47,"SUPPRF31333",85,9,19,4,-1,75,20,15,"Pilot 8","Pilot 8: max feedback + text"
48,"SUPPRF31333",81,16,34,-20,-12,20,46,54,"Pilot 8","Pilot 8: max feedback + text"
1,"SUPPRF94864",30,83,28,-3,-1,59,29,31,"Pilot 8","Pilot 8: max feedback + text"
2,"SUPPRF94864",27,75,47,-13,-16,29,63,60,"Pilot 8","Pilot 8: max feedback + text"
3,"SUPPRF94864",22,72,41,1,-13,70,54,40,"Pilot 8","Pilot 8: max feedback + text"
4,"SUPPRF94864",19,77,45,-4,-1,23,46,49,"Pilot 8","Pilot 8: max feedback + text"
5,"SUPPRF94864",16,73,67,-7,-13,80,80,74,"Pilot 8","Pilot 8: max feedback + text"
6,"SUPPRF94864",17,76,94,18,23,55,71,76,"Pilot 8","Pilot 8: max feedback + text"
7,"SUPPRF94864",20,81,37,7,0,68,37,30,"Pilot 8","Pilot 8: max feedback + text"
8,"SUPPRF94864",23,84,29,-1,0,78,29,30,"Pilot 8","Pilot 8: max feedback + text"
9,"SUPPRF94864",11,70,61,44,24,73,37,17,"Pilot 8","Pilot 8: max feedback + text"
10,"SUPPRF94864",35,72,77,37,14,76,63,40,"Pilot 8","Pilot 8: max feedback + text"
11,"SUPPRF94864",31,67,66,15,12,71,54,51,"Pilot 8","Pilot 8: max feedback + text"
12,"SUPPRF94864",41,64,100,36,20,47,80,64,"Pilot 8","Pilot 8: max feedback + text"
13,"SUPPRF94864",37,68,38,-1,1,74,37,39,"Pilot 8","Pilot 8: max feedback + text"
14,"SUPPRF94864",35,77,56,22,-15,55,71,34,"Pilot 8","Pilot 8: max feedback + text"
15,"SUPPRF94864",22,79,75,36,29,33,46,39,"Pilot 8","Pilot 8: max feedback + text"
16,"SUPPRF94864",25,64,38,-21,-16,80,54,59,"Pilot 8","Pilot 8: max feedback + text"
17,"SUPPRF94864",34,69,46,10,17,29,29,36,"Pilot 8","Pilot 8: max feedback + text"
18,"SUPPRF94864",37,62,71,10,0,60,71,61,"Pilot 8","Pilot 8: max feedback + text"
19,"SUPPRF94864",22,71,35,4,15,50,20,31,"Pilot 8","Pilot 8: max feedback + text"
20,"SUPPRF94864",27,69,15,-18,-14,87,29,33,"Pilot 8","Pilot 8: max feedback + text"
21,"SUPPRF94864",26,76,46,-5,0,76,46,51,"Pilot 8","Pilot 8: max feedback + text"
22,"SUPPRF94864",26,61,54,27,0,66,54,27,"Pilot 8","Pilot 8: max feedback + text"
23,"SUPPRF94864",33,66,78,14,24,55,54,64,"Pilot 8","Pilot 8: max feedback + text"
24,"SUPPRF94864",29,62,20,-7,0,29,20,27,"Pilot 8","Pilot 8: max feedback + text"
25,"SUPPRF94864",36,67,62,12,-1,48,63,50,"Pilot 8","Pilot 8: max feedback + text"
26,"SUPPRF94864",33,64,50,-1,-13,49,63,51,"Pilot 8","Pilot 8: max feedback + text"
27,"SUPPRF94864",33,63,33,9,-13,91,46,24,"Pilot 8","Pilot 8: max feedback + text"
28,"SUPPRF94864",34,72,55,-4,1,36,54,59,"Pilot 8","Pilot 8: max feedback + text"
29,"SUPPRF94864",30,68,81,11,1,53,80,70,"Pilot 8","Pilot 8: max feedback + text"
30,"SUPPRF94864",35,61,70,5,-1,89,71,65,"Pilot 8","Pilot 8: max feedback + text"
31,"SUPPRF94864",38,66,58,4,12,80,46,54,"Pilot 8","Pilot 8: max feedback + text"
32,"SUPPRF94864",46,56,55,-17,-16,39,71,72,"Pilot 8","Pilot 8: max feedback + text"
33,"SUPPRF94864",41,55,49,-2,12,72,37,51,"Pilot 8","Pilot 8: max feedback + text"
34,"SUPPRF94864",50,50,88,53,25,70,63,35,"Pilot 8","Pilot 8: max feedback + text"
35,"SUPPRF94864",40,49,47,33,27,94,20,14,"Pilot 8","Pilot 8: max feedback + text"
36,"SUPPRF94864",41,63,6,-24,-14,74,20,30,"Pilot 8","Pilot 8: max feedback + text"
37,"SUPPRF94864",39,52,24,-16,-13,83,37,40,"Pilot 8","Pilot 8: max feedback + text"
38,"SUPPRF94864",51,57,96,42,16,69,80,54,"Pilot 8","Pilot 8: max feedback + text"
39,"SUPPRF94864",49,50,8,-29,-12,79,20,37,"Pilot 8","Pilot 8: max feedback + text"
40,"SUPPRF94864",49,56,83,35,12,43,71,48,"Pilot 8","Pilot 8: max feedback + text"
41,"SUPPRF94864",46,50,34,-9,-12,80,46,43,"Pilot 8","Pilot 8: max feedback + text"
42,"SUPPRF94864",49,53,63,20,0,73,63,43,"Pilot 8","Pilot 8: max feedback + text"
43,"SUPPRF94864",48,50,19,16,-1,89,20,3,"Pilot 8","Pilot 8: max feedback + text"
44,"SUPPRF94864",50,53,58,-8,29,42,29,66,"Pilot 8","Pilot 8: max feedback + text"
45,"SUPPRF94864",47,48,22,-26,-15,82,37,48,"Pilot 8","Pilot 8: max feedback + text"
46,"SUPPRF94864",52,50,68,5,-12,84,80,63,"Pilot 8","Pilot 8: max feedback + text"
47,"SUPPRF94864",51,45,80,-11,0,39,80,91,"Pilot 8","Pilot 8: max feedback + text"
48,"SUPPRF94864",48,49,16,13,-13,82,29,3,"Pilot 8","Pilot 8: max feedback + text"
1,"SUPPRF18559",53,45,34,-13,-12,59,46,47,"Pilot 8","Pilot 8: max feedback + text"
2,"SUPPRF18559",56,44,96,38,16,35,80,58,"Pilot 8","Pilot 8: max feedback + text"
3,"SUPPRF18559",50,40,58,23,12,41,46,35,"Pilot 8","Pilot 8: max feedback + text"
4,"SUPPRF18559",51,43,38,-12,1,34,37,50,"Pilot 8","Pilot 8: max feedback + text"
5,"SUPPRF18559",56,37,47,20,27,48,20,27,"Pilot 8","Pilot 8: max feedback + text"
6,"SUPPRF18559",50,37,75,33,29,31,46,42,"Pilot 8","Pilot 8: max feedback + text"
7,"SUPPRF18559",51,41,19,-21,-1,31,20,40,"Pilot 8","Pilot 8: max feedback + text"
8,"SUPPRF18559",49,32,50,-3,-13,47,63,53,"Pilot 8","Pilot 8: max feedback + text"
9,"SUPPRF18559",49,33,41,-8,-13,35,54,49,"Pilot 8","Pilot 8: max feedback + text"
10,"SUPPRF18559",64,30,94,40,23,58,71,54,"Pilot 8","Pilot 8: max feedback + text"
11,"SUPPRF18559",53,26,24,-25,-13,28,37,49,"Pilot 8","Pilot 8: max feedback + text"
12,"SUPPRF18559",54,27,66,10,12,35,54,56,"Pilot 8","Pilot 8: max feedback + text"
13,"SUPPRF18559",56,27,81,17,1,58,80,64,"Pilot 8","Pilot 8: max feedback + text"
14,"SUPPRF18559",62,26,63,27,0,49,63,36,"Pilot 8","Pilot 8: max feedback + text"
15,"SUPPRF18559",53,25,45,-7,-1,29,46,52,"Pilot 8","Pilot 8: max feedback + text"
16,"SUPPRF18559",58,28,47,-1,-16,36,63,48,"Pilot 8","Pilot 8: max feedback + text"
17,"SUPPRF18559",55,30,88,55,25,48,63,33,"Pilot 8","Pilot 8: max feedback + text"
18,"SUPPRF18559",58,35,15,-37,-14,36,29,52,"Pilot 8","Pilot 8: max feedback + text"
19,"SUPPRF18559",53,26,46,-14,0,58,46,60,"Pilot 8","Pilot 8: max feedback + text"
20,"SUPPRF18559",60,25,29,8,0,64,29,21,"Pilot 8","Pilot 8: max feedback + text"
21,"SUPPRF18559",58,27,20,3,0,59,20,17,"Pilot 8","Pilot 8: max feedback + text"
22,"SUPPRF18559",57,23,70,-8,-1,61,71,78,"Pilot 8","Pilot 8: max feedback + text"
23,"SUPPRF18559",58,23,16,-1,-13,59,29,17,"Pilot 8","Pilot 8: max feedback + text"
24,"SUPPRF18559",61,28,28,4,-1,53,29,24,"Pilot 8","Pilot 8: max feedback + text"
25,"SUPPRF18559",61,25,78,17,24,38,54,61,"Pilot 8","Pilot 8: max feedback + text"
26,"SUPPRF18559",62,26,61,10,24,26,37,51,"Pilot 8","Pilot 8: max feedback + text"
27,"SUPPRF18559",58,26,56,-13,-15,70,71,69,"Pilot 8","Pilot 8: max feedback + text"
28,"SUPPRF18559",64,20,71,5,0,62,71,66,"Pilot 8","Pilot 8: max feedback + text"
29,"SUPPRF18559",58,14,67,-3,-13,68,80,70,"Pilot 8","Pilot 8: max feedback + text"
30,"SUPPRF18559",54,28,22,-32,-15,25,37,54,"Pilot 8","Pilot 8: max feedback + text"
31,"SUPPRF18559",57,17,100,24,20,52,80,76,"Pilot 8","Pilot 8: max feedback + text"
32,"SUPPRF18559",59,17,33,-17,-13,31,46,50,"Pilot 8","Pilot 8: max feedback + text"
33,"SUPPRF18559",54,24,8,-10,-12,42,20,18,"Pilot 8","Pilot 8: max feedback + text"
34,"SUPPRF18559",57,16,37,2,0,19,37,35,"Pilot 8","Pilot 8: max feedback + text"
35,"SUPPRF18559",58,11,77,42,14,46,63,35,"Pilot 8","Pilot 8: max feedback + text"
36,"SUPPRF18559",69,10,6,0,-14,63,20,6,"Pilot 8","Pilot 8: max feedback + text"
37,"SUPPRF18559",61,17,68,10,-12,62,80,58,"Pilot 8","Pilot 8: max feedback + text"
38,"SUPPRF18559",50,13,83,26,12,48,71,57,"Pilot 8","Pilot 8: max feedback + text"
39,"SUPPRF18559",58,17,38,-10,-16,23,54,48,"Pilot 8","Pilot 8: max feedback + text"
40,"SUPPRF18559",59,19,46,23,17,66,29,23,"Pilot 8","Pilot 8: max feedback + text"
41,"SUPPRF18559",58,20,80,20,0,58,80,60,"Pilot 8","Pilot 8: max feedback + text"
42,"SUPPRF18559",64,18,55,8,1,28,54,47,"Pilot 8","Pilot 8: max feedback + text"
43,"SUPPRF18559",63,21,49,11,12,19,37,38,"Pilot 8","Pilot 8: max feedback + text"
44,"SUPPRF18559",56,17,62,16,-1,24,63,46,"Pilot 8","Pilot 8: max feedback + text"
45,"SUPPRF18559",55,22,54,7,0,26,54,47,"Pilot 8","Pilot 8: max feedback + text"
46,"SUPPRF18559",57,25,35,-19,15,31,20,54,"Pilot 8","Pilot 8: max feedback + text"
47,"SUPPRF18559",57,18,58,37,29,55,29,21,"Pilot 8","Pilot 8: max feedback + text"
48,"SUPPRF18559",56,22,55,21,-16,59,71,34,"Pilot 8","Pilot 8: max feedback + text"
1,"SUPPRF98014",91,16,35,12,15,45,20,23,"Pilot 8","Pilot 8: max feedback + text"
2,"SUPPRF98014",92,4,81,6,1,66,80,75,"Pilot 8","Pilot 8: max feedback + text"
3,"SUPPRF98014",90,4,63,-1,0,76,63,64,"Pilot 8","Pilot 8: max feedback + text"
4,"SUPPRF98014",76,9,29,13,0,68,29,16,"Pilot 8","Pilot 8: max feedback + text"
5,"SUPPRF98014",75,9,16,-14,-13,73,29,30,"Pilot 8","Pilot 8: max feedback + text"
6,"SUPPRF98014",79,6,61,13,24,30,37,48,"Pilot 8","Pilot 8: max feedback + text"
7,"SUPPRF98014",89,1,68,-10,-12,75,80,78,"Pilot 8","Pilot 8: max feedback + text"
8,"SUPPRF98014",61,10,6,-12,-14,29,20,18,"Pilot 8","Pilot 8: max feedback + text"
9,"SUPPRF98014",66,4,54,20,0,27,54,34,"Pilot 8","Pilot 8: max feedback + text"
10,"SUPPRF98014",96,3,94,62,23,69,71,32,"Pilot 8","Pilot 8: max feedback + text"
11,"SUPPRF98014",71,12,19,2,-1,82,20,17,"Pilot 8","Pilot 8: max feedback + text"
12,"SUPPRF98014",69,3,58,16,12,62,46,42,"Pilot 8","Pilot 8: max feedback + text"
13,"SUPPRF98014",82,2,37,0,0,71,37,37,"Pilot 8","Pilot 8: max feedback + text"
14,"SUPPRF98014",90,4,58,26,29,61,29,32,"Pilot 8","Pilot 8: max feedback + text"
15,"SUPPRF98014",74,2,20,5,0,84,20,15,"Pilot 8","Pilot 8: max feedback + text"
16,"SUPPRF98014",57,1,56,-21,-15,80,71,77,"Pilot 8","Pilot 8: max feedback + text"
17,"SUPPRF98014",97,2,75,38,29,81,46,37,"Pilot 8","Pilot 8: max feedback + text"
18,"SUPPRF98014",64,2,38,-16,1,79,37,54,"Pilot 8","Pilot 8: max feedback + text"
19,"SUPPRF98014",59,5,55,-18,-16,80,71,73,"Pilot 8","Pilot 8: max feedback + text"
20,"SUPPRF98014",77,5,66,14,12,68,54,52,"Pilot 8","Pilot 8: max feedback + text"
21,"SUPPRF98014",60,3,50,-18,-13,86,63,68,"Pilot 8","Pilot 8: max feedback + text"
22,"SUPPRF98014",63,2,33,-18,-13,75,46,51,"Pilot 8","Pilot 8: max feedback + text"
23,"SUPPRF98014",74,1,28,6,-1,74,29,22,"Pilot 8","Pilot 8: max feedback + text"
24,"SUPPRF98014",55,5,8,-8,-12,74,20,16,"Pilot 8","Pilot 8: max feedback + text"
25,"SUPPRF98014",71,1,49,16,12,86,37,33,"Pilot 8","Pilot 8: max feedback + text"
26,"SUPPRF98014",84,5,77,35,14,75,63,42,"Pilot 8","Pilot 8: max feedback + text"
27,"SUPPRF98014",81,7,38,11,-16,84,54,27,"Pilot 8","Pilot 8: max feedback + text"
28,"SUPPRF98014",91,3,88,29,25,77,63,59,"Pilot 8","Pilot 8: max feedback + text"
29,"SUPPRF98014",94,3,78,49,24,58,54,29,"Pilot 8","Pilot 8: max feedback + text"
30,"SUPPRF98014",90,4,83,13,12,59,71,70,"Pilot 8","Pilot 8: max feedback + text"
31,"SUPPRF98014",81,4,47,33,27,83,20,14,"Pilot 8","Pilot 8: max feedback + text"
32,"SUPPRF98014",75,7,47,-25,-16,32,63,72,"Pilot 8","Pilot 8: max feedback + text"
33,"SUPPRF98014",78,4,46,-23,0,30,46,69,"Pilot 8","Pilot 8: max feedback + text"
34,"SUPPRF98014",81,4,70,35,-1,26,71,35,"Pilot 8","Pilot 8: max feedback + text"
35,"SUPPRF98014",78,6,67,14,-13,35,80,53,"Pilot 8","Pilot 8: max feedback + text"
36,"SUPPRF98014",75,10,22,-23,-15,75,37,45,"Pilot 8","Pilot 8: max feedback + text"
37,"SUPPRF98014",87,3,62,17,-1,64,63,45,"Pilot 8","Pilot 8: max feedback + text"
38,"SUPPRF98014",76,7,45,-21,-1,82,46,66,"Pilot 8","Pilot 8: max feedback + text"
39,"SUPPRF98014",84,2,71,2,0,85,71,69,"Pilot 8","Pilot 8: max feedback + text"
40,"SUPPRF98014",44,14,55,-41,1,60,54,96,"Pilot 8","Pilot 8: max feedback + text"
41,"SUPPRF98014",53,9,24,-27,-13,84,37,51,"Pilot 8","Pilot 8: max feedback + text"
42,"SUPPRF98014",77,1,80,4,0,84,80,76,"Pilot 8","Pilot 8: max feedback + text"
43,"SUPPRF98014",91,2,96,22,16,75,80,74,"Pilot 8","Pilot 8: max feedback + text"
44,"SUPPRF98014",77,4,15,-16,-14,85,29,31,"Pilot 8","Pilot 8: max feedback + text"
45,"SUPPRF98014",76,13,34,-29,-12,80,46,63,"Pilot 8","Pilot 8: max feedback + text"
46,"SUPPRF98014",74,8,41,8,-13,78,54,33,"Pilot 8","Pilot 8: max feedback + text"
47,"SUPPRF98014",97,3,100,29,20,84,80,71,"Pilot 8","Pilot 8: max feedback + text"
48,"SUPPRF98014",86,2,46,17,17,79,29,29,"Pilot 8","Pilot 8: max feedback + text"
1,"SUPPRF87060",99,0,80,0,0,93,80,80,"Pilot 8","Pilot 8: max feedback + text"
2,"SUPPRF87060",91,3,94,34,23,61,71,60,"Pilot 8","Pilot 8: max feedback + text"
3,"SUPPRF87060",92,1,71,-7,0,89,71,78,"Pilot 8","Pilot 8: max feedback + text"
4,"SUPPRF87060",82,5,56,-39,-15,87,71,95,"Pilot 8","Pilot 8: max feedback + text"
5,"SUPPRF87060",98,0,58,28,12,91,46,30,"Pilot 8","Pilot 8: max feedback + text"
6,"SUPPRF87060",97,0,68,4,-12,1,80,64,"Pilot 8","Pilot 8: max feedback + text"
7,"SUPPRF87060",95,3,75,49,29,31,46,26,"Pilot 8","Pilot 8: max feedback + text"
8,"SUPPRF87060",95,3,67,-22,-13,26,80,89,"Pilot 8","Pilot 8: max feedback + text"
9,"SUPPRF87060",99,1,100,14,20,76,80,86,"Pilot 8","Pilot 8: max feedback + text"
10,"SUPPRF87060",98,2,62,7,-1,95,63,55,"Pilot 8","Pilot 8: max feedback + text"
11,"SUPPRF87060",98,0,81,-5,1,83,80,86,"Pilot 8","Pilot 8: max feedback + text"
12,"SUPPRF87060",63,0,20,20,0,99,20,0,"Pilot 8","Pilot 8: max feedback + text"
13,"SUPPRF87060",98,1,96,2,16,20,80,94,"Pilot 8","Pilot 8: max feedback + text"
14,"SUPPRF87060",97,3,47,-23,-16,76,63,70,"Pilot 8","Pilot 8: max feedback + text"
15,"SUPPRF87060",97,1,88,26,25,15,63,62,"Pilot 8","Pilot 8: max feedback + text"
16,"SUPPRF87060",71,0,35,15,15,86,20,20,"Pilot 8","Pilot 8: max feedback + text"
17,"SUPPRF87060",71,2,61,23,24,5,37,38,"Pilot 8","Pilot 8: max feedback + text"
18,"SUPPRF87060",45,12,22,-14,-15,1,37,36,"Pilot 8","Pilot 8: max feedback + text"
19,"SUPPRF87060",31,8,16,-8,-13,84,29,24,"Pilot 8","Pilot 8: max feedback + text"
20,"SUPPRF87060",25,3,55,-3,-16,12,71,58,"Pilot 8","Pilot 8: max feedback + text"
21,"SUPPRF87060",16,18,38,-13,-16,0,54,51,"Pilot 8","Pilot 8: max feedback + text"
22,"SUPPRF87060",25,16,29,-14,0,3,29,43,"Pilot 8","Pilot 8: max feedback + text"
23,"SUPPRF87060",67,12,19,3,-1,86,20,16,"Pilot 8","Pilot 8: max feedback + text"
24,"SUPPRF87060",81,2,46,27,17,94,29,19,"Pilot 8","Pilot 8: max feedback + text"
25,"SUPPRF87060",85,2,28,-6,-1,1,29,34,"Pilot 8","Pilot 8: max feedback + text"
26,"SUPPRF87060",91,1,54,6,0,72,54,48,"Pilot 8","Pilot 8: max feedback + text"
27,"SUPPRF87060",79,3,15,-16,-14,2,29,31,"Pilot 8","Pilot 8: max feedback + text"
28,"SUPPRF87060",80,3,58,34,29,0,29,24,"Pilot 8","Pilot 8: max feedback + text"
29,"SUPPRF87060",0,2,38,2,1,37,37,36,"Pilot 8","Pilot 8: max feedback + text"
30,"SUPPRF87060",59,3,24,-8,-13,19,37,32,"Pilot 8","Pilot 8: max feedback + text"
31,"SUPPRF87060",51,0,66,9,12,79,54,57,"Pilot 8","Pilot 8: max feedback + text"
32,"SUPPRF87060",38,1,47,42,27,80,20,5,"Pilot 8","Pilot 8: max feedback + text"
33,"SUPPRF87060",33,1,77,15,14,28,63,62,"Pilot 8","Pilot 8: max feedback + text"
34,"SUPPRF87060",26,2,49,21,12,64,37,28,"Pilot 8","Pilot 8: max feedback + text"
35,"SUPPRF87060",0,0,63,49,0,1,63,14,"Pilot 8","Pilot 8: max feedback + text"
36,"SUPPRF87060",2,1,8,-4,-12,86,20,12,"Pilot 8","Pilot 8: max feedback + text"
37,"SUPPRF87060",65,1,70,-12,-1,22,71,82,"Pilot 8","Pilot 8: max feedback + text"
38,"SUPPRF87060",18,3,37,6,0,52,37,31,"Pilot 8","Pilot 8: max feedback + text"
39,"SUPPRF87060",0,1,33,20,-13,1,46,13,"Pilot 8","Pilot 8: max feedback + text"
40,"SUPPRF87060",9,2,45,11,-1,17,46,34,"Pilot 8","Pilot 8: max feedback + text"
41,"SUPPRF87060",0,1,6,-8,-14,94,20,14,"Pilot 8","Pilot 8: max feedback + text"
42,"SUPPRF87060",7,1,46,-5,0,0,46,51,"Pilot 8","Pilot 8: max feedback + text"
43,"SUPPRF87060",2,2,83,-8,12,7,71,91,"Pilot 8","Pilot 8: max feedback + text"
44,"SUPPRF87060",0,0,78,34,24,6,54,44,"Pilot 8","Pilot 8: max feedback + text"
45,"SUPPRF87060",1,1,34,0,-12,0,46,34,"Pilot 8","Pilot 8: max feedback + text"
46,"SUPPRF87060",0,1,41,40,-13,1,54,1,"Pilot 8","Pilot 8: max feedback + text"
47,"SUPPRF87060",0,1,50,-11,-13,6,63,61,"Pilot 8","Pilot 8: max feedback + text"
1,"SUPPRF83676",45,31,29,-8,0,26,29,37,"Pilot 8","Pilot 8: max feedback + text"
2,"SUPPRF83676",40,46,63,1,0,47,63,62,"Pilot 8","Pilot 8: max feedback + text"
3,"SUPPRF83676",48,37,68,-5,-12,46,80,73,"Pilot 8","Pilot 8: max feedback + text"
4,"SUPPRF83676",49,34,81,14,1,37,80,67,"Pilot 8","Pilot 8: max feedback + text"
5,"SUPPRF83676",50,37,88,27,25,47,63,61,"Pilot 8","Pilot 8: max feedback + text"
6,"SUPPRF83676",51,53,47,27,27,35,20,20,"Pilot 8","Pilot 8: max feedback + text"
7,"SUPPRF83676",1,99,22,-8,-15,50,37,30,"Pilot 8","Pilot 8: max feedback + text"
8,"SUPPRF83676",39,47,49,29,12,47,37,20,"Pilot 8","Pilot 8: max feedback + text"
9,"SUPPRF83676",50,47,71,1,0,47,71,70,"Pilot 8","Pilot 8: max feedback + text"
10,"SUPPRF83676",51,49,55,0,1,42,54,55,"Pilot 8","Pilot 8: max feedback + text"
11,"SUPPRF83676",44,46,70,-1,-1,49,71,71,"Pilot 8","Pilot 8: max feedback + text"
12,"SUPPRF83676",54,50,62,18,-1,49,63,44,"Pilot 8","Pilot 8: max feedback + text"
13,"SUPPRF83676",51,55,47,-21,-16,50,63,68,"Pilot 8","Pilot 8: max feedback + text"
1,"SUPPRF32902",86,9,94,21,23,96,71,73,"Pilot 8","Pilot 8: max feedback + text"
2,"SUPPRF32902",91,4,68,-16,-12,87,80,84,"Pilot 8","Pilot 8: max feedback + text"
3,"SUPPRF32902",88,8,49,-25,12,89,37,74,"Pilot 8","Pilot 8: max feedback + text"
4,"SUPPRF32902",86,5,63,-2,0,7,63,65,"Pilot 8","Pilot 8: max feedback + text"
5,"SUPPRF32902",91,7,38,-4,1,15,37,42,"Pilot 8","Pilot 8: max feedback + text"
6,"SUPPRF32902",96,1,54,8,0,19,54,46,"Pilot 8","Pilot 8: max feedback + text"
7,"SUPPRF32902",98,3,20,0,0,48,20,20,"Pilot 8","Pilot 8: max feedback + text"
8,"SUPPRF32902",98,2,46,16,17,14,29,30,"Pilot 8","Pilot 8: max feedback + text"
9,"SUPPRF32902",94,2,83,24,12,74,71,59,"Pilot 8","Pilot 8: max feedback + text"
10,"SUPPRF32902",94,6,33,-46,-13,80,46,79,"Pilot 8","Pilot 8: max feedback + text"
11,"SUPPRF32902",88,9,55,-5,-16,81,71,60,"Pilot 8","Pilot 8: max feedback + text"
12,"SUPPRF32902",98,4,80,10,0,80,80,70,"Pilot 8","Pilot 8: max feedback + text"
13,"SUPPRF32902",86,14,100,15,20,36,80,85,"Pilot 8","Pilot 8: max feedback + text"
14,"SUPPRF32902",96,3,47,-39,-16,55,63,86,"Pilot 8","Pilot 8: max feedback + text"
15,"SUPPRF32902",89,4,71,-18,0,61,71,89,"Pilot 8","Pilot 8: max feedback + text"
16,"SUPPRF32902",94,2,81,-1,1,24,80,82,"Pilot 8","Pilot 8: max feedback + text"
17,"SUPPRF32902",96,7,50,-35,-13,26,63,85,"Pilot 8","Pilot 8: max feedback + text"
18,"SUPPRF32902",91,3,45,-16,-1,14,46,61,"Pilot 8","Pilot 8: max feedback + text"
19,"SUPPRF32902",88,6,38,4,-16,22,54,34,"Pilot 8","Pilot 8: max feedback + text"
20,"SUPPRF32902",82,14,19,-63,-1,28,20,82,"Pilot 8","Pilot 8: max feedback + text"
21,"SUPPRF32902",90,79,24,-8,-13,16,37,32,"Pilot 8","Pilot 8: max feedback + text"
22,"SUPPRF32902",89,13,75,-14,29,14,46,89,"Pilot 8","Pilot 8: max feedback + text"
23,"SUPPRF32902",90,5,62,-26,-1,14,63,88,"Pilot 8","Pilot 8: max feedback + text"
24,"SUPPRF32902",93,8,15,-29,-14,10,29,44,"Pilot 8","Pilot 8: max feedback + text"
25,"SUPPRF32902",96,9,35,-1,15,19,20,36,"Pilot 8","Pilot 8: max feedback + text"
26,"SUPPRF32902",91,17,47,-12,27,14,20,59,"Pilot 8","Pilot 8: max feedback + text"
27,"SUPPRF32902",87,12,41,7,-13,17,54,34,"Pilot 8","Pilot 8: max feedback + text"
28,"SUPPRF32902",96,12,78,67,24,18,54,11,"Pilot 8","Pilot 8: max feedback + text"
29,"SUPPRF32902",89,12,61,18,24,16,37,43,"Pilot 8","Pilot 8: max feedback + text"
30,"SUPPRF32902",97,11,8,-15,-12,21,20,23,"Pilot 8","Pilot 8: max feedback + text"
31,"SUPPRF32902",92,0,6,-18,-14,23,20,24,"Pilot 8","Pilot 8: max feedback + text"
32,"SUPPRF32902",91,16,29,12,0,27,29,17,"Pilot 8","Pilot 8: max feedback + text"
33,"SUPPRF32902",92,12,58,33,12,12,46,25,"Pilot 8","Pilot 8: max feedback + text"
34,"SUPPRF32902",98,15,34,8,-12,16,46,26,"Pilot 8","Pilot 8: max feedback + text"
35,"SUPPRF32902",91,10,28,-24,-1,18,29,52,"Pilot 8","Pilot 8: max feedback + text"
36,"SUPPRF32902",87,22,88,22,25,18,63,66,"Pilot 8","Pilot 8: max feedback + text"
37,"SUPPRF32902",72,13,67,45,-13,12,80,22,"Pilot 8","Pilot 8: max feedback + text"
38,"SUPPRF32902",97,2,96,36,16,7,80,60,"Pilot 8","Pilot 8: max feedback + text"
39,"SUPPRF32902",95,9,16,-38,-13,29,29,54,"Pilot 8","Pilot 8: max feedback + text"
40,"SUPPRF32902",78,18,22,-13,-15,16,37,35,"Pilot 8","Pilot 8: max feedback + text"
41,"SUPPRF32902",92,14,58,31,29,24,29,27,"Pilot 8","Pilot 8: max feedback + text"
42,"SUPPRF32902",100,0,46,-10,0,20,46,56,"Pilot 8","Pilot 8: max feedback + text"
43,"SUPPRF32902",95,0,37,-18,0,17,37,55,"Pilot 8","Pilot 8: max feedback + text"
44,"SUPPRF32902",94,11,66,-9,12,5,54,75,"Pilot 8","Pilot 8: max feedback + text"
45,"SUPPRF32902",87,14,55,30,1,13,54,25,"Pilot 8","Pilot 8: max feedback + text"
46,"SUPPRF32902",97,3,70,48,-1,9,71,22,"Pilot 8","Pilot 8: max feedback + text"
47,"SUPPRF32902",89,12,77,-5,14,6,63,82,"Pilot 8","Pilot 8: max feedback + text"
48,"SUPPRF32902",97,1,56,17,-15,99,71,39,"Pilot 8","Pilot 8: max feedback + text"
1,"SUPPRF94776",62,18,54,6,0,36,54,48,"Pilot 8","Pilot 8: max feedback + text"
2,"SUPPRF94776",60,8,47,3,27,51,20,44,"Pilot 8","Pilot 8: max feedback + text"
3,"SUPPRF94776",52,8,24,-32,-13,38,37,56,"Pilot 8","Pilot 8: max feedback + text"
4,"SUPPRF94776",47,6,94,21,23,82,71,73,"Pilot 8","Pilot 8: max feedback + text"
5,"SUPPRF94776",62,8,35,17,15,70,20,18,"Pilot 8","Pilot 8: max feedback + text"
6,"SUPPRF94776",48,7,67,-12,-13,58,80,79,"Pilot 8","Pilot 8: max feedback + text"
7,"SUPPRF94776",68,8,77,14,14,43,63,63,"Pilot 8","Pilot 8: max feedback + text"
8,"SUPPRF94776",50,5,70,4,-1,50,71,66,"Pilot 8","Pilot 8: max feedback + text"
9,"SUPPRF94776",67,6,75,36,29,35,46,39,"Pilot 8","Pilot 8: max feedback + text"
10,"SUPPRF94776",66,4,96,46,16,63,80,50,"Pilot 8","Pilot 8: max feedback + text"
11,"SUPPRF94776",50,7,41,4,-13,58,54,37,"Pilot 8","Pilot 8: max feedback + text"
12,"SUPPRF94776",51,5,38,-11,-16,34,54,49,"Pilot 8","Pilot 8: max feedback + text"
13,"SUPPRF94776",59,6,49,23,12,57,37,26,"Pilot 8","Pilot 8: max feedback + text"
14,"SUPPRF94776",75,4,19,0,-1,80,20,19,"Pilot 8","Pilot 8: max feedback + text"
15,"SUPPRF94776",50,6,8,-64,-12,9,20,72,"Pilot 8","Pilot 8: max feedback + text"
16,"SUPPRF94776",51,6,38,-2,1,71,37,40,"Pilot 8","Pilot 8: max feedback + text"
17,"SUPPRF94776",64,5,58,44,12,7,46,14,"Pilot 8","Pilot 8: max feedback + text"
18,"SUPPRF94776",51,7,22,-12,-15,30,37,34,"Pilot 8","Pilot 8: max feedback + text"
19,"SUPPRF94776",67,6,46,34,17,86,29,12,"Pilot 8","Pilot 8: max feedback + text"
20,"SUPPRF94776",78,73,80,7,0,73,80,73,"Pilot 8","Pilot 8: max feedback + text"
21,"SUPPRF94776",66,8,55,4,-16,21,71,51,"Pilot 8","Pilot 8: max feedback + text"
22,"SUPPRF94776",68,7,55,20,1,63,54,35,"Pilot 8","Pilot 8: max feedback + text"
23,"SUPPRF94776",51,6,45,7,-1,29,46,38,"Pilot 8","Pilot 8: max feedback + text"
24,"SUPPRF94776",49,5,47,-25,-16,12,63,72,"Pilot 8","Pilot 8: max feedback + text"
25,"SUPPRF94776",50,6,16,-11,-13,13,29,27,"Pilot 8","Pilot 8: max feedback + text"
26,"SUPPRF94776",77,6,100,87,20,58,80,13,"Pilot 8","Pilot 8: max feedback + text"
27,"SUPPRF94776",50,5,56,-25,-15,59,71,81,"Pilot 8","Pilot 8: max feedback + text"
28,"SUPPRF94776",58,4,46,-2,0,34,46,48,"Pilot 8","Pilot 8: max feedback + text"
29,"SUPPRF94776",59,4,71,16,0,29,71,55,"Pilot 8","Pilot 8: max feedback + text"
30,"SUPPRF94776",59,6,68,9,-12,19,80,59,"Pilot 8","Pilot 8: max feedback + text"
31,"SUPPRF94776",49,6,33,-14,-13,30,46,47,"Pilot 8","Pilot 8: max feedback + text"
32,"SUPPRF94776",51,51,37,20,0,17,37,17,"Pilot 8","Pilot 8: max feedback + text"
33,"SUPPRF94776",50,49,28,-5,-1,56,29,33,"Pilot 8","Pilot 8: max feedback + text"
34,"SUPPRF94776",52,5,6,-34,-14,55,20,40,"Pilot 8","Pilot 8: max feedback + text"
35,"SUPPRF94776",50,5,50,5,-13,20,63,45,"Pilot 8","Pilot 8: max feedback + text"
36,"SUPPRF94776",58,10,66,13,12,41,54,53,"Pilot 8","Pilot 8: max feedback + text"
37,"SUPPRF94776",62,7,61,12,24,37,37,49,"Pilot 8","Pilot 8: max feedback + text"
38,"SUPPRF94776",70,5,78,42,24,65,54,36,"Pilot 8","Pilot 8: max feedback + text"
39,"SUPPRF94776",48,5,58,36,29,85,29,22,"Pilot 8","Pilot 8: max feedback + text"
40,"SUPPRF94776",52,5,81,16,1,57,80,65,"Pilot 8","Pilot 8: max feedback + text"
41,"SUPPRF94776",54,9,20,13,0,74,20,7,"Pilot 8","Pilot 8: max feedback + text"
42,"SUPPRF94776",68,4,88,38,25,10,63,50,"Pilot 8","Pilot 8: max feedback + text"
43,"SUPPRF94776",52,4,83,8,12,46,71,75,"Pilot 8","Pilot 8: max feedback + text"
44,"SUPPRF94776",50,6,63,17,0,29,63,46,"Pilot 8","Pilot 8: max feedback + text"
45,"SUPPRF94776",55,5,62,1,-1,50,63,61,"Pilot 8","Pilot 8: max feedback + text"
46,"SUPPRF94776",50,9,29,10,0,40,29,19,"Pilot 8","Pilot 8: max feedback + text"
47,"SUPPRF94776",51,32,34,-16,-12,0,46,50,"Pilot 8","Pilot 8: max feedback + text"
48,"SUPPRF94776",50,6,15,2,-14,55,29,13,"Pilot 8","Pilot 8: max feedback + text"
1,"SUPPRF72685",63,14,58,11,29,54,29,47,"Pilot 8","Pilot 8: max feedback + text"
2,"SUPPRF72685",65,12,47,-5,27,84,20,52,"Pilot 8","Pilot 8: max feedback + text"
3,"SUPPRF72685",84,7,96,50,16,26,80,46,"Pilot 8","Pilot 8: max feedback + text"
4,"SUPPRF72685",83,2,46,-12,0,59,46,58,"Pilot 8","Pilot 8: max feedback + text"
5,"SUPPRF72685",85,5,78,17,24,11,54,61,"Pilot 8","Pilot 8: max feedback + text"
6,"SUPPRF72685",89,9,54,-5,0,48,54,59,"Pilot 8","Pilot 8: max feedback + text"
7,"SUPPRF72685",76,1,70,31,-1,7,71,39,"Pilot 8","Pilot 8: max feedback + text"
8,"SUPPRF72685",57,1,41,-8,-13,28,54,49,"Pilot 8","Pilot 8: max feedback + text"
9,"SUPPRF72685",51,58,38,-15,1,29,37,53,"Pilot 8","Pilot 8: max feedback + text"
10,"SUPPRF72685",90,4,16,-34,-13,0,29,50,"Pilot 8","Pilot 8: max feedback + text"
11,"SUPPRF72685",90,3,38,17,-16,58,54,21,"Pilot 8","Pilot 8: max feedback + text"
12,"SUPPRF72685",91,1,19,10,-1,7,20,9,"Pilot 8","Pilot 8: max feedback + text"
13,"SUPPRF72685",93,3,77,18,14,41,63,59,"Pilot 8","Pilot 8: max feedback + text"
14,"SUPPRF72685",95,3,81,2,1,51,80,79,"Pilot 8","Pilot 8: max feedback + text"
15,"SUPPRF72685",93,1,49,31,12,25,37,18,"Pilot 8","Pilot 8: max feedback + text"
16,"SUPPRF72685",83,1,100,42,20,50,80,58,"Pilot 8","Pilot 8: max feedback + text"
17,"SUPPRF72685",94,3,15,-25,-14,51,29,40,"Pilot 8","Pilot 8: max feedback + text"
18,"SUPPRF72685",85,2,61,12,24,28,37,49,"Pilot 8","Pilot 8: max feedback + text"
19,"SUPPRF72685",94,5,66,13,12,47,54,53,"Pilot 8","Pilot 8: max feedback + text"
20,"SUPPRF72685",92,2,29,5,0,22,29,24,"Pilot 8","Pilot 8: max feedback + text"
21,"SUPPRF72685",1,2,24,-66,-13,86,37,90,"Pilot 8","Pilot 8: max feedback + text"
22,"SUPPRF72685",52,3,28,-25,-1,3,29,53,"Pilot 8","Pilot 8: max feedback + text"
23,"SUPPRF72685",94,1,22,-33,-15,58,37,55,"Pilot 8","Pilot 8: max feedback + text"
24,"SUPPRF72685",95,2,8,-16,-12,85,20,24,"Pilot 8","Pilot 8: max feedback + text"
25,"SUPPRF72685",94,1,35,-15,15,9,20,50,"Pilot 8","Pilot 8: max feedback + text"
26,"SUPPRF72685",77,2,56,13,-15,29,71,43,"Pilot 8","Pilot 8: max feedback + text"
27,"SUPPRF72685",88,4,45,7,-1,25,46,38,"Pilot 8","Pilot 8: max feedback + text"
28,"SUPPRF72685",91,3,6,-9,-14,78,20,15,"Pilot 8","Pilot 8: max feedback + text"
29,"SUPPRF72685",49,3,62,4,-1,54,63,58,"Pilot 8","Pilot 8: max feedback + text"
30,"SUPPRF72685",93,4,47,-2,-16,37,63,49,"Pilot 8","Pilot 8: max feedback + text"
31,"SUPPRF72685",82,7,50,-10,-13,51,63,60,"Pilot 8","Pilot 8: max feedback + text"
32,"SUPPRF72685",86,6,71,21,0,27,71,50,"Pilot 8","Pilot 8: max feedback + text"
33,"SUPPRF72685",45,13,55,-19,-16,69,71,74,"Pilot 8","Pilot 8: max feedback + text"
34,"SUPPRF72685",10,9,88,46,25,62,63,42,"Pilot 8","Pilot 8: max feedback + text"
35,"SUPPRF72685",55,20,34,-28,-12,35,46,62,"Pilot 8","Pilot 8: max feedback + text"
36,"SUPPRF72685",62,20,33,-21,-13,37,46,54,"Pilot 8","Pilot 8: max feedback + text"
37,"SUPPRF72685",53,52,67,-5,-13,48,80,72,"Pilot 8","Pilot 8: max feedback + text"
38,"SUPPRF72685",60,42,37,-37,0,44,37,74,"Pilot 8","Pilot 8: max feedback + text"
39,"SUPPRF72685",47,52,20,-51,0,23,20,71,"Pilot 8","Pilot 8: max feedback + text"
40,"SUPPRF72685",49,49,94,31,23,41,71,63,"Pilot 8","Pilot 8: max feedback + text"
41,"SUPPRF72685",45,57,63,-7,0,44,63,70,"Pilot 8","Pilot 8: max feedback + text"
42,"SUPPRF72685",50,57,46,26,17,59,29,20,"Pilot 8","Pilot 8: max feedback + text"
43,"SUPPRF72685",55,51,58,-7,12,36,46,65,"Pilot 8","Pilot 8: max feedback + text"
44,"SUPPRF72685",56,49,68,19,-12,40,80,49,"Pilot 8","Pilot 8: max feedback + text"
45,"SUPPRF72685",55,36,75,20,29,41,46,55,"Pilot 8","Pilot 8: max feedback + text"
46,"SUPPRF72685",26,36,83,18,12,47,71,65,"Pilot 8","Pilot 8: max feedback + text"
47,"SUPPRF72685",51,51,55,-4,1,56,54,59,"Pilot 8","Pilot 8: max feedback + text"
48,"SUPPRF72685",49,45,80,30,0,54,80,50,"Pilot 8","Pilot 8: max feedback + text"
1,"SUPPRF43781",59,41,19,-6,-1,31,20,25,"Pilot 8","Pilot 8: max feedback + text"
2,"SUPPRF43781",47,41,47,-21,-16,37,63,68,"Pilot 8","Pilot 8: max feedback + text"
3,"SUPPRF43781",44,45,50,-10,-13,28,63,60,"Pilot 8","Pilot 8: max feedback + text"
4,"SUPPRF43781",37,33,8,-18,-12,34,20,26,"Pilot 8","Pilot 8: max feedback + text"
5,"SUPPRF43781",40,30,45,4,-1,25,46,41,"Pilot 8","Pilot 8: max feedback + text"
6,"SUPPRF43781",44,36,58,19,12,30,46,39,"Pilot 8","Pilot 8: max feedback + text"
7,"SUPPRF43781",61,30,61,18,24,28,37,43,"Pilot 8","Pilot 8: max feedback + text"
8,"SUPPRF43781",77,18,78,19,24,32,54,59,"Pilot 8","Pilot 8: max feedback + text"
9,"SUPPRF43781",51,38,20,2,0,27,20,18,"Pilot 8","Pilot 8: max feedback + text"
10,"SUPPRF43781",53,29,35,10,15,23,20,25,"Pilot 8","Pilot 8: max feedback + text"
11,"SUPPRF43781",89,13,96,31,16,27,80,65,"Pilot 8","Pilot 8: max feedback + text"
12,"SUPPRF43781",26,67,41,-58,-13,7,54,99,"Pilot 8","Pilot 8: max feedback + text"
13,"SUPPRF43781",99,14,100,15,20,22,80,85,"Pilot 8","Pilot 8: max feedback + text"
14,"SUPPRF43781",36,23,16,-8,-13,26,29,24,"Pilot 8","Pilot 8: max feedback + text"
15,"SUPPRF43781",67,24,88,24,25,27,63,64,"Pilot 8","Pilot 8: max feedback + text"
16,"SUPPRF43781",31,33,34,-24,-12,18,46,58,"Pilot 8","Pilot 8: max feedback + text"
17,"SUPPRF43781",62,39,71,10,0,32,71,61,"Pilot 8","Pilot 8: max feedback + text"
18,"SUPPRF43781",51,33,46,17,17,29,29,29,"Pilot 8","Pilot 8: max feedback + text"
19,"SUPPRF43781",58,20,77,13,14,28,63,64,"Pilot 8","Pilot 8: max feedback + text"
20,"SUPPRF43781",42,11,38,-5,1,13,37,43,"Pilot 8","Pilot 8: max feedback + text"
21,"SUPPRF43781",89,6,70,1,-1,19,71,69,"Pilot 8","Pilot 8: max feedback + text"
22,"SUPPRF43781",68,9,63,4,0,21,63,59,"Pilot 8","Pilot 8: max feedback + text"
23,"SUPPRF43781",25,8,38,-15,-16,17,54,53,"Pilot 8","Pilot 8: max feedback + text"
24,"SUPPRF43781",69,13,94,28,23,21,71,66,"Pilot 8","Pilot 8: max feedback + text"
25,"SUPPRF43781",65,8,62,10,-1,9,63,52,"Pilot 8","Pilot 8: max feedback + text"
26,"SUPPRF43781",21,5,22,-17,-15,25,37,39,"Pilot 8","Pilot 8: max feedback + text"
27,"SUPPRF43781",66,3,83,19,12,12,71,64,"Pilot 8","Pilot 8: max feedback + text"
28,"SUPPRF43781",29,8,68,-18,-12,23,80,86,"Pilot 8","Pilot 8: max feedback + text"
29,"SUPPRF43781",68,14,55,6,1,20,54,49,"Pilot 8","Pilot 8: max feedback + text"
30,"SUPPRF43781",69,2,80,0,0,17,80,80,"Pilot 8","Pilot 8: max feedback + text"
31,"SUPPRF43781",66,14,46,-1,0,33,46,47,"Pilot 8","Pilot 8: max feedback + text"
32,"SUPPRF43781",31,6,15,-11,-14,28,29,26,"Pilot 8","Pilot 8: max feedback + text"
33,"SUPPRF43781",50,12,49,21,12,26,37,28,"Pilot 8","Pilot 8: max feedback + text"
34,"SUPPRF43781",43,9,28,-4,-1,11,29,32,"Pilot 8","Pilot 8: max feedback + text"
35,"SUPPRF43781",48,68,47,38,27,3,20,9,"Pilot 8","Pilot 8: max feedback + text"
36,"SUPPRF43781",50,17,55,-6,-16,25,71,61,"Pilot 8","Pilot 8: max feedback + text"
37,"SUPPRF43781",59,18,58,27,29,25,29,31,"Pilot 8","Pilot 8: max feedback + text"
38,"SUPPRF43781",70,7,54,-2,0,22,54,56,"Pilot 8","Pilot 8: max feedback + text"
39,"SUPPRF43781",50,23,33,-13,-13,17,46,46,"Pilot 8","Pilot 8: max feedback + text"
40,"SUPPRF43781",50,13,37,7,0,11,37,30,"Pilot 8","Pilot 8: max feedback + text"
41,"SUPPRF43781",19,24,56,-32,-15,13,71,88,"Pilot 8","Pilot 8: max feedback + text"
42,"SUPPRF43781",28,13,67,-18,-13,20,80,85,"Pilot 8","Pilot 8: max feedback + text"
43,"SUPPRF43781",11,8,6,-26,-14,16,20,32,"Pilot 8","Pilot 8: max feedback + text"
44,"SUPPRF43781",38,15,24,-10,-13,24,37,34,"Pilot 8","Pilot 8: max feedback + text"
45,"SUPPRF43781",35,21,81,7,1,18,80,74,"Pilot 8","Pilot 8: max feedback + text"
46,"SUPPRF43781",46,23,75,43,29,18,46,32,"Pilot 8","Pilot 8: max feedback + text"
47,"SUPPRF43781",67,1,29,-2,0,19,29,31,"Pilot 8","Pilot 8: max feedback + text"
48,"SUPPRF43781",65,26,66,1,12,18,54,65,"Pilot 8","Pilot 8: max feedback + text"
1,"SUPPRF03208",86,28,38,8,1,20,37,30,"Pilot 8","Pilot 8: max feedback + text"
2,"SUPPRF03208",79,23,28,-8,-1,19,29,36,"Pilot 8","Pilot 8: max feedback + text"
3,"SUPPRF03208",86,7,80,4,0,9,80,76,"Pilot 8","Pilot 8: max feedback + text"
4,"SUPPRF03208",90,5,83,10,12,6,71,73,"Pilot 8","Pilot 8: max feedback + text"
5,"SUPPRF03208",87,4,50,-15,-13,5,63,65,"Pilot 8","Pilot 8: max feedback + text"
6,"SUPPRF03208",90,4,68,-9,-12,13,80,77,"Pilot 8","Pilot 8: max feedback + text"
7,"SUPPRF03208",89,2,45,-30,-1,3,46,75,"Pilot 8","Pilot 8: max feedback + text"
8,"SUPPRF03208",93,1,47,38,27,3,20,9,"Pilot 8","Pilot 8: max feedback + text"
9,"SUPPRF03208",92,1,41,40,-13,42,54,1,"Pilot 8","Pilot 8: max feedback + text"
10,"SUPPRF03208",90,2,61,43,24,6,37,18,"Pilot 8","Pilot 8: max feedback + text"
11,"SUPPRF03208",87,0,33,11,-13,3,46,22,"Pilot 8","Pilot 8: max feedback + text"
12,"SUPPRF03208",90,0,71,21,0,1,71,50,"Pilot 8","Pilot 8: max feedback + text"
13,"SUPPRF03208",89,0,35,26,15,2,20,9,"Pilot 8","Pilot 8: max feedback + text"
14,"SUPPRF03208",100,0,94,31,23,1,71,63,"Pilot 8","Pilot 8: max feedback + text"
15,"SUPPRF03208",91,0,58,30,12,3,46,28,"Pilot 8","Pilot 8: max feedback + text"
16,"SUPPRF03208",90,1,67,-1,-13,1,80,68,"Pilot 8","Pilot 8: max feedback + text"
17,"SUPPRF03208",91,1,49,25,12,2,37,24,"Pilot 8","Pilot 8: max feedback + text"
18,"SUPPRF03208",88,1,8,-7,-12,1,20,15,"Pilot 8","Pilot 8: max feedback + text"
19,"SUPPRF03208",87,1,16,-21,-13,0,29,37,"Pilot 8","Pilot 8: max feedback + text"
20,"SUPPRF03208",85,1,22,2,-15,1,37,20,"Pilot 8","Pilot 8: max feedback + text"
21,"SUPPRF03208",90,1,62,41,-1,2,63,21,"Pilot 8","Pilot 8: max feedback + text"
22,"SUPPRF03208",92,3,96,14,16,0,80,82,"Pilot 8","Pilot 8: max feedback + text"
23,"SUPPRF03208",93,1,75,28,29,1,46,47,"Pilot 8","Pilot 8: max feedback + text"
24,"SUPPRF03208",86,1,15,-31,-14,1,29,46,"Pilot 8","Pilot 8: max feedback + text"
25,"SUPPRF03208",91,1,70,4,-1,1,71,66,"Pilot 8","Pilot 8: max feedback + text"
26,"SUPPRF03208",90,0,66,26,12,2,54,40,"Pilot 8","Pilot 8: max feedback + text"
27,"SUPPRF03208",92,1,100,36,20,1,80,64,"Pilot 8","Pilot 8: max feedback + text"
28,"SUPPRF03208",92,1,20,15,0,1,20,5,"Pilot 8","Pilot 8: max feedback + text"
29,"SUPPRF03208",90,1,6,0,-14,0,20,6,"Pilot 8","Pilot 8: max feedback + text"
30,"SUPPRF03208",87,1,63,35,0,1,63,28,"Pilot 8","Pilot 8: max feedback + text"
31,"SUPPRF03208",87,0,54,52,0,1,54,2,"Pilot 8","Pilot 8: max feedback + text"
32,"SUPPRF03208",85,1,47,-3,-16,1,63,50,"Pilot 8","Pilot 8: max feedback + text"
33,"SUPPRF03208",90,0,38,37,-16,0,54,1,"Pilot 8","Pilot 8: max feedback + text"
34,"SUPPRF03208",88,0,29,10,0,1,29,19,"Pilot 8","Pilot 8: max feedback + text"
35,"SUPPRF03208",90,0,56,6,-15,2,71,50,"Pilot 8","Pilot 8: max feedback + text"
36,"SUPPRF03208",86,1,46,15,0,1,46,31,"Pilot 8","Pilot 8: max feedback + text"
37,"SUPPRF03208",89,1,24,1,-13,1,37,23,"Pilot 8","Pilot 8: max feedback + text"
38,"SUPPRF03208",88,1,19,10,-1,1,20,9,"Pilot 8","Pilot 8: max feedback + text"
39,"SUPPRF03208",92,1,55,52,-16,2,71,3,"Pilot 8","Pilot 8: max feedback + text"
40,"SUPPRF03208",87,1,55,29,1,1,54,26,"Pilot 8","Pilot 8: max feedback + text"
41,"SUPPRF03208",88,1,34,8,-12,1,46,26,"Pilot 8","Pilot 8: max feedback + text"
42,"SUPPRF03208",88,2,46,4,17,0,29,42,"Pilot 8","Pilot 8: max feedback + text"
43,"SUPPRF03208",90,1,88,65,25,1,63,23,"Pilot 8","Pilot 8: max feedback + text"
44,"SUPPRF03208",87,0,77,36,14,2,63,41,"Pilot 8","Pilot 8: max feedback + text"
45,"SUPPRF03208",88,3,58,54,29,1,29,4,"Pilot 8","Pilot 8: max feedback + text"
46,"SUPPRF03208",90,1,81,41,1,1,80,40,"Pilot 8","Pilot 8: max feedback + text"
47,"SUPPRF03208",89,1,37,-5,0,2,37,42,"Pilot 8","Pilot 8: max feedback + text"
48,"SUPPRF03208",90,1,78,42,24,1,54,36,"Pilot 8","Pilot 8: max feedback + text"
1,"SUPPRF96217",42,21,50,7,-13,35,63,43,"Pilot 8","Pilot 8: max feedback + text"
2,"SUPPRF96217",43,31,47,12,27,34,20,35,"Pilot 8","Pilot 8: max feedback + text"
3,"SUPPRF96217",44,26,45,-10,-1,45,46,55,"Pilot 8","Pilot 8: max feedback + text"
4,"SUPPRF96217",42,22,19,-19,-1,59,20,38,"Pilot 8","Pilot 8: max feedback + text"
5,"SUPPRF96217",41,20,77,24,14,34,63,53,"Pilot 8","Pilot 8: max feedback + text"
6,"SUPPRF96217",32,14,37,11,0,66,37,26,"Pilot 8","Pilot 8: max feedback + text"
7,"SUPPRF96217",43,10,38,16,1,60,37,22,"Pilot 8","Pilot 8: max feedback + text"
8,"SUPPRF96217",39,18,61,29,24,67,37,32,"Pilot 8","Pilot 8: max feedback + text"
9,"SUPPRF96217",59,8,100,33,20,29,80,67,"Pilot 8","Pilot 8: max feedback + text"
10,"SUPPRF96217",50,23,34,-22,-12,70,46,56,"Pilot 8","Pilot 8: max feedback + text"
11,"SUPPRF96217",50,15,58,20,12,60,46,38,"Pilot 8","Pilot 8: max feedback + text"
12,"SUPPRF96217",49,22,55,-11,-16,58,71,66,"Pilot 8","Pilot 8: max feedback + text"
13,"SUPPRF96217",44,21,16,-18,-13,63,29,34,"Pilot 8","Pilot 8: max feedback + text"
14,"SUPPRF96217",65,23,88,15,25,62,63,73,"Pilot 8","Pilot 8: max feedback + text"
15,"SUPPRF96217",51,21,55,-17,1,60,54,72,"Pilot 8","Pilot 8: max feedback + text"
16,"SUPPRF96217",50,17,68,-11,-12,71,80,79,"Pilot 8","Pilot 8: max feedback + text"
17,"SUPPRF96217",46,12,94,14,23,77,71,80,"Pilot 8","Pilot 8: max feedback + text"
18,"SUPPRF96217",50,11,66,10,12,75,54,56,"Pilot 8","Pilot 8: max feedback + text"
19,"SUPPRF96217",43,32,96,19,16,31,80,77,"Pilot 8","Pilot 8: max feedback + text"
20,"SUPPRF96217",44,32,78,14,24,67,54,64,"Pilot 8","Pilot 8: max feedback + text"
21,"SUPPRF96217",53,25,22,-20,-15,72,37,42,"Pilot 8","Pilot 8: max feedback + text"
22,"SUPPRF96217",50,15,47,-5,-16,65,63,52,"Pilot 8","Pilot 8: max feedback + text"
23,"SUPPRF96217",39,14,62,4,-1,68,63,58,"Pilot 8","Pilot 8: max feedback + text"
24,"SUPPRF96217",45,17,28,-5,-1,50,29,33,"Pilot 8","Pilot 8: max feedback + text"
25,"SUPPRF96217",45,18,46,4,17,30,29,42,"Pilot 8","Pilot 8: max feedback + text"
26,"SUPPRF96217",44,14,70,-17,-1,59,71,87,"Pilot 8","Pilot 8: max feedback + text"
27,"SUPPRF96217",45,14,35,2,15,56,20,33,"Pilot 8","Pilot 8: max feedback + text"
28,"SUPPRF96217",45,16,80,0,0,77,80,80,"Pilot 8","Pilot 8: max feedback + text"
29,"SUPPRF96217",38,13,15,-60,-14,27,29,75,"Pilot 8","Pilot 8: max feedback + text"
30,"SUPPRF96217",44,14,63,22,0,24,63,41,"Pilot 8","Pilot 8: max feedback + text"
31,"SUPPRF96217",41,14,49,14,12,15,37,35,"Pilot 8","Pilot 8: max feedback + text"
32,"SUPPRF96217",54,14,29,-7,0,73,29,36,"Pilot 8","Pilot 8: max feedback + text"
33,"SUPPRF96217",35,27,6,-34,-14,73,20,40,"Pilot 8","Pilot 8: max feedback + text"
34,"SUPPRF96217",46,13,81,48,1,15,80,33,"Pilot 8","Pilot 8: max feedback + text"
35,"SUPPRF96217",43,13,56,-23,-15,72,71,79,"Pilot 8","Pilot 8: max feedback + text"
36,"SUPPRF96217",45,11,67,8,-13,55,80,59,"Pilot 8","Pilot 8: max feedback + text"
37,"SUPPRF96217",45,15,24,-8,-13,29,37,32,"Pilot 8","Pilot 8: max feedback + text"
38,"SUPPRF96217",45,12,71,-6,0,74,71,77,"Pilot 8","Pilot 8: max feedback + text"
39,"SUPPRF96217",41,13,41,-21,-13,50,54,62,"Pilot 8","Pilot 8: max feedback + text"
40,"SUPPRF96217",44,10,54,-14,0,79,54,68,"Pilot 8","Pilot 8: max feedback + text"
41,"SUPPRF96217",45,24,83,2,12,96,71,81,"Pilot 8","Pilot 8: max feedback + text"
42,"SUPPRF96217",53,13,75,-9,29,77,46,84,"Pilot 8","Pilot 8: max feedback + text"
43,"SUPPRF96217",48,19,58,23,29,18,29,35,"Pilot 8","Pilot 8: max feedback + text"
44,"SUPPRF96217",39,9,20,-16,0,11,20,36,"Pilot 8","Pilot 8: max feedback + text"
45,"SUPPRF96217",39,12,38,-22,-16,53,54,60,"Pilot 8","Pilot 8: max feedback + text"
46,"SUPPRF96217",28,13,8,-17,-12,69,20,25,"Pilot 8","Pilot 8: max feedback + text"
47,"SUPPRF96217",41,12,33,0,-13,71,46,33,"Pilot 8","Pilot 8: max feedback + text"
48,"SUPPRF96217",47,16,46,1,0,90,46,45,"Pilot 8","Pilot 8: max feedback + text"
1,"SUPPRF83713",0,2,58,-20,29,83,29,78,"Pilot 8","Pilot 8: max feedback + text"
2,"SUPPRF83713",79,1,81,49,1,37,80,32,"Pilot 8","Pilot 8: max feedback + text"
3,"SUPPRF83713",70,1,33,-3,-13,63,46,36,"Pilot 8","Pilot 8: max feedback + text"
4,"SUPPRF83713",78,0,56,-19,-15,85,71,75,"Pilot 8","Pilot 8: max feedback + text"
5,"SUPPRF83713",82,1,80,9,0,31,80,71,"Pilot 8","Pilot 8: max feedback + text"
6,"SUPPRF83713",76,1,15,-63,-14,69,29,78,"Pilot 8","Pilot 8: max feedback + text"
7,"SUPPRF83713",75,0,49,-18,12,10,37,67,"Pilot 8","Pilot 8: max feedback + text"
8,"SUPPRF83713",74,2,34,-26,-12,15,46,60,"Pilot 8","Pilot 8: max feedback + text"
9,"SUPPRF83713",73,1,29,-45,0,30,29,74,"Pilot 8","Pilot 8: max feedback + text"
10,"SUPPRF83713",72,0,50,-39,-13,79,63,89,"Pilot 8","Pilot 8: max feedback + text"
11,"SUPPRF83713",74,0,71,1,0,60,71,70,"Pilot 8","Pilot 8: max feedback + text"
12,"SUPPRF83713",74,1,22,-43,-15,20,37,65,"Pilot 8","Pilot 8: max feedback + text"
13,"SUPPRF83713",64,1,37,-39,0,63,37,76,"Pilot 8","Pilot 8: max feedback + text"
14,"SUPPRF83713",75,1,20,-56,0,57,20,76,"Pilot 8","Pilot 8: max feedback + text"
15,"SUPPRF83713",70,1,58,-13,12,51,46,71,"Pilot 8","Pilot 8: max feedback + text"
16,"SUPPRF83713",70,3,68,-2,-12,57,80,70,"Pilot 8","Pilot 8: max feedback + text"
17,"SUPPRF83713",76,1,46,25,17,84,29,21,"Pilot 8","Pilot 8: max feedback + text"
18,"SUPPRF83713",77,0,45,-6,-1,17,46,51,"Pilot 8","Pilot 8: max feedback + text"
19,"SUPPRF83713",67,1,28,-33,-1,25,29,61,"Pilot 8","Pilot 8: max feedback + text"
20,"SUPPRF83713",75,4,67,-4,-13,80,80,71,"Pilot 8","Pilot 8: max feedback + text"
21,"SUPPRF83713",77,1,6,-6,-14,73,20,12,"Pilot 8","Pilot 8: max feedback + text"
22,"SUPPRF83713",71,0,75,32,29,71,46,43,"Pilot 8","Pilot 8: max feedback + text"
23,"SUPPRF83713",73,0,19,-39,-1,20,20,58,"Pilot 8","Pilot 8: max feedback + text"
24,"SUPPRF83713",75,3,41,-22,-13,17,54,63,"Pilot 8","Pilot 8: max feedback + text"
25,"SUPPRF83713",65,0,100,24,20,2,80,76,"Pilot 8","Pilot 8: max feedback + text"
26,"SUPPRF83713",4,9,47,-24,27,24,20,71,"Pilot 8","Pilot 8: max feedback + text"
27,"SUPPRF83713",70,10,38,-29,1,8,37,67,"Pilot 8","Pilot 8: max feedback + text"
28,"SUPPRF83713",76,12,70,13,-1,11,71,57,"Pilot 8","Pilot 8: max feedback + text"
29,"SUPPRF83713",82,3,96,6,16,86,80,90,"Pilot 8","Pilot 8: max feedback + text"
30,"SUPPRF83713",78,1,24,4,-13,84,37,20,"Pilot 8","Pilot 8: max feedback + text"
31,"SUPPRF83713",80,3,88,51,25,70,63,37,"Pilot 8","Pilot 8: max feedback + text"
32,"SUPPRF83713",75,6,78,-8,24,19,54,86,"Pilot 8","Pilot 8: max feedback + text"
33,"SUPPRF83713",74,10,94,22,23,14,71,72,"Pilot 8","Pilot 8: max feedback + text"
34,"SUPPRF83713",73,4,66,28,12,59,54,38,"Pilot 8","Pilot 8: max feedback + text"
35,"SUPPRF83713",69,3,38,-52,-16,84,54,90,"Pilot 8","Pilot 8: max feedback + text"
36,"SUPPRF83713",75,0,16,-68,-13,86,29,84,"Pilot 8","Pilot 8: max feedback + text"
37,"SUPPRF83713",79,5,8,-62,-12,24,20,70,"Pilot 8","Pilot 8: max feedback + text"
38,"SUPPRF83713",78,3,62,-8,-1,17,63,70,"Pilot 8","Pilot 8: max feedback + text"
39,"SUPPRF83713",80,5,61,-18,24,17,37,79,"Pilot 8","Pilot 8: max feedback + text"
40,"SUPPRF83713",72,2,46,-53,0,99,46,99,"Pilot 8","Pilot 8: max feedback + text"
41,"SUPPRF83713",78,8,35,-42,15,21,20,77,"Pilot 8","Pilot 8: max feedback + text"
42,"SUPPRF83713",70,3,54,-33,0,18,54,87,"Pilot 8","Pilot 8: max feedback + text"
43,"SUPPRF83713",83,9,83,16,12,14,71,67,"Pilot 8","Pilot 8: max feedback + text"
44,"SUPPRF83713",70,15,77,-11,14,12,63,88,"Pilot 8","Pilot 8: max feedback + text"
45,"SUPPRF83713",76,9,55,9,1,6,54,46,"Pilot 8","Pilot 8: max feedback + text"
46,"SUPPRF83713",80,7,47,0,-16,77,63,47,"Pilot 8","Pilot 8: max feedback + text"
47,"SUPPRF83713",81,12,63,41,0,3,63,22,"Pilot 8","Pilot 8: max feedback + text"
48,"SUPPRF83713",84,10,55,36,-16,83,71,19,"Pilot 8","Pilot 8: max feedback + text"
1,"SUPPRF76101",85,11,70,-20,-1,100,71,90,"Pilot 8","Pilot 8: max feedback + text"
2,"SUPPRF76101",73,14,15,-15,-14,90,29,30,"Pilot 8","Pilot 8: max feedback + text"
3,"SUPPRF76101",72,13,16,6,-13,60,29,10,"Pilot 8","Pilot 8: max feedback + text"
4,"SUPPRF76101",78,15,37,-33,0,27,37,70,"Pilot 8","Pilot 8: max feedback + text"
5,"SUPPRF76101",83,15,29,4,0,89,29,25,"Pilot 8","Pilot 8: max feedback + text"
6,"SUPPRF76101",88,4,88,18,25,95,63,70,"Pilot 8","Pilot 8: max feedback + text"
7,"SUPPRF76101",83,1,47,12,27,85,20,35,"Pilot 8","Pilot 8: max feedback + text"
8,"SUPPRF76101",83,0,55,-35,-16,100,71,90,"Pilot 8","Pilot 8: max feedback + text"
9,"SUPPRF76101",87,0,35,-1,15,81,20,36,"Pilot 8","Pilot 8: max feedback + text"
10,"SUPPRF76101",75,3,34,-51,-12,84,46,85,"Pilot 8","Pilot 8: max feedback + text"
11,"SUPPRF76101",85,0,61,41,24,50,37,20,"Pilot 8","Pilot 8: max feedback + text"
12,"SUPPRF76101",69,3,50,-20,-13,95,63,70,"Pilot 8","Pilot 8: max feedback + text"
13,"SUPPRF76101",81,0,19,-6,-1,86,20,25,"Pilot 8","Pilot 8: max feedback + text"
14,"SUPPRF76101",76,0,6,-14,-14,86,20,20,"Pilot 8","Pilot 8: max feedback + text"
15,"SUPPRF76101",71,6,67,-23,-13,92,80,90,"Pilot 8","Pilot 8: max feedback + text"
16,"SUPPRF76101",81,0,58,22,12,64,46,36,"Pilot 8","Pilot 8: max feedback + text"
17,"SUPPRF76101",65,9,28,-28,-1,79,29,56,"Pilot 8","Pilot 8: max feedback + text"
18,"SUPPRF76101",63,16,41,-34,-13,78,54,75,"Pilot 8","Pilot 8: max feedback + text"
19,"SUPPRF76101",56,13,8,-22,-12,41,20,30,"Pilot 8","Pilot 8: max feedback + text"
20,"SUPPRF76101",64,31,22,22,-15,100,37,0,"Pilot 8","Pilot 8: max feedback + text"
21,"SUPPRF76101",76,18,83,13,12,80,71,70,"Pilot 8","Pilot 8: max feedback + text"
22,"SUPPRF76101",79,8,75,15,29,81,46,60,"Pilot 8","Pilot 8: max feedback + text"
23,"SUPPRF76101",53,6,96,86,16,93,80,10,"Pilot 8","Pilot 8: max feedback + text"
24,"SUPPRF76101",63,10,38,-12,1,72,37,50,"Pilot 8","Pilot 8: max feedback + text"
25,"SUPPRF76101",57,6,24,-31,-13,47,37,55,"Pilot 8","Pilot 8: max feedback + text"
26,"SUPPRF76101",68,8,33,-7,-13,85,46,40,"Pilot 8","Pilot 8: max feedback + text"
27,"SUPPRF76101",73,4,68,-7,-12,90,80,75,"Pilot 8","Pilot 8: max feedback + text"
28,"SUPPRF76101",68,7,45,-15,-1,71,46,60,"Pilot 8","Pilot 8: max feedback + text"
29,"SUPPRF76101",67,9,66,5,12,74,54,61,"Pilot 8","Pilot 8: max feedback + text"
30,"SUPPRF76101",70,6,46,0,0,67,46,46,"Pilot 8","Pilot 8: max feedback + text"
31,"SUPPRF76101",49,8,81,54,1,57,80,27,"Pilot 8","Pilot 8: max feedback + text"
32,"SUPPRF76101",60,7,55,-20,1,100,54,75,"Pilot 8","Pilot 8: max feedback + text"
33,"SUPPRF76101",69,6,78,18,24,80,54,60,"Pilot 8","Pilot 8: max feedback + text"
34,"SUPPRF76101",72,7,47,-8,-16,77,63,55,"Pilot 8","Pilot 8: max feedback + text"
35,"SUPPRF76101",62,8,38,-33,-16,83,54,71,"Pilot 8","Pilot 8: max feedback + text"
36,"SUPPRF76101",63,7,94,24,23,95,71,70,"Pilot 8","Pilot 8: max feedback + text"
37,"SUPPRF76101",69,8,54,-6,0,80,54,60,"Pilot 8","Pilot 8: max feedback + text"
38,"SUPPRF76101",60,6,58,23,29,78,29,35,"Pilot 8","Pilot 8: max feedback + text"
39,"SUPPRF76101",64,1,62,-12,-1,81,63,74,"Pilot 8","Pilot 8: max feedback + text"
40,"SUPPRF76101",66,4,80,4,0,72,80,76,"Pilot 8","Pilot 8: max feedback + text"
41,"SUPPRF76101",64,5,77,27,14,84,63,50,"Pilot 8","Pilot 8: max feedback + text"
42,"SUPPRF76101",64,5,56,-14,-15,90,71,70,"Pilot 8","Pilot 8: max feedback + text"
43,"SUPPRF76101",84,5,71,-4,0,90,71,75,"Pilot 8","Pilot 8: max feedback + text"
44,"SUPPRF76101",78,4,63,13,0,83,63,50,"Pilot 8","Pilot 8: max feedback + text"
45,"SUPPRF76101",80,4,46,6,17,70,29,40,"Pilot 8","Pilot 8: max feedback + text"
46,"SUPPRF76101",80,7,49,5,12,52,37,44,"Pilot 8","Pilot 8: max feedback + text"
47,"SUPPRF76101",51,50,20,10,0,0,20,10,"Pilot 8","Pilot 8: max feedback + text"
48,"SUPPRF76101",89,8,100,21,20,90,80,79,"Pilot 8","Pilot 8: max feedback + text"
1,"SUPPRF21477",75,33,71,18,0,35,71,53,"Pilot 8","Pilot 8: max feedback + text"
2,"SUPPRF21477",73,24,58,8,29,68,29,50,"Pilot 8","Pilot 8: max feedback + text"
3,"SUPPRF21477",75,20,55,8,-16,57,71,47,"Pilot 8","Pilot 8: max feedback + text"
4,"SUPPRF21477",74,22,6,-16,-14,55,20,22,"Pilot 8","Pilot 8: max feedback + text"
5,"SUPPRF21477",78,35,58,22,12,73,46,36,"Pilot 8","Pilot 8: max feedback + text"
6,"SUPPRF21477",78,19,16,-1,-13,74,29,17,"Pilot 8","Pilot 8: max feedback + text"
7,"SUPPRF21477",78,28,70,7,-1,44,71,63,"Pilot 8","Pilot 8: max feedback + text"
8,"SUPPRF21477",75,29,94,34,23,67,71,60,"Pilot 8","Pilot 8: max feedback + text"
9,"SUPPRF21477",81,21,46,-23,0,65,46,69,"Pilot 8","Pilot 8: max feedback + text"
10,"SUPPRF21477",76,24,29,2,0,68,29,27,"Pilot 8","Pilot 8: max feedback + text"
11,"SUPPRF21477",78,30,28,4,-1,69,29,24,"Pilot 8","Pilot 8: max feedback + text"
12,"SUPPRF21477",76,12,19,2,-1,77,20,17,"Pilot 8","Pilot 8: max feedback + text"
13,"SUPPRF21477",84,23,49,-6,12,51,37,55,"Pilot 8","Pilot 8: max feedback + text"
14,"SUPPRF21477",76,22,80,16,0,32,80,64,"Pilot 8","Pilot 8: max feedback + text"
15,"SUPPRF21477",78,20,8,-10,-12,70,20,18,"Pilot 8","Pilot 8: max feedback + text"
16,"SUPPRF21477",76,30,54,-5,0,33,54,59,"Pilot 8","Pilot 8: max feedback + text"
17,"SUPPRF21477",79,23,88,40,25,27,63,48,"Pilot 8","Pilot 8: max feedback + text"
18,"SUPPRF21477",79,20,47,-24,-16,39,63,71,"Pilot 8","Pilot 8: max feedback + text"
19,"SUPPRF21477",82,23,24,-1,-13,66,37,25,"Pilot 8","Pilot 8: max feedback + text"
20,"SUPPRF21477",79,21,38,6,1,64,37,32,"Pilot 8","Pilot 8: max feedback + text"
21,"SUPPRF21477",86,24,96,23,16,68,80,73,"Pilot 8","Pilot 8: max feedback + text"
22,"SUPPRF21477",78,18,20,-31,0,40,20,51,"Pilot 8","Pilot 8: max feedback + text"
23,"SUPPRF21477",80,22,66,8,12,32,54,58,"Pilot 8","Pilot 8: max feedback + text"
24,"SUPPRF21477",80,17,22,-45,-15,29,37,67,"Pilot 8","Pilot 8: max feedback + text"
25,"SUPPRF21477",75,25,45,-17,-1,41,46,62,"Pilot 8","Pilot 8: max feedback + text"
26,"SUPPRF21477",89,21,67,0,-13,40,80,67,"Pilot 8","Pilot 8: max feedback + text"
27,"SUPPRF21477",81,18,61,25,24,45,37,36,"Pilot 8","Pilot 8: max feedback + text"
28,"SUPPRF21477",85,21,81,10,1,38,80,71,"Pilot 8","Pilot 8: max feedback + text"
29,"SUPPRF21477",85,15,34,-36,-12,24,46,70,"Pilot 8","Pilot 8: max feedback + text"
30,"SUPPRF21477",77,32,50,-19,-13,35,63,69,"Pilot 8","Pilot 8: max feedback + text"
31,"SUPPRF21477",78,18,47,29,27,64,20,18,"Pilot 8","Pilot 8: max feedback + text"
32,"SUPPRF21477",79,16,77,15,14,27,63,62,"Pilot 8","Pilot 8: max feedback + text"
33,"SUPPRF21477",80,21,55,4,1,37,54,51,"Pilot 8","Pilot 8: max feedback + text"
34,"SUPPRF21477",82,16,37,-2,0,45,37,39,"Pilot 8","Pilot 8: max feedback + text"
35,"SUPPRF21477",85,19,68,-9,-12,33,80,77,"Pilot 8","Pilot 8: max feedback + text"
36,"SUPPRF21477",71,25,56,-12,-15,26,71,68,"Pilot 8","Pilot 8: max feedback + text"
37,"SUPPRF21477",87,21,15,-5,-14,50,29,20,"Pilot 8","Pilot 8: max feedback + text"
38,"SUPPRF21477",74,28,38,0,-16,64,54,38,"Pilot 8","Pilot 8: max feedback + text"
39,"SUPPRF21477",78,14,46,21,17,25,29,25,"Pilot 8","Pilot 8: max feedback + text"
40,"SUPPRF21477",84,17,35,19,15,64,20,16,"Pilot 8","Pilot 8: max feedback + text"
41,"SUPPRF21477",81,20,75,34,29,67,46,41,"Pilot 8","Pilot 8: max feedback + text"
42,"SUPPRF21477",75,15,41,8,-13,62,54,33,"Pilot 8","Pilot 8: max feedback + text"
43,"SUPPRF21477",79,24,83,52,12,60,71,31,"Pilot 8","Pilot 8: max feedback + text"
44,"SUPPRF21477",84,18,63,0,0,71,63,63,"Pilot 8","Pilot 8: max feedback + text"
45,"SUPPRF21477",82,21,62,-5,-1,76,63,67,"Pilot 8","Pilot 8: max feedback + text"
46,"SUPPRF21477",84,21,33,5,-13,64,46,28,"Pilot 8","Pilot 8: max feedback + text"
47,"SUPPRF21477",81,25,78,44,24,60,54,34,"Pilot 8","Pilot 8: max feedback + text"
48,"SUPPRF21477",87,22,100,24,20,81,80,76,"Pilot 8","Pilot 8: max feedback + text"
1,"SUPPRF30226",28,90,34,-12,-12,63,46,46,"Pilot 8","Pilot 8: max feedback + text"
2,"SUPPRF30226",37,84,71,30,0,64,71,41,"Pilot 8","Pilot 8: max feedback + text"
3,"SUPPRF30226",16,89,6,-46,-14,35,20,52,"Pilot 8","Pilot 8: max feedback + text"
4,"SUPPRF30226",24,94,38,-21,-16,75,54,59,"Pilot 8","Pilot 8: max feedback + text"
5,"SUPPRF30226",28,93,46,-16,17,79,29,62,"Pilot 8","Pilot 8: max feedback + text"
6,"SUPPRF30226",24,92,78,53,24,44,54,25,"Pilot 8","Pilot 8: max feedback + text"
7,"SUPPRF30226",9,92,38,-17,1,32,37,55,"Pilot 8","Pilot 8: max feedback + text"
8,"SUPPRF30226",22,87,96,81,16,33,80,15,"Pilot 8","Pilot 8: max feedback + text"
9,"SUPPRF30226",18,91,83,29,12,26,71,54,"Pilot 8","Pilot 8: max feedback + text"
10,"SUPPRF30226",12,88,77,44,14,20,63,33,"Pilot 8","Pilot 8: max feedback + text"
11,"SUPPRF30226",22,93,33,-22,-13,25,46,55,"Pilot 8","Pilot 8: max feedback + text"
12,"SUPPRF30226",16,91,22,-16,-15,64,37,38,"Pilot 8","Pilot 8: max feedback + text"
13,"SUPPRF30226",15,89,58,3,29,25,29,55,"Pilot 8","Pilot 8: max feedback + text"
14,"SUPPRF30226",20,97,61,26,24,40,37,35,"Pilot 8","Pilot 8: max feedback + text"
15,"SUPPRF30226",86,89,47,25,27,19,20,22,"Pilot 8","Pilot 8: max feedback + text"
16,"SUPPRF30226",24,100,15,0,-14,71,29,15,"Pilot 8","Pilot 8: max feedback + text"
17,"SUPPRF30226",26,100,46,31,0,78,46,15,"Pilot 8","Pilot 8: max feedback + text"
18,"SUPPRF30226",8,93,68,20,-12,30,80,48,"Pilot 8","Pilot 8: max feedback + text"
19,"SUPPRF30226",10,98,8,-19,-12,77,20,27,"Pilot 8","Pilot 8: max feedback + text"
20,"SUPPRF30226",16,94,94,47,23,75,71,47,"Pilot 8","Pilot 8: max feedback + text"
21,"SUPPRF30226",20,96,28,-2,-1,84,29,30,"Pilot 8","Pilot 8: max feedback + text"
22,"SUPPRF30226",19,99,35,5,15,59,20,30,"Pilot 8","Pilot 8: max feedback + text"
23,"SUPPRF30226",16,100,55,24,-16,74,71,31,"Pilot 8","Pilot 8: max feedback + text"
24,"SUPPRF30226",24,98,70,63,-1,24,71,7,"Pilot 8","Pilot 8: max feedback + text"
25,"SUPPRF30226",13,94,54,41,0,39,54,13,"Pilot 8","Pilot 8: max feedback + text"
26,"SUPPRF30226",20,100,80,67,0,71,80,13,"Pilot 8","Pilot 8: max feedback + text"
27,"SUPPRF30226",5,100,41,15,-13,44,54,26,"Pilot 8","Pilot 8: max feedback + text"
28,"SUPPRF30226",25,99,58,10,12,26,46,48,"Pilot 8","Pilot 8: max feedback + text"
29,"SUPPRF30226",0,100,29,-1,0,89,29,30,"Pilot 8","Pilot 8: max feedback + text"
30,"SUPPRF30226",1,100,50,36,-13,76,63,14,"Pilot 8","Pilot 8: max feedback + text"
31,"SUPPRF30226",2,100,20,7,0,26,20,13,"Pilot 8","Pilot 8: max feedback + text"
32,"SUPPRF30226",0,98,66,66,12,1,54,0,"Pilot 8","Pilot 8: max feedback + text"
33,"SUPPRF30226",0,97,62,55,-1,34,63,7,"Pilot 8","Pilot 8: max feedback + text"
34,"SUPPRF30226",0,99,19,12,-1,7,20,7,"Pilot 8","Pilot 8: max feedback + text"
35,"SUPPRF30226",0,98,16,12,-13,44,29,4,"Pilot 8","Pilot 8: max feedback + text"
36,"SUPPRF30226",0,98,56,56,-15,56,71,0,"Pilot 8","Pilot 8: max feedback + text"
37,"SUPPRF30226",1,99,63,54,0,29,63,9,"Pilot 8","Pilot 8: max feedback + text"
38,"SUPPRF30226",1,0,81,9,1,64,80,72,"Pilot 8","Pilot 8: max feedback + text"
39,"SUPPRF30226",3,97,49,49,12,55,37,0,"Pilot 8","Pilot 8: max feedback + text"
40,"SUPPRF30226",2,99,47,14,-16,43,63,33,"Pilot 8","Pilot 8: max feedback + text"
41,"SUPPRF30226",2,98,88,85,25,40,63,3,"Pilot 8","Pilot 8: max feedback + text"
42,"SUPPRF30226",1,100,75,56,29,70,46,19,"Pilot 8","Pilot 8: max feedback + text"
43,"SUPPRF30226",1,97,55,44,1,32,54,11,"Pilot 8","Pilot 8: max feedback + text"
44,"SUPPRF30226",1,100,67,57,-13,59,80,10,"Pilot 8","Pilot 8: max feedback + text"
45,"SUPPRF30226",0,98,37,-5,0,33,37,42,"Pilot 8","Pilot 8: max feedback + text"
46,"SUPPRF30226",2,100,24,-6,-13,26,37,30,"Pilot 8","Pilot 8: max feedback + text"
47,"SUPPRF30226",0,99,100,52,20,29,80,48,"Pilot 8","Pilot 8: max feedback + text"
48,"SUPPRF30226",0,98,45,5,-1,39,46,40,"Pilot 8","Pilot 8: max feedback + text"
1,"SUPPRF87860",50,49,20,-47,0,29,20,67,"Pilot 8","Pilot 8: max feedback + text"
2,"SUPPRF87860",48,50,62,0,-1,61,63,62,"Pilot 8","Pilot 8: max feedback + text"
3,"SUPPRF87860",49,53,67,7,-13,56,80,60,"Pilot 8","Pilot 8: max feedback + text"
4,"SUPPRF87860",48,49,33,-36,-13,36,46,69,"Pilot 8","Pilot 8: max feedback + text"
5,"SUPPRF87860",51,50,54,-18,0,61,54,72,"Pilot 8","Pilot 8: max feedback + text"
6,"SUPPRF87860",50,51,38,12,-16,45,54,26,"Pilot 8","Pilot 8: max feedback + text"
7,"SUPPRF87860",51,50,78,35,24,53,54,43,"Pilot 8","Pilot 8: max feedback + text"
8,"SUPPRF87860",50,52,8,-34,-12,50,20,42,"Pilot 8","Pilot 8: max feedback + text"
9,"SUPPRF87860",49,51,37,-13,0,51,37,50,"Pilot 8","Pilot 8: max feedback + text"
10,"SUPPRF87860",48,46,77,29,14,50,63,48,"Pilot 8","Pilot 8: max feedback + text"
11,"SUPPRF87860",50,49,94,42,23,60,71,52,"Pilot 8","Pilot 8: max feedback + text"
12,"SUPPRF87860",51,50,61,-6,24,69,37,67,"Pilot 8","Pilot 8: max feedback + text"
13,"SUPPRF87860",50,50,56,10,-15,52,71,46,"Pilot 8","Pilot 8: max feedback + text"
14,"SUPPRF87860",49,48,24,-6,-13,59,37,30,"Pilot 8","Pilot 8: max feedback + text"
15,"SUPPRF87860",49,52,6,-34,-14,24,20,40,"Pilot 8","Pilot 8: max feedback + text"
16,"SUPPRF87860",49,47,58,52,29,5,29,6,"Pilot 8","Pilot 8: max feedback + text"
17,"SUPPRF87860",53,45,49,38,12,44,37,11,"Pilot 8","Pilot 8: max feedback + text"
18,"SUPPRF87860",51,49,16,-5,-13,46,29,21,"Pilot 8","Pilot 8: max feedback + text"
19,"SUPPRF87860",54,44,83,32,12,51,71,51,"Pilot 8","Pilot 8: max feedback + text"
20,"SUPPRF87860",50,49,70,-7,-1,66,71,77,"Pilot 8","Pilot 8: max feedback + text"
21,"SUPPRF87860",50,51,46,12,17,50,29,34,"Pilot 8","Pilot 8: max feedback + text"
22,"SUPPRF87860",49,49,50,0,-13,48,63,50,"Pilot 8","Pilot 8: max feedback + text"
23,"SUPPRF87860",49,53,71,37,0,51,71,34,"Pilot 8","Pilot 8: max feedback + text"
24,"SUPPRF87860",51,51,68,41,-12,31,80,27,"Pilot 8","Pilot 8: max feedback + text"
25,"SUPPRF87860",51,52,19,-14,-1,57,20,33,"Pilot 8","Pilot 8: max feedback + text"
26,"SUPPRF87860",49,50,63,15,0,50,63,48,"Pilot 8","Pilot 8: max feedback + text"
27,"SUPPRF87860",49,50,96,83,16,52,80,13,"Pilot 8","Pilot 8: max feedback + text"
28,"SUPPRF87860",48,54,35,27,15,19,20,8,"Pilot 8","Pilot 8: max feedback + text"
29,"SUPPRF87860",48,49,46,-3,0,49,46,49,"Pilot 8","Pilot 8: max feedback + text"
30,"SUPPRF87860",50,50,41,11,-13,47,54,30,"Pilot 8","Pilot 8: max feedback + text"
31,"SUPPRF87860",49,50,45,-3,-1,47,46,48,"Pilot 8","Pilot 8: max feedback + text"
32,"SUPPRF87860",53,48,100,58,20,59,80,42,"Pilot 8","Pilot 8: max feedback + text"
33,"SUPPRF87860",50,46,47,41,27,32,20,6,"Pilot 8","Pilot 8: max feedback + text"
34,"SUPPRF87860",48,49,88,39,25,49,63,49,"Pilot 8","Pilot 8: max feedback + text"
35,"SUPPRF87860",50,51,81,23,1,72,80,58,"Pilot 8","Pilot 8: max feedback + text"
36,"SUPPRF87860",51,48,75,49,29,49,46,26,"Pilot 8","Pilot 8: max feedback + text"
37,"SUPPRF87860",50,50,22,-28,-15,51,37,50,"Pilot 8","Pilot 8: max feedback + text"
38,"SUPPRF87860",50,48,80,33,0,52,80,47,"Pilot 8","Pilot 8: max feedback + text"
39,"SUPPRF87860",50,49,47,26,-16,50,63,21,"Pilot 8","Pilot 8: max feedback + text"
40,"SUPPRF87860",48,50,66,16,12,49,54,50,"Pilot 8","Pilot 8: max feedback + text"
41,"SUPPRF87860",51,49,55,14,-16,46,71,41,"Pilot 8","Pilot 8: max feedback + text"
42,"SUPPRF87860",49,50,15,-18,-14,49,29,33,"Pilot 8","Pilot 8: max feedback + text"
43,"SUPPRF87860",48,49,38,38,1,99,37,0,"Pilot 8","Pilot 8: max feedback + text"
44,"SUPPRF87860",52,50,55,14,1,49,54,41,"Pilot 8","Pilot 8: max feedback + text"
45,"SUPPRF87860",50,51,58,9,12,50,46,49,"Pilot 8","Pilot 8: max feedback + text"
46,"SUPPRF87860",51,50,28,-3,-1,47,29,31,"Pilot 8","Pilot 8: max feedback + text"
47,"SUPPRF87860",50,50,29,-14,0,51,29,43,"Pilot 8","Pilot 8: max feedback + text"
48,"SUPPRF87860",51,48,34,7,-12,50,46,27,"Pilot 8","Pilot 8: max feedback + text"
1,"SUPPRF74630",100,9,62,47,-1,100,63,15,"Pilot 8","Pilot 8: max feedback + text"
2,"SUPPRF74630",0,40,19,9,-1,43,20,10,"Pilot 8","Pilot 8: max feedback + text"
3,"SUPPRF74630",100,0,55,55,-16,0,71,0,"Pilot 8","Pilot 8: max feedback + text"
4,"SUPPRF74630",0,100,50,-12,-13,0,63,62,"Pilot 8","Pilot 8: max feedback + text"
5,"SUPPRF74630",14,93,28,28,-1,100,29,0,"Pilot 8","Pilot 8: max feedback + text"
6,"SUPPRF74630",60,24,46,40,0,0,46,6,"Pilot 8","Pilot 8: max feedback + text"
7,"SUPPRF74630",0,99,35,-14,15,27,20,49,"Pilot 8","Pilot 8: max feedback + text"
8,"SUPPRF74630",0,100,37,-17,0,0,37,54,"Pilot 8","Pilot 8: max feedback + text"
9,"SUPPRF74630",76,62,46,31,17,9,29,15,"Pilot 8","Pilot 8: max feedback + text"
10,"SUPPRF74630",100,0,100,38,20,100,80,62,"Pilot 8","Pilot 8: max feedback + text"
11,"SUPPRF74630",100,0,78,30,24,58,54,48,"Pilot 8","Pilot 8: max feedback + text"
12,"SUPPRF74630",0,95,29,-6,0,77,29,35,"Pilot 8","Pilot 8: max feedback + text"
13,"SUPPRF74630",100,0,96,71,16,39,80,25,"Pilot 8","Pilot 8: max feedback + text"
14,"SUPPRF74630",44,61,67,23,-13,35,80,44,"Pilot 8","Pilot 8: max feedback + text"
15,"SUPPRF74630",90,0,83,53,12,74,71,30,"Pilot 8","Pilot 8: max feedback + text"
16,"SUPPRF74630",0,100,24,-2,-13,100,37,26,"Pilot 8","Pilot 8: max feedback + text"
17,"SUPPRF74630",100,0,54,14,0,93,54,40,"Pilot 8","Pilot 8: max feedback + text"
18,"SUPPRF74630",0,0,22,22,-15,12,37,0,"Pilot 8","Pilot 8: max feedback + text"
19,"SUPPRF74630",88,99,45,9,-1,100,46,36,"Pilot 8","Pilot 8: max feedback + text"
20,"SUPPRF74630",100,2,94,94,23,100,71,0,"Pilot 8","Pilot 8: max feedback + text"
21,"SUPPRF74630",94,0,81,81,1,100,80,0,"Pilot 8","Pilot 8: max feedback + text"
22,"SUPPRF74630",100,62,41,3,-13,0,54,38,"Pilot 8","Pilot 8: max feedback + text"
23,"SUPPRF74630",0,100,8,-10,-12,0,20,18,"Pilot 8","Pilot 8: max feedback + text"
24,"SUPPRF74630",87,100,77,45,14,0,63,32,"Pilot 8","Pilot 8: max feedback + text"
25,"SUPPRF74630",75,0,71,43,0,0,71,28,"Pilot 8","Pilot 8: max feedback + text"
26,"SUPPRF74630",0,100,16,-69,-13,59,29,85,"Pilot 8","Pilot 8: max feedback + text"
27,"SUPPRF74630",0,100,15,15,-14,100,29,0,"Pilot 8","Pilot 8: max feedback + text"
28,"SUPPRF74630",100,53,80,30,0,81,80,50,"Pilot 8","Pilot 8: max feedback + text"
29,"SUPPRF74630",100,9,47,47,-16,100,63,0,"Pilot 8","Pilot 8: max feedback + text"
30,"SUPPRF74630",100,0,49,12,12,46,37,37,"Pilot 8","Pilot 8: max feedback + text"
31,"SUPPRF74630",100,0,61,13,24,0,37,48,"Pilot 8","Pilot 8: max feedback + text"
32,"SUPPRF74630",68,0,34,-2,-12,0,46,36,"Pilot 8","Pilot 8: max feedback + text"
33,"SUPPRF74630",99,0,68,38,-12,26,80,30,"Pilot 8","Pilot 8: max feedback + text"
34,"SUPPRF74630",100,0,38,-4,1,15,37,42,"Pilot 8","Pilot 8: max feedback + text"
35,"SUPPRF74630",100,0,55,54,1,0,54,1,"Pilot 8","Pilot 8: max feedback + text"
36,"SUPPRF74630",100,0,88,58,25,61,63,30,"Pilot 8","Pilot 8: max feedback + text"
37,"SUPPRF74630",71,0,47,-10,27,0,20,57,"Pilot 8","Pilot 8: max feedback + text"
38,"SUPPRF74630",100,0,66,64,12,0,54,2,"Pilot 8","Pilot 8: max feedback + text"
39,"SUPPRF74630",100,2,70,45,-1,0,71,25,"Pilot 8","Pilot 8: max feedback + text"
40,"SUPPRF74630",100,0,63,23,0,0,63,40,"Pilot 8","Pilot 8: max feedback + text"
41,"SUPPRF74630",100,1,58,6,12,100,46,52,"Pilot 8","Pilot 8: max feedback + text"
42,"SUPPRF74630",80,0,58,23,29,0,29,35,"Pilot 8","Pilot 8: max feedback + text"
43,"SUPPRF74630",0,0,20,3,0,0,20,17,"Pilot 8","Pilot 8: max feedback + text"
44,"SUPPRF74630",0,0,6,-19,-14,0,20,25,"Pilot 8","Pilot 8: max feedback + text"
45,"SUPPRF74630",100,0,38,38,-16,100,54,0,"Pilot 8","Pilot 8: max feedback + text"
46,"SUPPRF74630",94,0,33,24,-13,0,46,9,"Pilot 8","Pilot 8: max feedback + text"
47,"SUPPRF74630",100,0,75,70,29,0,46,5,"Pilot 8","Pilot 8: max feedback + text"
48,"SUPPRF74630",100,0,56,52,-15,100,71,4,"Pilot 8","Pilot 8: max feedback + text"
1,"SUPPRF80658",54,24,6,-14,-14,56,20,20,"Pilot 8","Pilot 8: max feedback + text"
2,"SUPPRF80658",70,23,96,26,16,67,80,70,"Pilot 8","Pilot 8: max feedback + text"
3,"SUPPRF80658",76,22,58,39,29,84,29,19,"Pilot 8","Pilot 8: max feedback + text"
4,"SUPPRF80658",76,14,94,33,23,79,71,61,"Pilot 8","Pilot 8: max feedback + text"
5,"SUPPRF80658",66,16,15,-23,-14,74,29,38,"Pilot 8","Pilot 8: max feedback + text"
6,"SUPPRF80658",81,15,80,56,0,75,80,24,"Pilot 8","Pilot 8: max feedback + text"
7,"SUPPRF80658",74,17,68,-12,-12,81,80,80,"Pilot 8","Pilot 8: max feedback + text"
8,"SUPPRF80658",63,15,35,-22,15,57,20,57,"Pilot 8","Pilot 8: max feedback + text"
9,"SUPPRF80658",75,20,47,20,-16,35,63,27,"Pilot 8","Pilot 8: max feedback + text"
10,"SUPPRF80658",73,17,29,18,0,43,29,11,"Pilot 8","Pilot 8: max feedback + text"
11,"SUPPRF80658",83,17,49,-5,12,11,37,54,"Pilot 8","Pilot 8: max feedback + text"
12,"SUPPRF80658",59,16,8,-68,-12,56,20,76,"Pilot 8","Pilot 8: max feedback + text"
13,"SUPPRF80658",55,18,38,2,1,32,37,36,"Pilot 8","Pilot 8: max feedback + text"
14,"SUPPRF80658",58,19,34,13,-12,18,46,21,"Pilot 8","Pilot 8: max feedback + text"
15,"SUPPRF80658",62,20,61,38,24,29,37,23,"Pilot 8","Pilot 8: max feedback + text"
16,"SUPPRF80658",74,21,62,17,-1,43,63,45,"Pilot 8","Pilot 8: max feedback + text"
17,"SUPPRF80658",73,21,41,0,-13,32,54,41,"Pilot 8","Pilot 8: max feedback + text"
18,"SUPPRF80658",72,19,46,24,17,20,29,22,"Pilot 8","Pilot 8: max feedback + text"
19,"SUPPRF80658",70,22,77,49,14,29,63,28,"Pilot 8","Pilot 8: max feedback + text"
20,"SUPPRF80658",65,25,67,22,-13,38,80,45,"Pilot 8","Pilot 8: max feedback + text"
21,"SUPPRF80658",59,26,38,4,-16,28,54,34,"Pilot 8","Pilot 8: max feedback + text"
22,"SUPPRF80658",68,26,100,31,20,64,80,69,"Pilot 8","Pilot 8: max feedback + text"
23,"SUPPRF80658",68,25,56,47,-15,12,71,9,"Pilot 8","Pilot 8: max feedback + text"
24,"SUPPRF80658",74,21,58,12,12,25,46,46,"Pilot 8","Pilot 8: max feedback + text"
25,"SUPPRF80658",63,31,66,29,12,23,54,37,"Pilot 8","Pilot 8: max feedback + text"
26,"SUPPRF80658",62,24,55,-4,-16,48,71,59,"Pilot 8","Pilot 8: max feedback + text"
27,"SUPPRF80658",66,22,33,11,-13,31,46,22,"Pilot 8","Pilot 8: max feedback + text"
28,"SUPPRF80658",53,30,16,-33,-13,31,29,49,"Pilot 8","Pilot 8: max feedback + text"
29,"SUPPRF80658",56,53,37,7,0,31,37,30,"Pilot 8","Pilot 8: max feedback + text"
30,"SUPPRF80658",56,37,55,20,1,34,54,35,"Pilot 8","Pilot 8: max feedback + text"
31,"SUPPRF80658",59,33,45,16,-1,45,46,29,"Pilot 8","Pilot 8: max feedback + text"
32,"SUPPRF80658",63,33,28,3,-1,70,29,25,"Pilot 8","Pilot 8: max feedback + text"
33,"SUPPRF80658",61,34,47,14,27,33,20,33,"Pilot 8","Pilot 8: max feedback + text"
34,"SUPPRF80658",59,34,63,-10,0,47,63,73,"Pilot 8","Pilot 8: max feedback + text"
35,"SUPPRF80658",64,31,75,18,29,49,46,57,"Pilot 8","Pilot 8: max feedback + text"
36,"SUPPRF80658",65,30,54,26,0,36,54,28,"Pilot 8","Pilot 8: max feedback + text"
37,"SUPPRF80658",63,27,71,31,0,34,71,40,"Pilot 8","Pilot 8: max feedback + text"
38,"SUPPRF80658",65,26,50,-14,-13,55,63,64,"Pilot 8","Pilot 8: max feedback + text"
39,"SUPPRF80658",64,40,83,48,12,26,71,35,"Pilot 8","Pilot 8: max feedback + text"
40,"SUPPRF80658",71,33,24,-15,-13,38,37,39,"Pilot 8","Pilot 8: max feedback + text"
41,"SUPPRF80658",66,27,46,-1,0,47,46,47,"Pilot 8","Pilot 8: max feedback + text"
42,"SUPPRF80658",58,35,88,37,25,32,63,51,"Pilot 8","Pilot 8: max feedback + text"
43,"SUPPRF80658",59,31,20,1,0,19,20,19,"Pilot 8","Pilot 8: max feedback + text"
44,"SUPPRF80658",54,33,22,-23,-15,26,37,45,"Pilot 8","Pilot 8: max feedback + text"
45,"SUPPRF80658",56,30,19,0,-1,62,20,19,"Pilot 8","Pilot 8: max feedback + text"
46,"SUPPRF80658",58,34,81,21,1,39,80,60,"Pilot 8","Pilot 8: max feedback + text"
47,"SUPPRF80658",61,34,78,32,24,26,54,46,"Pilot 8","Pilot 8: max feedback + text"
48,"SUPPRF80658",65,32,70,24,-1,39,71,46,"Pilot 8","Pilot 8: max feedback + text"
1,"SUPPRF03421",63,0,49,9,12,82,37,40,"Pilot 8","Pilot 8: max feedback + text"
2,"SUPPRF03421",59,2,58,9,12,67,46,49,"Pilot 8","Pilot 8: max feedback + text"
3,"SUPPRF03421",47,1,55,2,1,34,54,53,"Pilot 8","Pilot 8: max feedback + text"
4,"SUPPRF03421",65,1,71,8,0,44,71,63,"Pilot 8","Pilot 8: max feedback + text"
5,"SUPPRF03421",53,1,83,11,12,51,71,72,"Pilot 8","Pilot 8: max feedback + text"
6,"SUPPRF03421",46,1,67,-4,-13,24,80,71,"Pilot 8","Pilot 8: max feedback + text"
7,"SUPPRF03421",13,1,6,-27,-14,54,20,33,"Pilot 8","Pilot 8: max feedback + text"
8,"SUPPRF03421",38,1,20,3,0,76,20,17,"Pilot 8","Pilot 8: max feedback + text"
9,"SUPPRF03421",52,1,35,23,15,64,20,12,"Pilot 8","Pilot 8: max feedback + text"
10,"SUPPRF03421",56,1,54,18,0,61,54,36,"Pilot 8","Pilot 8: max feedback + text"
11,"SUPPRF03421",81,2,88,62,25,62,63,26,"Pilot 8","Pilot 8: max feedback + text"
12,"SUPPRF03421",35,3,15,-17,-14,62,29,32,"Pilot 8","Pilot 8: max feedback + text"
13,"SUPPRF03421",78,1,34,-9,-12,81,46,43,"Pilot 8","Pilot 8: max feedback + text"
14,"SUPPRF03421",49,0,33,-3,-13,50,46,36,"Pilot 8","Pilot 8: max feedback + text"
15,"SUPPRF03421",34,3,55,-16,-16,70,71,71,"Pilot 8","Pilot 8: max feedback + text"
16,"SUPPRF03421",49,8,38,3,1,32,37,35,"Pilot 8","Pilot 8: max feedback + text"
17,"SUPPRF03421",27,1,16,-19,-13,77,29,35,"Pilot 8","Pilot 8: max feedback + text"
18,"SUPPRF03421",98,1,100,28,20,70,80,72,"Pilot 8","Pilot 8: max feedback + text"
19,"SUPPRF03421",51,0,66,18,12,43,54,48,"Pilot 8","Pilot 8: max feedback + text"
20,"SUPPRF03421",55,1,19,4,-1,93,20,15,"Pilot 8","Pilot 8: max feedback + text"
21,"SUPPRF03421",50,1,45,21,-1,28,46,24,"Pilot 8","Pilot 8: max feedback + text"
22,"SUPPRF03421",61,3,46,-6,0,87,46,52,"Pilot 8","Pilot 8: max feedback + text"
23,"SUPPRF03421",50,1,70,15,-1,63,71,55,"Pilot 8","Pilot 8: max feedback + text"
24,"SUPPRF03421",52,1,29,4,0,92,29,25,"Pilot 8","Pilot 8: max feedback + text"
25,"SUPPRF03421",65,0,77,24,14,78,63,53,"Pilot 8","Pilot 8: max feedback + text"
26,"SUPPRF03421",53,2,61,25,24,85,37,36,"Pilot 8","Pilot 8: max feedback + text"
27,"SUPPRF03421",88,52,75,42,29,14,46,33,"Pilot 8","Pilot 8: max feedback + text"
28,"SUPPRF03421",51,0,47,-10,-16,81,63,57,"Pilot 8","Pilot 8: max feedback + text"
29,"SUPPRF03421",68,2,80,4,0,88,80,76,"Pilot 8","Pilot 8: max feedback + text"
30,"SUPPRF03421",72,2,58,37,29,94,29,21,"Pilot 8","Pilot 8: max feedback + text"
31,"SUPPRF03421",35,0,28,-10,-1,44,29,38,"Pilot 8","Pilot 8: max feedback + text"
32,"SUPPRF03421",50,2,38,-14,-16,58,54,52,"Pilot 8","Pilot 8: max feedback + text"
33,"SUPPRF03421",73,1,46,28,17,68,29,18,"Pilot 8","Pilot 8: max feedback + text"
34,"SUPPRF03421",43,3,56,-12,-15,64,71,68,"Pilot 8","Pilot 8: max feedback + text"
35,"SUPPRF03421",64,2,50,-2,-13,64,63,52,"Pilot 8","Pilot 8: max feedback + text"
36,"SUPPRF03421",8,0,22,-25,-15,73,37,47,"Pilot 8","Pilot 8: max feedback + text"
37,"SUPPRF03421",52,0,63,-20,0,26,63,83,"Pilot 8","Pilot 8: max feedback + text"
38,"SUPPRF03421",17,2,8,-20,-12,85,20,28,"Pilot 8","Pilot 8: max feedback + text"
39,"SUPPRF03421",35,6,37,15,0,83,37,22,"Pilot 8","Pilot 8: max feedback + text"
40,"SUPPRF03421",46,1,78,40,24,59,54,38,"Pilot 8","Pilot 8: max feedback + text"
41,"SUPPRF03421",35,1,24,-8,-13,70,37,32,"Pilot 8","Pilot 8: max feedback + text"
42,"SUPPRF03421",42,4,81,17,1,78,80,64,"Pilot 8","Pilot 8: max feedback + text"
43,"SUPPRF03421",39,4,94,20,23,58,71,74,"Pilot 8","Pilot 8: max feedback + text"
44,"SUPPRF03421",39,0,41,-19,-13,69,54,60,"Pilot 8","Pilot 8: max feedback + text"
45,"SUPPRF03421",28,3,68,32,-12,73,80,36,"Pilot 8","Pilot 8: max feedback + text"
46,"SUPPRF03421",49,3,62,-2,-1,82,63,64,"Pilot 8","Pilot 8: max feedback + text"
47,"SUPPRF03421",52,3,47,32,27,87,20,15,"Pilot 8","Pilot 8: max feedback + text"
48,"SUPPRF03421",58,0,96,21,16,78,80,75,"Pilot 8","Pilot 8: max feedback + text"
1,"SUPPRF97320",78,5,35,14,15,49,20,21,"Pilot 8","Pilot 8: max feedback + text"
2,"SUPPRF97320",90,5,83,8,12,60,71,75,"Pilot 8","Pilot 8: max feedback + text"
3,"SUPPRF97320",89,6,16,-13,-13,76,29,29,"Pilot 8","Pilot 8: max feedback + text"
4,"SUPPRF97320",94,4,70,-13,-1,67,71,83,"Pilot 8","Pilot 8: max feedback + text"
5,"SUPPRF97320",97,3,58,44,29,61,29,14,"Pilot 8","Pilot 8: max feedback + text"
6,"SUPPRF97320",98,2,45,-3,-1,41,46,48,"Pilot 8","Pilot 8: max feedback + text"
7,"SUPPRF97320",97,3,28,-20,-1,0,29,48,"Pilot 8","Pilot 8: max feedback + text"
8,"SUPPRF97320",91,1,55,-7,-16,41,71,62,"Pilot 8","Pilot 8: max feedback + text"
9,"SUPPRF97320",96,2,81,3,1,76,80,78,"Pilot 8","Pilot 8: max feedback + text"
10,"SUPPRF97320",98,2,41,-23,-13,5,54,64,"Pilot 8","Pilot 8: max feedback + text"
11,"SUPPRF97320",97,4,34,5,-12,52,46,29,"Pilot 8","Pilot 8: max feedback + text"
12,"SUPPRF97320",100,1,100,11,20,89,80,89,"Pilot 8","Pilot 8: max feedback + text"
13,"SUPPRF97320",95,4,75,23,29,39,46,52,"Pilot 8","Pilot 8: max feedback + text"
14,"SUPPRF97320",99,0,94,67,23,18,71,27,"Pilot 8","Pilot 8: max feedback + text"
15,"SUPPRF97320",98,1,78,24,24,91,54,54,"Pilot 8","Pilot 8: max feedback + text"
16,"SUPPRF97320",93,3,24,-42,-13,47,37,66,"Pilot 8","Pilot 8: max feedback + text"
17,"SUPPRF97320",97,4,37,2,0,93,37,35,"Pilot 8","Pilot 8: max feedback + text"
18,"SUPPRF97320",98,3,29,-10,0,72,29,39,"Pilot 8","Pilot 8: max feedback + text"
19,"SUPPRF97320",98,1,50,-21,-13,70,63,71,"Pilot 8","Pilot 8: max feedback + text"
20,"SUPPRF97320",97,2,77,22,14,87,63,55,"Pilot 8","Pilot 8: max feedback + text"
21,"SUPPRF97320",93,1,71,12,0,25,71,59,"Pilot 8","Pilot 8: max feedback + text"
22,"SUPPRF97320",97,3,63,-5,0,32,63,68,"Pilot 8","Pilot 8: max feedback + text"
23,"SUPPRF97320",98,2,46,-7,0,66,46,53,"Pilot 8","Pilot 8: max feedback + text"
24,"SUPPRF97320",98,0,49,-13,12,9,37,62,"Pilot 8","Pilot 8: max feedback + text"
25,"SUPPRF97320",100,2,46,0,17,51,29,46,"Pilot 8","Pilot 8: max feedback + text"
26,"SUPPRF97320",95,4,20,-52,0,29,20,72,"Pilot 8","Pilot 8: max feedback + text"
27,"SUPPRF97320",97,2,66,12,12,82,54,54,"Pilot 8","Pilot 8: max feedback + text"
28,"SUPPRF97320",98,3,88,15,25,38,63,73,"Pilot 8","Pilot 8: max feedback + text"
29,"SUPPRF97320",98,4,38,-32,1,13,37,70,"Pilot 8","Pilot 8: max feedback + text"
30,"SUPPRF97320",98,1,80,-4,0,88,80,84,"Pilot 8","Pilot 8: max feedback + text"
31,"SUPPRF97320",99,1,54,2,0,86,54,52,"Pilot 8","Pilot 8: max feedback + text"
32,"SUPPRF97320",99,3,19,-26,-1,8,20,45,"Pilot 8","Pilot 8: max feedback + text"
33,"SUPPRF97320",99,2,15,-12,-14,65,29,27,"Pilot 8","Pilot 8: max feedback + text"
34,"SUPPRF97320",99,1,96,42,16,14,80,54,"Pilot 8","Pilot 8: max feedback + text"
35,"SUPPRF97320",98,1,58,33,12,73,46,25,"Pilot 8","Pilot 8: max feedback + text"
36,"SUPPRF97320",96,2,8,-17,-12,18,20,25,"Pilot 8","Pilot 8: max feedback + text"
37,"SUPPRF97320",98,1,67,-20,-13,11,80,87,"Pilot 8","Pilot 8: max feedback + text"
38,"SUPPRF97320",100,1,62,29,-1,21,63,33,"Pilot 8","Pilot 8: max feedback + text"
39,"SUPPRF97320",86,4,38,-48,-16,32,54,86,"Pilot 8","Pilot 8: max feedback + text"
40,"SUPPRF97320",89,4,55,8,1,77,54,47,"Pilot 8","Pilot 8: max feedback + text"
41,"SUPPRF97320",92,8,33,-12,-13,85,46,45,"Pilot 8","Pilot 8: max feedback + text"
42,"SUPPRF97320",93,7,56,21,-15,10,71,35,"Pilot 8","Pilot 8: max feedback + text"
43,"SUPPRF97320",96,4,61,-3,24,12,37,64,"Pilot 8","Pilot 8: max feedback + text"
44,"SUPPRF97320",95,5,47,-14,27,33,20,61,"Pilot 8","Pilot 8: max feedback + text"
45,"SUPPRF97320",92,2,68,5,-12,11,80,63,"Pilot 8","Pilot 8: max feedback + text"
46,"SUPPRF97320",99,3,22,-52,-15,15,37,74,"Pilot 8","Pilot 8: max feedback + text"
47,"SUPPRF97320",93,1,47,-15,-16,89,63,62,"Pilot 8","Pilot 8: max feedback + text"
48,"SUPPRF97320",96,1,6,-14,-14,84,20,20,"Pilot 8","Pilot 8: max feedback + text"
1,"SUPPRF88012",36,35,66,43,12,3,54,23,"Pilot 8","Pilot 8: max feedback + text"
2,"SUPPRF88012",38,38,46,13,0,1,46,33,"Pilot 8","Pilot 8: max feedback + text"
3,"SUPPRF88012",37,38,77,30,14,1,63,47,"Pilot 8","Pilot 8: max feedback + text"
4,"SUPPRF88012",36,35,56,-7,-15,2,71,63,"Pilot 8","Pilot 8: max feedback + text"
5,"SUPPRF88012",35,33,24,-5,-13,2,37,29,"Pilot 8","Pilot 8: max feedback + text"
6,"SUPPRF88012",31,34,78,36,24,2,54,42,"Pilot 8","Pilot 8: max feedback + text"
7,"SUPPRF88012",38,33,96,45,16,1,80,51,"Pilot 8","Pilot 8: max feedback + text"
8,"SUPPRF88012",34,35,33,-6,-13,1,46,39,"Pilot 8","Pilot 8: max feedback + text"
9,"SUPPRF88012",36,35,68,26,-12,43,80,42,"Pilot 8","Pilot 8: max feedback + text"
10,"SUPPRF88012",38,37,50,11,-13,47,63,39,"Pilot 8","Pilot 8: max feedback + text"
11,"SUPPRF88012",37,34,61,21,24,36,37,40,"Pilot 8","Pilot 8: max feedback + text"
12,"SUPPRF88012",37,38,49,10,12,36,37,39,"Pilot 8","Pilot 8: max feedback + text"
13,"SUPPRF88012",35,32,58,23,12,31,46,35,"Pilot 8","Pilot 8: max feedback + text"
14,"SUPPRF88012",35,26,15,-16,-14,28,29,31,"Pilot 8","Pilot 8: max feedback + text"
15,"SUPPRF88012",26,28,81,57,1,20,80,24,"Pilot 8","Pilot 8: max feedback + text"
16,"SUPPRF88012",30,29,62,28,-1,31,63,34,"Pilot 8","Pilot 8: max feedback + text"
17,"SUPPRF88012",27,22,55,29,-16,25,71,26,"Pilot 8","Pilot 8: max feedback + text"
18,"SUPPRF88012",28,26,70,35,-1,25,71,35,"Pilot 8","Pilot 8: max feedback + text"
19,"SUPPRF88012",27,27,55,31,1,23,54,24,"Pilot 8","Pilot 8: max feedback + text"
20,"SUPPRF88012",28,26,6,-10,-14,21,20,16,"Pilot 8","Pilot 8: max feedback + text"
21,"SUPPRF88012",39,34,54,14,0,3,54,40,"Pilot 8","Pilot 8: max feedback + text"
22,"SUPPRF88012",30,30,22,-10,-15,2,37,32,"Pilot 8","Pilot 8: max feedback + text"
23,"SUPPRF88012",32,27,100,98,20,2,80,2,"Pilot 8","Pilot 8: max feedback + text"
24,"SUPPRF88012",28,28,37,8,0,2,37,29,"Pilot 8","Pilot 8: max feedback + text"
25,"SUPPRF88012",29,29,29,3,0,20,29,26,"Pilot 8","Pilot 8: max feedback + text"
26,"SUPPRF88012",29,39,46,20,17,26,29,26,"Pilot 8","Pilot 8: max feedback + text"
27,"SUPPRF88012",79,71,8,-35,-12,45,20,43,"Pilot 8","Pilot 8: max feedback + text"
28,"SUPPRF88012",47,49,83,38,12,45,71,45,"Pilot 8","Pilot 8: max feedback + text"
29,"SUPPRF88012",45,45,75,29,29,47,46,46,"Pilot 8","Pilot 8: max feedback + text"
30,"SUPPRF88012",47,45,45,9,-1,46,46,36,"Pilot 8","Pilot 8: max feedback + text"
31,"SUPPRF88012",49,48,35,-14,15,45,20,49,"Pilot 8","Pilot 8: max feedback + text"
32,"SUPPRF88012",46,47,20,9,0,9,20,11,"Pilot 8","Pilot 8: max feedback + text"
33,"SUPPRF88012",47,49,38,-9,1,48,37,47,"Pilot 8","Pilot 8: max feedback + text"
34,"SUPPRF88012",46,46,47,11,-16,48,63,36,"Pilot 8","Pilot 8: max feedback + text"
35,"SUPPRF88012",45,47,47,-4,27,1,20,51,"Pilot 8","Pilot 8: max feedback + text"
36,"SUPPRF88012",49,46,34,11,-12,0,46,23,"Pilot 8","Pilot 8: max feedback + text"
37,"SUPPRF88012",51,49,80,-19,0,99,80,99,"Pilot 8","Pilot 8: max feedback + text"
38,"SUPPRF88012",48,48,41,-7,-13,47,54,48,"Pilot 8","Pilot 8: max feedback + text"
39,"SUPPRF88012",49,46,67,-14,-13,52,80,81,"Pilot 8","Pilot 8: max feedback + text"
40,"SUPPRF88012",48,49,19,12,-1,9,20,7,"Pilot 8","Pilot 8: max feedback + text"
41,"SUPPRF88012",49,48,58,8,29,50,29,50,"Pilot 8","Pilot 8: max feedback + text"
42,"SUPPRF88012",48,47,88,40,25,48,63,48,"Pilot 8","Pilot 8: max feedback + text"
43,"SUPPRF88012",50,50,63,13,0,47,63,50,"Pilot 8","Pilot 8: max feedback + text"
44,"SUPPRF88012",50,51,38,5,-16,36,54,33,"Pilot 8","Pilot 8: max feedback + text"
45,"SUPPRF88012",49,46,28,18,-1,14,29,10,"Pilot 8","Pilot 8: max feedback + text"
46,"SUPPRF88012",29,49,16,-7,-13,21,29,23,"Pilot 8","Pilot 8: max feedback + text"
47,"SUPPRF88012",49,51,94,47,23,49,71,47,"Pilot 8","Pilot 8: max feedback + text"
48,"SUPPRF88012",49,49,71,23,0,48,71,48,"Pilot 8","Pilot 8: max feedback + text"
1,"SUPPRF01236",93,0,45,-2,-1,89,46,47,"Pilot 8","Pilot 8: max feedback + text"
2,"SUPPRF01236",92,0,50,2,-13,50,63,48,"Pilot 8","Pilot 8: max feedback + text"
3,"SUPPRF01236",96,1,68,-6,-12,73,80,74,"Pilot 8","Pilot 8: max feedback + text"
4,"SUPPRF01236",93,0,15,-61,-14,16,29,76,"Pilot 8","Pilot 8: max feedback + text"
5,"SUPPRF01236",89,0,24,18,-13,98,37,6,"Pilot 8","Pilot 8: max feedback + text"
6,"SUPPRF01236",74,4,41,-11,-13,59,54,52,"Pilot 8","Pilot 8: max feedback + text"
7,"SUPPRF01236",98,0,46,0,0,47,46,46,"Pilot 8","Pilot 8: max feedback + text"
8,"SUPPRF01236",81,0,78,29,24,48,54,49,"Pilot 8","Pilot 8: max feedback + text"
9,"SUPPRF01236",97,0,94,43,23,48,71,51,"Pilot 8","Pilot 8: max feedback + text"
10,"SUPPRF01236",86,1,16,-33,-13,48,29,49,"Pilot 8","Pilot 8: max feedback + text"
11,"SUPPRF01236",85,4,77,26,14,49,63,51,"Pilot 8","Pilot 8: max feedback + text"
12,"SUPPRF01236",73,0,70,18,-1,36,71,52,"Pilot 8","Pilot 8: max feedback + text"
13,"SUPPRF01236",91,0,47,47,27,100,20,0,"Pilot 8","Pilot 8: max feedback + text"
14,"SUPPRF01236",88,0,33,-32,-13,50,46,65,"Pilot 8","Pilot 8: max feedback + text"
15,"SUPPRF01236",48,47,37,-14,0,48,37,51,"Pilot 8","Pilot 8: max feedback + text"
16,"SUPPRF01236",71,6,56,11,-15,49,71,45,"Pilot 8","Pilot 8: max feedback + text"
17,"SUPPRF01236",49,41,19,-32,-1,48,20,51,"Pilot 8","Pilot 8: max feedback + text"
18,"SUPPRF01236",22,25,61,13,24,51,37,48,"Pilot 8","Pilot 8: max feedback + text"
19,"SUPPRF01236",0,38,100,55,20,49,80,45,"Pilot 8","Pilot 8: max feedback + text"
20,"SUPPRF01236",0,31,75,32,29,47,46,43,"Pilot 8","Pilot 8: max feedback + text"
21,"SUPPRF01236",2,25,80,31,0,48,80,49,"Pilot 8","Pilot 8: max feedback + text"
22,"SUPPRF01236",2,42,6,-40,-14,49,20,46,"Pilot 8","Pilot 8: max feedback + text"
23,"SUPPRF01236",4,44,49,2,12,41,37,47,"Pilot 8","Pilot 8: max feedback + text"
24,"SUPPRF01236",14,43,22,-24,-15,49,37,46,"Pilot 8","Pilot 8: max feedback + text"
25,"SUPPRF01236",6,44,54,10,0,38,54,44,"Pilot 8","Pilot 8: max feedback + text"
26,"SUPPRF01236",9,22,28,-14,-1,47,29,42,"Pilot 8","Pilot 8: max feedback + text"
27,"SUPPRF01236",16,25,67,19,-13,44,80,48,"Pilot 8","Pilot 8: max feedback + text"
28,"SUPPRF01236",19,10,8,-36,-12,47,20,44,"Pilot 8","Pilot 8: max feedback + text"
29,"SUPPRF01236",8,7,55,7,1,47,54,48,"Pilot 8","Pilot 8: max feedback + text"
30,"SUPPRF01236",7,8,38,-8,-16,45,54,46,"Pilot 8","Pilot 8: max feedback + text"
31,"SUPPRF01236",11,34,47,-1,-16,46,63,48,"Pilot 8","Pilot 8: max feedback + text"
32,"SUPPRF01236",7,10,58,19,29,48,29,39,"Pilot 8","Pilot 8: max feedback + text"
33,"SUPPRF01236",25,38,58,5,12,31,46,53,"Pilot 8","Pilot 8: max feedback + text"
34,"SUPPRF01236",10,20,46,0,17,41,29,46,"Pilot 8","Pilot 8: max feedback + text"
35,"SUPPRF01236",12,5,62,12,-1,45,63,50,"Pilot 8","Pilot 8: max feedback + text"
36,"SUPPRF01236",12,8,88,42,25,45,63,46,"Pilot 8","Pilot 8: max feedback + text"
37,"SUPPRF01236",16,6,71,20,0,45,71,51,"Pilot 8","Pilot 8: max feedback + text"
38,"SUPPRF01236",11,25,81,32,1,48,80,49,"Pilot 8","Pilot 8: max feedback + text"
39,"SUPPRF01236",44,45,29,-13,0,47,29,42,"Pilot 8","Pilot 8: max feedback + text"
40,"SUPPRF01236",25,33,34,-16,-12,45,46,50,"Pilot 8","Pilot 8: max feedback + text"
41,"SUPPRF01236",10,2,66,22,12,45,54,44,"Pilot 8","Pilot 8: max feedback + text"
42,"SUPPRF01236",2,8,38,-10,1,45,37,48,"Pilot 8","Pilot 8: max feedback + text"
43,"SUPPRF01236",10,11,55,11,-16,43,71,44,"Pilot 8","Pilot 8: max feedback + text"
44,"SUPPRF01236",31,34,20,-26,0,45,20,46,"Pilot 8","Pilot 8: max feedback + text"
45,"SUPPRF01236",30,16,96,59,16,49,80,37,"Pilot 8","Pilot 8: max feedback + text"
46,"SUPPRF01236",44,45,35,-14,15,44,20,49,"Pilot 8","Pilot 8: max feedback + text"
47,"SUPPRF01236",47,45,63,22,0,46,63,41,"Pilot 8","Pilot 8: max feedback + text"
48,"SUPPRF01236",38,30,83,38,12,49,71,45,"Pilot 8","Pilot 8: max feedback + text"
1,"SUPPRF25745",96,2,29,-5,0,43,29,34,"Pilot 8","Pilot 8: max feedback + text"
2,"SUPPRF25745",98,2,54,-3,0,53,54,57,"Pilot 8","Pilot 8: max feedback + text"
3,"SUPPRF25745",98,1,61,26,24,52,37,35,"Pilot 8","Pilot 8: max feedback + text"
4,"SUPPRF25745",98,1,34,4,-12,58,46,30,"Pilot 8","Pilot 8: max feedback + text"
5,"SUPPRF25745",99,1,22,-40,-15,41,37,62,"Pilot 8","Pilot 8: max feedback + text"
6,"SUPPRF25745",99,0,28,-2,-1,75,29,30,"Pilot 8","Pilot 8: max feedback + text"
7,"SUPPRF25745",98,0,81,10,1,78,80,71,"Pilot 8","Pilot 8: max feedback + text"
8,"SUPPRF25745",99,1,46,-5,0,57,46,51,"Pilot 8","Pilot 8: max feedback + text"
9,"SUPPRF25745",99,1,8,-16,-12,78,20,24,"Pilot 8","Pilot 8: max feedback + text"
10,"SUPPRF25745",100,0,45,-4,-1,64,46,49,"Pilot 8","Pilot 8: max feedback + text"
11,"SUPPRF25745",98,2,63,-2,0,78,63,65,"Pilot 8","Pilot 8: max feedback + text"
12,"SUPPRF25745",100,0,38,-21,-16,63,54,59,"Pilot 8","Pilot 8: max feedback + text"
13,"SUPPRF25745",99,1,80,31,0,19,80,49,"Pilot 8","Pilot 8: max feedback + text"
14,"SUPPRF25745",99,1,55,-4,-16,31,71,59,"Pilot 8","Pilot 8: max feedback + text"
15,"SUPPRF25745",99,1,70,7,-1,79,71,63,"Pilot 8","Pilot 8: max feedback + text"
16,"SUPPRF25745",100,0,20,-40,0,35,20,60,"Pilot 8","Pilot 8: max feedback + text"
17,"SUPPRF25745",100,0,6,-13,-14,54,20,19,"Pilot 8","Pilot 8: max feedback + text"
18,"SUPPRF25745",100,0,47,30,27,31,20,17,"Pilot 8","Pilot 8: max feedback + text"
19,"SUPPRF25745",100,0,35,18,15,1,20,17,"Pilot 8","Pilot 8: max feedback + text"
20,"SUPPRF25745",100,0,96,31,16,42,80,65,"Pilot 8","Pilot 8: max feedback + text"
21,"SUPPRF25745",100,0,62,3,-1,13,63,59,"Pilot 8","Pilot 8: max feedback + text"
22,"SUPPRF25745",100,0,83,11,12,70,71,72,"Pilot 8","Pilot 8: max feedback + text"
23,"SUPPRF25745",100,0,15,-55,-14,61,29,70,"Pilot 8","Pilot 8: max feedback + text"
24,"SUPPRF25745",100,0,50,-16,-13,66,63,66,"Pilot 8","Pilot 8: max feedback + text"
25,"SUPPRF25745",100,1,77,15,14,57,63,62,"Pilot 8","Pilot 8: max feedback + text"
26,"SUPPRF25745",100,0,24,-13,-13,61,37,37,"Pilot 8","Pilot 8: max feedback + text"
27,"SUPPRF25745",99,0,55,-9,1,56,54,64,"Pilot 8","Pilot 8: max feedback + text"
28,"SUPPRF25745",100,0,88,22,25,69,63,66,"Pilot 8","Pilot 8: max feedback + text"
29,"SUPPRF25745",100,0,16,-18,-13,74,29,34,"Pilot 8","Pilot 8: max feedback + text"
30,"SUPPRF25745",100,0,66,1,12,72,54,65,"Pilot 8","Pilot 8: max feedback + text"
31,"SUPPRF25745",100,0,33,-13,-13,65,46,46,"Pilot 8","Pilot 8: max feedback + text"
32,"SUPPRF25745",99,0,46,17,17,33,29,29,"Pilot 8","Pilot 8: max feedback + text"
33,"SUPPRF25745",100,1,78,12,24,80,54,66,"Pilot 8","Pilot 8: max feedback + text"
34,"SUPPRF25745",100,0,47,-16,-16,77,63,63,"Pilot 8","Pilot 8: max feedback + text"
35,"SUPPRF25745",100,0,38,4,1,53,37,34,"Pilot 8","Pilot 8: max feedback + text"
36,"SUPPRF25745",100,0,100,17,20,72,80,83,"Pilot 8","Pilot 8: max feedback + text"
37,"SUPPRF25745",99,0,71,11,0,29,71,60,"Pilot 8","Pilot 8: max feedback + text"
38,"SUPPRF25745",100,0,58,32,29,74,29,26,"Pilot 8","Pilot 8: max feedback + text"
39,"SUPPRF25745",99,0,37,-4,0,67,37,41,"Pilot 8","Pilot 8: max feedback + text"
40,"SUPPRF25745",100,0,41,-23,-13,65,54,64,"Pilot 8","Pilot 8: max feedback + text"
41,"SUPPRF25745",100,0,75,26,29,54,46,49,"Pilot 8","Pilot 8: max feedback + text"
42,"SUPPRF25745",100,1,19,-10,-1,59,20,29,"Pilot 8","Pilot 8: max feedback + text"
43,"SUPPRF25745",100,0,56,-1,-15,40,71,57,"Pilot 8","Pilot 8: max feedback + text"
44,"SUPPRF25745",100,0,94,25,23,72,71,69,"Pilot 8","Pilot 8: max feedback + text"
45,"SUPPRF25745",100,0,68,-5,-12,74,80,73,"Pilot 8","Pilot 8: max feedback + text"
46,"SUPPRF25745",100,0,49,12,12,63,37,37,"Pilot 8","Pilot 8: max feedback + text"
47,"SUPPRF25745",100,1,67,36,-13,49,80,31,"Pilot 8","Pilot 8: max feedback + text"
48,"SUPPRF25745",100,0,58,3,12,74,46,55,"Pilot 8","Pilot 8: max feedback + text"
1,"SUPPRF90136",79,69,80,20,0,37,80,60,"Pilot 8","Pilot 8: max feedback + text"
2,"SUPPRF90136",73,66,15,-28,-14,76,29,43,"Pilot 8","Pilot 8: max feedback + text"
3,"SUPPRF90136",87,43,77,7,14,74,63,70,"Pilot 8","Pilot 8: max feedback + text"
4,"SUPPRF90136",79,42,61,29,24,77,37,32,"Pilot 8","Pilot 8: max feedback + text"
5,"SUPPRF90136",75,48,50,-12,-13,79,63,62,"Pilot 8","Pilot 8: max feedback + text"
6,"SUPPRF90136",67,58,38,1,1,44,37,37,"Pilot 8","Pilot 8: max feedback + text"
7,"SUPPRF90136",53,53,62,-6,-1,60,63,68,"Pilot 8","Pilot 8: max feedback + text"
8,"SUPPRF90136",49,57,37,-4,0,72,37,41,"Pilot 8","Pilot 8: max feedback + text"
9,"SUPPRF90136",45,60,24,-26,-13,36,37,50,"Pilot 8","Pilot 8: max feedback + text"
10,"SUPPRF90136",46,61,75,17,29,80,46,58,"Pilot 8","Pilot 8: max feedback + text"
11,"SUPPRF90136",53,66,78,16,24,72,54,62,"Pilot 8","Pilot 8: max feedback + text"
12,"SUPPRF90136",42,64,63,-4,0,46,63,67,"Pilot 8","Pilot 8: max feedback + text"
13,"SUPPRF90136",42,68,88,23,25,52,63,65,"Pilot 8","Pilot 8: max feedback + text"
14,"SUPPRF90136",38,64,67,-5,-13,31,80,72,"Pilot 8","Pilot 8: max feedback + text"
15,"SUPPRF90136",37,73,38,-20,-16,55,54,58,"Pilot 8","Pilot 8: max feedback + text"
16,"SUPPRF90136",26,62,33,10,-13,40,46,23,"Pilot 8","Pilot 8: max feedback + text"
17,"SUPPRF90136",18,67,34,-24,-12,33,46,58,"Pilot 8","Pilot 8: max feedback + text"
18,"SUPPRF90136",31,63,46,-9,17,24,29,55,"Pilot 8","Pilot 8: max feedback + text"
19,"SUPPRF90136",25,60,58,9,12,21,46,49,"Pilot 8","Pilot 8: max feedback + text"
20,"SUPPRF90136",29,65,68,-13,-12,67,80,81,"Pilot 8","Pilot 8: max feedback + text"
21,"SUPPRF90136",41,62,55,1,1,38,54,54,"Pilot 8","Pilot 8: max feedback + text"
22,"SUPPRF90136",47,60,20,1,0,84,20,19,"Pilot 8","Pilot 8: max feedback + text"
23,"SUPPRF90136",52,53,70,-8,-1,62,71,78,"Pilot 8","Pilot 8: max feedback + text"
24,"SUPPRF90136",53,61,100,45,20,48,80,55,"Pilot 8","Pilot 8: max feedback + text"
25,"SUPPRF90136",50,63,16,-18,-13,82,29,34,"Pilot 8","Pilot 8: max feedback + text"
26,"SUPPRF90136",46,51,56,-4,-15,82,71,60,"Pilot 8","Pilot 8: max feedback + text"
27,"SUPPRF90136",42,62,29,-42,0,59,29,71,"Pilot 8","Pilot 8: max feedback + text"
28,"SUPPRF90136",36,63,8,1,-12,15,20,7,"Pilot 8","Pilot 8: max feedback + text"
29,"SUPPRF90136",45,72,71,2,0,70,71,69,"Pilot 8","Pilot 8: max feedback + text"
30,"SUPPRF90136",30,60,41,-20,-13,69,54,61,"Pilot 8","Pilot 8: max feedback + text"
31,"SUPPRF90136",45,49,47,36,27,86,20,11,"Pilot 8","Pilot 8: max feedback + text"
32,"SUPPRF90136",39,57,28,4,-1,83,29,24,"Pilot 8","Pilot 8: max feedback + text"
33,"SUPPRF90136",39,51,81,8,1,50,80,73,"Pilot 8","Pilot 8: max feedback + text"
34,"SUPPRF90136",41,59,96,27,16,42,80,69,"Pilot 8","Pilot 8: max feedback + text"
35,"SUPPRF90136",42,54,45,7,-1,64,46,38,"Pilot 8","Pilot 8: max feedback + text"
36,"SUPPRF90136",34,51,94,33,23,57,71,61,"Pilot 8","Pilot 8: max feedback + text"
37,"SUPPRF90136",34,63,58,28,29,70,29,30,"Pilot 8","Pilot 8: max feedback + text"
38,"SUPPRF90136",21,77,6,-28,-14,9,20,34,"Pilot 8","Pilot 8: max feedback + text"
39,"SUPPRF90136",9,77,83,24,12,27,71,59,"Pilot 8","Pilot 8: max feedback + text"
40,"SUPPRF90136",15,73,66,19,12,27,54,47,"Pilot 8","Pilot 8: max feedback + text"
41,"SUPPRF90136",13,71,35,13,15,23,20,22,"Pilot 8","Pilot 8: max feedback + text"
42,"SUPPRF90136",19,74,55,-15,-16,47,71,70,"Pilot 8","Pilot 8: max feedback + text"
43,"SUPPRF90136",19,72,19,-14,-1,44,20,33,"Pilot 8","Pilot 8: max feedback + text"
44,"SUPPRF90136",35,73,54,-5,0,61,54,59,"Pilot 8","Pilot 8: max feedback + text"
45,"SUPPRF90136",49,65,22,-3,-15,72,37,25,"Pilot 8","Pilot 8: max feedback + text"
46,"SUPPRF90136",26,70,49,26,12,90,37,23,"Pilot 8","Pilot 8: max feedback + text"
47,"SUPPRF90136",33,76,46,-2,0,78,46,48,"Pilot 8","Pilot 8: max feedback + text"
48,"SUPPRF90136",25,62,47,-11,-16,64,63,58,"Pilot 8","Pilot 8: max feedback + text"
1,"SUPPRF19517",56,20,34,-10,-12,83,46,44,"Pilot 8","Pilot 8: max feedback + text"
2,"SUPPRF19517",62,9,16,1,-13,81,29,15,"Pilot 8","Pilot 8: max feedback + text"
3,"SUPPRF19517",76,5,45,22,-1,19,46,23,"Pilot 8","Pilot 8: max feedback + text"
4,"SUPPRF19517",58,5,63,13,0,11,63,50,"Pilot 8","Pilot 8: max feedback + text"
5,"SUPPRF19517",51,1,66,26,12,0,54,40,"Pilot 8","Pilot 8: max feedback + text"
6,"SUPPRF19517",50,0,61,37,24,0,37,24,"Pilot 8","Pilot 8: max feedback + text"
7,"SUPPRF19517",17,0,94,72,23,0,71,22,"Pilot 8","Pilot 8: max feedback + text"
8,"SUPPRF19517",6,0,77,41,14,0,63,36,"Pilot 8","Pilot 8: max feedback + text"
9,"SUPPRF19517",42,0,35,8,15,0,20,27,"Pilot 8","Pilot 8: max feedback + text"
10,"SUPPRF19517",57,0,46,5,17,0,29,41,"Pilot 8","Pilot 8: max feedback + text"
11,"SUPPRF19517",57,6,28,-16,-1,0,29,44,"Pilot 8","Pilot 8: max feedback + text"
12,"SUPPRF19517",57,1,49,24,12,0,37,25,"Pilot 8","Pilot 8: max feedback + text"
13,"SUPPRF19517",56,6,47,9,27,0,20,38,"Pilot 8","Pilot 8: max feedback + text"
14,"SUPPRF19517",80,9,83,20,12,0,71,63,"Pilot 8","Pilot 8: max feedback + text"
15,"SUPPRF19517",70,5,55,55,-16,0,71,0,"Pilot 8","Pilot 8: max feedback + text"
16,"SUPPRF19517",78,10,75,27,29,0,46,48,"Pilot 8","Pilot 8: max feedback + text"
17,"SUPPRF19517",79,16,54,13,0,71,54,41,"Pilot 8","Pilot 8: max feedback + text"
18,"SUPPRF19517",82,12,50,2,-13,67,63,48,"Pilot 8","Pilot 8: max feedback + text"
19,"SUPPRF19517",83,14,56,7,-15,79,71,49,"Pilot 8","Pilot 8: max feedback + text"
20,"SUPPRF19517",80,0,58,7,12,10,46,51,"Pilot 8","Pilot 8: max feedback + text"
21,"SUPPRF19517",72,0,20,0,0,8,20,20,"Pilot 8","Pilot 8: max feedback + text"
22,"SUPPRF19517",67,0,62,21,-1,10,63,41,"Pilot 8","Pilot 8: max feedback + text"
23,"SUPPRF19517",77,0,29,-1,0,0,29,30,"Pilot 8","Pilot 8: max feedback + text"
24,"SUPPRF19517",83,0,55,9,1,2,54,46,"Pilot 8","Pilot 8: max feedback + text"
25,"SUPPRF19517",72,44,96,30,16,0,80,66,"Pilot 8","Pilot 8: max feedback + text"
26,"SUPPRF19517",91,0,19,-7,-1,0,20,26,"Pilot 8","Pilot 8: max feedback + text"
27,"SUPPRF19517",74,0,68,-2,-12,0,80,70,"Pilot 8","Pilot 8: max feedback + text"
28,"SUPPRF19517",74,17,41,-8,-13,4,54,49,"Pilot 8","Pilot 8: max feedback + text"
29,"SUPPRF19517",74,15,8,-35,-12,0,20,43,"Pilot 8","Pilot 8: max feedback + text"
30,"SUPPRF19517",83,22,38,8,1,1,37,30,"Pilot 8","Pilot 8: max feedback + text"
31,"SUPPRF19517",83,14,100,33,20,8,80,67,"Pilot 8","Pilot 8: max feedback + text"
32,"SUPPRF19517",57,19,38,-23,-16,4,54,61,"Pilot 8","Pilot 8: max feedback + text"
33,"SUPPRF19517",93,3,47,8,-16,0,63,39,"Pilot 8","Pilot 8: max feedback + text"
34,"SUPPRF19517",83,6,33,-16,-13,0,46,49,"Pilot 8","Pilot 8: max feedback + text"
35,"SUPPRF19517",72,18,15,-24,-14,0,29,39,"Pilot 8","Pilot 8: max feedback + text"
36,"SUPPRF19517",75,17,37,2,0,0,37,35,"Pilot 8","Pilot 8: max feedback + text"
37,"SUPPRF19517",77,0,71,55,0,0,71,16,"Pilot 8","Pilot 8: max feedback + text"
38,"SUPPRF19517",90,4,88,42,25,4,63,46,"Pilot 8","Pilot 8: max feedback + text"
39,"SUPPRF19517",79,3,46,-3,0,0,46,49,"Pilot 8","Pilot 8: max feedback + text"
40,"SUPPRF19517",84,2,80,41,0,0,80,39,"Pilot 8","Pilot 8: max feedback + text"
41,"SUPPRF19517",100,0,22,-24,-15,2,37,46,"Pilot 8","Pilot 8: max feedback + text"
42,"SUPPRF19517",79,0,78,27,24,0,54,51,"Pilot 8","Pilot 8: max feedback + text"
43,"SUPPRF19517",100,0,58,15,29,0,29,43,"Pilot 8","Pilot 8: max feedback + text"
44,"SUPPRF19517",99,4,24,-17,-13,0,37,41,"Pilot 8","Pilot 8: max feedback + text"
45,"SUPPRF19517",80,0,67,-10,-13,0,80,77,"Pilot 8","Pilot 8: max feedback + text"
46,"SUPPRF19517",98,1,70,18,-1,4,71,52,"Pilot 8","Pilot 8: max feedback + text"
47,"SUPPRF19517",98,0,81,7,1,0,80,74,"Pilot 8","Pilot 8: max feedback + text"
48,"SUPPRF19517",66,9,6,-17,-14,1,20,23,"Pilot 8","Pilot 8: max feedback + text"
1,"SUPPRF48856",33,48,78,78,24,0,54,0,"Pilot 8","Pilot 8: max feedback + text"
2,"SUPPRF48856",57,29,96,16,16,64,80,80,"Pilot 8","Pilot 8: max feedback + text"
3,"SUPPRF48856",57,16,83,12,12,64,71,71,"Pilot 8","Pilot 8: max feedback + text"
4,"SUPPRF48856",52,13,24,-7,-13,60,37,31,"Pilot 8","Pilot 8: max feedback + text"
5,"SUPPRF48856",51,6,55,9,1,58,54,46,"Pilot 8","Pilot 8: max feedback + text"
6,"SUPPRF48856",50,4,45,6,-1,57,46,39,"Pilot 8","Pilot 8: max feedback + text"
7,"SUPPRF48856",49,2,71,1,0,50,71,70,"Pilot 8","Pilot 8: max feedback + text"
8,"SUPPRF48856",43,0,8,-12,-12,59,20,20,"Pilot 8","Pilot 8: max feedback + text"
9,"SUPPRF48856",49,0,58,14,12,60,46,44,"Pilot 8","Pilot 8: max feedback + text"
10,"SUPPRF48856",49,0,77,7,14,38,63,70,"Pilot 8","Pilot 8: max feedback + text"
11,"SUPPRF48856",50,0,88,19,25,39,63,69,"Pilot 8","Pilot 8: max feedback + text"
12,"SUPPRF48856",51,0,67,-23,-13,58,80,90,"Pilot 8","Pilot 8: max feedback + text"
13,"SUPPRF48856",50,2,6,-14,-14,63,20,20,"Pilot 8","Pilot 8: max feedback + text"
14,"SUPPRF48856",48,1,37,-10,0,17,37,47,"Pilot 8","Pilot 8: max feedback + text"
15,"SUPPRF48856",49,0,33,-17,-13,31,46,50,"Pilot 8","Pilot 8: max feedback + text"
16,"SUPPRF48856",49,0,29,-2,0,48,29,31,"Pilot 8","Pilot 8: max feedback + text"
17,"SUPPRF48856",50,0,41,-25,-13,52,54,66,"Pilot 8","Pilot 8: max feedback + text"
18,"SUPPRF48856",49,0,68,-17,-12,62,80,85,"Pilot 8","Pilot 8: max feedback + text"
19,"SUPPRF48856",51,0,28,7,-1,12,29,21,"Pilot 8","Pilot 8: max feedback + text"
20,"SUPPRF48856",47,0,46,16,17,58,29,30,"Pilot 8","Pilot 8: max feedback + text"
21,"SUPPRF48856",49,0,94,44,23,1,71,50,"Pilot 8","Pilot 8: max feedback + text"
22,"SUPPRF48856",49,0,70,-1,-1,58,71,71,"Pilot 8","Pilot 8: max feedback + text"
23,"SUPPRF48856",49,0,100,30,20,58,80,70,"Pilot 8","Pilot 8: max feedback + text"
24,"SUPPRF48856",49,3,46,0,0,72,46,46,"Pilot 8","Pilot 8: max feedback + text"
25,"SUPPRF48856",50,0,19,-1,-1,67,20,20,"Pilot 8","Pilot 8: max feedback + text"
26,"SUPPRF48856",49,0,20,0,0,60,20,20,"Pilot 8","Pilot 8: max feedback + text"
27,"SUPPRF48856",50,1,61,12,24,1,37,49,"Pilot 8","Pilot 8: max feedback + text"
28,"SUPPRF48856",51,0,81,-9,1,74,80,90,"Pilot 8","Pilot 8: max feedback + text"
29,"SUPPRF48856",51,0,63,3,0,69,63,60,"Pilot 8","Pilot 8: max feedback + text"
30,"SUPPRF48856",49,0,47,-3,-16,51,63,50,"Pilot 8","Pilot 8: max feedback + text"
31,"SUPPRF48856",50,3,56,-34,-15,18,71,90,"Pilot 8","Pilot 8: max feedback + text"
32,"SUPPRF48856",49,0,62,12,-1,48,63,50,"Pilot 8","Pilot 8: max feedback + text"
33,"SUPPRF48856",50,1,35,15,15,62,20,20,"Pilot 8","Pilot 8: max feedback + text"
34,"SUPPRF48856",49,0,22,-18,-15,50,37,40,"Pilot 8","Pilot 8: max feedback + text"
35,"SUPPRF48856",48,2,54,-1,0,55,54,55,"Pilot 8","Pilot 8: max feedback + text"
36,"SUPPRF48856",49,0,16,-14,-13,62,29,30,"Pilot 8","Pilot 8: max feedback + text"
37,"SUPPRF48856",45,1,58,27,29,66,29,31,"Pilot 8","Pilot 8: max feedback + text"
38,"SUPPRF48856",48,2,38,-6,1,59,37,44,"Pilot 8","Pilot 8: max feedback + text"
39,"SUPPRF48856",50,0,50,-5,-13,47,63,55,"Pilot 8","Pilot 8: max feedback + text"
40,"SUPPRF48856",40,1,34,-27,-12,48,46,61,"Pilot 8","Pilot 8: max feedback + text"
41,"SUPPRF48856",45,0,55,-18,-16,67,71,73,"Pilot 8","Pilot 8: max feedback + text"
42,"SUPPRF48856",48,1,15,-14,-14,68,29,29,"Pilot 8","Pilot 8: max feedback + text"
43,"SUPPRF48856",50,0,75,30,29,66,46,45,"Pilot 8","Pilot 8: max feedback + text"
44,"SUPPRF48856",49,2,80,-3,0,67,80,83,"Pilot 8","Pilot 8: max feedback + text"
45,"SUPPRF48856",50,0,38,-16,-16,71,54,54,"Pilot 8","Pilot 8: max feedback + text"
46,"SUPPRF48856",50,1,47,27,27,74,20,20,"Pilot 8","Pilot 8: max feedback + text"
47,"SUPPRF48856",49,0,66,13,12,75,54,53,"Pilot 8","Pilot 8: max feedback + text"
48,"SUPPRF48856",47,0,49,4,12,66,37,45,"Pilot 8","Pilot 8: max feedback + text"
1,"SUPPRF21828",50,50,71,17,0,49,71,54,"Pilot 8","Pilot 8: max feedback + text"
2,"SUPPRF21828",51,48,37,-10,0,50,37,47,"Pilot 8","Pilot 8: max feedback + text"
3,"SUPPRF21828",47,47,58,10,29,46,29,48,"Pilot 8","Pilot 8: max feedback + text"
4,"SUPPRF21828",49,49,78,23,24,49,54,55,"Pilot 8","Pilot 8: max feedback + text"
5,"SUPPRF21828",47,46,47,-2,27,49,20,49,"Pilot 8","Pilot 8: max feedback + text"
6,"SUPPRF21828",47,47,47,-3,-16,50,63,50,"Pilot 8","Pilot 8: max feedback + text"
7,"SUPPRF21828",49,49,88,37,25,51,63,51,"Pilot 8","Pilot 8: max feedback + text"
8,"SUPPRF21828",47,48,58,7,12,50,46,51,"Pilot 8","Pilot 8: max feedback + text"
9,"SUPPRF21828",49,47,66,19,12,49,54,47,"Pilot 8","Pilot 8: max feedback + text"
10,"SUPPRF21828",49,49,80,22,0,49,80,58,"Pilot 8","Pilot 8: max feedback + text"
11,"SUPPRF21828",51,50,49,-1,12,52,37,50,"Pilot 8","Pilot 8: max feedback + text"
12,"SUPPRF21828",49,50,70,21,-1,50,71,49,"Pilot 8","Pilot 8: max feedback + text"
13,"SUPPRF21828",49,49,45,-4,-1,50,46,49,"Pilot 8","Pilot 8: max feedback + text"
14,"SUPPRF21828",48,49,75,25,29,51,46,50,"Pilot 8","Pilot 8: max feedback + text"
15,"SUPPRF21828",48,47,46,-2,17,48,29,48,"Pilot 8","Pilot 8: max feedback + text"
16,"SUPPRF21828",50,51,94,46,23,49,71,48,"Pilot 8","Pilot 8: max feedback + text"
17,"SUPPRF21828",49,47,41,-9,-13,50,54,50,"Pilot 8","Pilot 8: max feedback + text"
18,"SUPPRF21828",48,47,33,-21,-13,46,46,54,"Pilot 8","Pilot 8: max feedback + text"
19,"SUPPRF21828",49,48,29,-30,0,48,29,59,"Pilot 8","Pilot 8: max feedback + text"
20,"SUPPRF21828",50,50,19,-45,-1,45,20,64,"Pilot 8","Pilot 8: max feedback + text"
21,"SUPPRF21828",50,50,38,-15,-16,51,54,53,"Pilot 8","Pilot 8: max feedback + text"
22,"SUPPRF21828",49,50,83,31,12,48,71,52,"Pilot 8","Pilot 8: max feedback + text"
23,"SUPPRF21828",49,49,55,3,1,49,54,52,"Pilot 8","Pilot 8: max feedback + text"
24,"SUPPRF21828",49,47,38,-20,1,48,37,58,"Pilot 8","Pilot 8: max feedback + text"
25,"SUPPRF21828",50,50,6,-55,-14,51,20,61,"Pilot 8","Pilot 8: max feedback + text"
26,"SUPPRF21828",51,51,46,-14,0,51,46,60,"Pilot 8","Pilot 8: max feedback + text"
27,"SUPPRF21828",51,49,55,3,-16,50,71,52,"Pilot 8","Pilot 8: max feedback + text"
28,"SUPPRF21828",51,50,34,-31,-12,49,46,65,"Pilot 8","Pilot 8: max feedback + text"
29,"SUPPRF21828",50,50,62,8,-1,50,63,54,"Pilot 8","Pilot 8: max feedback + text"
30,"SUPPRF21828",49,48,68,14,-12,47,80,54,"Pilot 8","Pilot 8: max feedback + text"
31,"SUPPRF21828",48,48,50,0,-13,48,63,50,"Pilot 8","Pilot 8: max feedback + text"
32,"SUPPRF21828",49,48,54,-8,0,49,54,62,"Pilot 8","Pilot 8: max feedback + text"
33,"SUPPRF21828",50,50,61,6,24,57,37,55,"Pilot 8","Pilot 8: max feedback + text"
34,"SUPPRF21828",49,50,24,-35,-13,51,37,59,"Pilot 8","Pilot 8: max feedback + text"
35,"SUPPRF21828",49,48,56,4,-15,51,71,52,"Pilot 8","Pilot 8: max feedback + text"
36,"SUPPRF21828",49,48,77,29,14,48,63,48,"Pilot 8","Pilot 8: max feedback + text"
37,"SUPPRF21828",50,49,20,-40,0,55,20,60,"Pilot 8","Pilot 8: max feedback + text"
38,"SUPPRF21828",49,50,81,23,1,49,80,58,"Pilot 8","Pilot 8: max feedback + text"
39,"SUPPRF21828",49,50,96,46,16,49,80,50,"Pilot 8","Pilot 8: max feedback + text"
40,"SUPPRF21828",48,49,67,17,-13,49,80,50,"Pilot 8","Pilot 8: max feedback + text"
41,"SUPPRF21828",48,46,35,1,15,45,20,34,"Pilot 8","Pilot 8: max feedback + text"
42,"SUPPRF21828",49,49,22,-45,-15,52,37,67,"Pilot 8","Pilot 8: max feedback + text"
43,"SUPPRF21828",50,52,15,-13,-14,49,29,28,"Pilot 8","Pilot 8: max feedback + text"
44,"SUPPRF21828",48,47,16,-10,-13,48,29,26,"Pilot 8","Pilot 8: max feedback + text"
45,"SUPPRF21828",49,48,8,-37,-12,48,20,45,"Pilot 8","Pilot 8: max feedback + text"
46,"SUPPRF21828",48,47,28,4,-1,49,29,24,"Pilot 8","Pilot 8: max feedback + text"
47,"SUPPRF21828",48,47,63,28,0,50,63,35,"Pilot 8","Pilot 8: max feedback + text"
48,"SUPPRF21828",47,50,100,16,20,48,80,84,"Pilot 8","Pilot 8: max feedback + text"
1,"SUPPRF12765",75,1,68,-2,-12,50,80,70,"Pilot 8","Pilot 8: max feedback + text"
2,"SUPPRF12765",76,0,24,-20,-13,50,37,44,"Pilot 8","Pilot 8: max feedback + text"
3,"SUPPRF12765",76,0,55,-11,1,50,54,66,"Pilot 8","Pilot 8: max feedback + text"
4,"SUPPRF12765",80,75,8,-12,-12,0,20,20,"Pilot 8","Pilot 8: max feedback + text"
5,"SUPPRF12765",76,0,38,10,1,0,37,28,"Pilot 8","Pilot 8: max feedback + text"
6,"SUPPRF12765",72,0,47,-18,-16,0,63,65,"Pilot 8","Pilot 8: max feedback + text"
7,"SUPPRF12765",70,0,28,16,-1,0,29,12,"Pilot 8","Pilot 8: max feedback + text"
8,"SUPPRF12765",78,0,20,0,0,100,20,20,"Pilot 8","Pilot 8: max feedback + text"
9,"SUPPRF12765",73,0,62,-3,-1,0,63,65,"Pilot 8","Pilot 8: max feedback + text"
10,"SUPPRF12765",78,0,22,-26,-15,50,37,48,"Pilot 8","Pilot 8: max feedback + text"
11,"SUPPRF12765",70,0,41,-20,-13,17,54,61,"Pilot 8","Pilot 8: max feedback + text"
12,"SUPPRF12765",71,0,100,41,20,0,80,59,"Pilot 8","Pilot 8: max feedback + text"
13,"SUPPRF12765",84,0,77,19,14,0,63,58,"Pilot 8","Pilot 8: max feedback + text"
14,"SUPPRF12765",79,0,61,28,24,0,37,33,"Pilot 8","Pilot 8: max feedback + text"
15,"SUPPRF12765",64,0,37,-26,0,50,37,63,"Pilot 8","Pilot 8: max feedback + text"
16,"SUPPRF12765",73,0,58,1,12,0,46,57,"Pilot 8","Pilot 8: max feedback + text"
17,"SUPPRF12765",73,0,46,-14,17,50,29,60,"Pilot 8","Pilot 8: max feedback + text"
18,"SUPPRF12765",79,0,16,-3,-13,2,29,19,"Pilot 8","Pilot 8: max feedback + text"
19,"SUPPRF12765",81,0,71,-7,0,0,71,78,"Pilot 8","Pilot 8: max feedback + text"
20,"SUPPRF12765",73,0,58,-13,29,0,29,71,"Pilot 8","Pilot 8: max feedback + text"
21,"SUPPRF12765",76,1,33,-33,-13,68,46,66,"Pilot 8","Pilot 8: max feedback + text"
22,"SUPPRF12765",71,0,15,-18,-14,100,29,33,"Pilot 8","Pilot 8: max feedback + text"
23,"SUPPRF12765",81,4,34,-9,-12,2,46,43,"Pilot 8","Pilot 8: max feedback + text"
24,"SUPPRF12765",78,0,96,17,16,50,80,79,"Pilot 8","Pilot 8: max feedback + text"
25,"SUPPRF12765",72,2,46,23,0,100,46,23,"Pilot 8","Pilot 8: max feedback + text"
26,"SUPPRF12765",64,0,35,16,15,100,20,19,"Pilot 8","Pilot 8: max feedback + text"
27,"SUPPRF12765",68,0,49,-2,12,0,37,51,"Pilot 8","Pilot 8: max feedback + text"
28,"SUPPRF12765",73,0,75,12,29,55,46,63,"Pilot 8","Pilot 8: max feedback + text"
29,"SUPPRF12765",80,0,47,24,27,100,20,23,"Pilot 8","Pilot 8: max feedback + text"
30,"SUPPRF12765",75,0,56,-29,-15,95,71,85,"Pilot 8","Pilot 8: max feedback + text"
31,"SUPPRF12765",72,0,80,-3,0,74,80,83,"Pilot 8","Pilot 8: max feedback + text"
32,"SUPPRF12765",70,0,54,54,0,0,54,0,"Pilot 8","Pilot 8: max feedback + text"
33,"SUPPRF12765",65,0,63,2,0,21,63,61,"Pilot 8","Pilot 8: max feedback + text"
34,"SUPPRF12765",73,0,81,4,1,11,80,77,"Pilot 8","Pilot 8: max feedback + text"
35,"SUPPRF12765",70,0,67,10,-13,75,80,57,"Pilot 8","Pilot 8: max feedback + text"
36,"SUPPRF12765",78,0,6,-26,-14,100,20,32,"Pilot 8","Pilot 8: max feedback + text"
37,"SUPPRF12765",74,3,83,47,12,100,71,36,"Pilot 8","Pilot 8: max feedback + text"
38,"SUPPRF12765",67,0,38,-23,-16,74,54,61,"Pilot 8","Pilot 8: max feedback + text"
39,"SUPPRF12765",76,0,50,20,-13,94,63,30,"Pilot 8","Pilot 8: max feedback + text"
40,"SUPPRF12765",73,0,66,-11,12,0,54,77,"Pilot 8","Pilot 8: max feedback + text"
41,"SUPPRF12765",77,0,55,-27,-16,73,71,82,"Pilot 8","Pilot 8: max feedback + text"
42,"SUPPRF12765",77,0,88,34,25,0,63,54,"Pilot 8","Pilot 8: max feedback + text"
43,"SUPPRF12765",65,1,29,-35,0,77,29,64,"Pilot 8","Pilot 8: max feedback + text"
44,"SUPPRF12765",74,0,78,23,24,100,54,55,"Pilot 8","Pilot 8: max feedback + text"
45,"SUPPRF12765",72,0,19,-9,-1,100,20,28,"Pilot 8","Pilot 8: max feedback + text"
46,"SUPPRF12765",75,0,70,9,-1,0,71,61,"Pilot 8","Pilot 8: max feedback + text"
47,"SUPPRF12765",74,0,94,22,23,100,71,72,"Pilot 8","Pilot 8: max feedback + text"
48,"SUPPRF12765",73,0,45,3,-1,0,46,42,"Pilot 8","Pilot 8: max feedback + text"
1,"SUPPRF86181",64,17,58,6,12,47,46,52,"Pilot 8","Pilot 8: max feedback + text"
2,"SUPPRF86181",55,27,49,17,12,58,37,32,"Pilot 8","Pilot 8: max feedback + text"
3,"SUPPRF86181",27,16,6,-51,-14,35,20,57,"Pilot 8","Pilot 8: max feedback + text"
4,"SUPPRF86181",54,27,47,28,27,21,20,19,"Pilot 8","Pilot 8: max feedback + text"
5,"SUPPRF86181",41,42,38,-12,-16,54,54,50,"Pilot 8","Pilot 8: max feedback + text"
6,"SUPPRF86181",45,14,24,-26,-13,49,37,50,"Pilot 8","Pilot 8: max feedback + text"
7,"SUPPRF86181",35,36,58,24,29,38,29,34,"Pilot 8","Pilot 8: max feedback + text"
8,"SUPPRF86181",49,18,94,30,23,72,71,64,"Pilot 8","Pilot 8: max feedback + text"
9,"SUPPRF86181",20,39,34,-19,-12,60,46,53,"Pilot 8","Pilot 8: max feedback + text"
10,"SUPPRF86181",23,27,66,29,12,57,54,37,"Pilot 8","Pilot 8: max feedback + text"
11,"SUPPRF86181",44,44,41,1,-13,50,54,40,"Pilot 8","Pilot 8: max feedback + text"
12,"SUPPRF86181",35,47,50,23,-13,13,63,27,"Pilot 8","Pilot 8: max feedback + text"
13,"SUPPRF86181",23,15,16,-33,-13,19,29,49,"Pilot 8","Pilot 8: max feedback + text"
14,"SUPPRF86181",58,44,67,32,-13,55,80,35,"Pilot 8","Pilot 8: max feedback + text"
15,"SUPPRF86181",60,27,68,25,-12,28,80,43,"Pilot 8","Pilot 8: max feedback + text"
16,"SUPPRF86181",78,22,46,-33,17,68,29,79,"Pilot 8","Pilot 8: max feedback + text"
17,"SUPPRF86181",73,31,45,-4,-1,61,46,49,"Pilot 8","Pilot 8: max feedback + text"
18,"SUPPRF86181",75,26,100,48,20,28,80,52,"Pilot 8","Pilot 8: max feedback + text"
19,"SUPPRF86181",49,20,46,-11,0,53,46,57,"Pilot 8","Pilot 8: max feedback + text"
20,"SUPPRF86181",36,24,29,-36,0,55,29,65,"Pilot 8","Pilot 8: max feedback + text"
21,"SUPPRF86181",75,12,80,10,0,79,80,70,"Pilot 8","Pilot 8: max feedback + text"
22,"SUPPRF86181",61,26,56,-8,-15,74,71,64,"Pilot 8","Pilot 8: max feedback + text"
23,"SUPPRF86181",61,21,38,-13,1,64,37,51,"Pilot 8","Pilot 8: max feedback + text"
24,"SUPPRF86181",60,28,15,-35,-14,28,29,50,"Pilot 8","Pilot 8: max feedback + text"
25,"SUPPRF86181",38,35,37,-3,0,50,37,40,"Pilot 8","Pilot 8: max feedback + text"
26,"SUPPRF86181",57,30,35,-31,15,30,20,66,"Pilot 8","Pilot 8: max feedback + text"
27,"SUPPRF86181",57,32,62,21,-1,47,63,41,"Pilot 8","Pilot 8: max feedback + text"
28,"SUPPRF86181",66,23,55,-3,1,70,54,58,"Pilot 8","Pilot 8: max feedback + text"
29,"SUPPRF86181",53,55,33,-14,-13,55,46,47,"Pilot 8","Pilot 8: max feedback + text"
30,"SUPPRF86181",57,31,61,15,24,53,37,46,"Pilot 8","Pilot 8: max feedback + text"
31,"SUPPRF86181",49,56,55,-3,-16,70,71,58,"Pilot 8","Pilot 8: max feedback + text"
32,"SUPPRF86181",60,29,96,24,16,81,80,72,"Pilot 8","Pilot 8: max feedback + text"
33,"SUPPRF86181",63,22,54,-11,0,73,54,65,"Pilot 8","Pilot 8: max feedback + text"
34,"SUPPRF86181",65,26,81,-3,1,77,80,84,"Pilot 8","Pilot 8: max feedback + text"
35,"SUPPRF86181",51,21,19,-53,-1,27,20,72,"Pilot 8","Pilot 8: max feedback + text"
36,"SUPPRF86181",74,21,28,-4,-1,70,29,32,"Pilot 8","Pilot 8: max feedback + text"
37,"SUPPRF86181",57,24,22,-32,-15,64,37,54,"Pilot 8","Pilot 8: max feedback + text"
38,"SUPPRF86181",64,64,47,6,-16,61,63,41,"Pilot 8","Pilot 8: max feedback + text"
39,"SUPPRF86181",60,32,78,24,24,81,54,54,"Pilot 8","Pilot 8: max feedback + text"
40,"SUPPRF86181",79,26,20,-19,0,28,20,39,"Pilot 8","Pilot 8: max feedback + text"
41,"SUPPRF86181",62,29,75,22,29,73,46,53,"Pilot 8","Pilot 8: max feedback + text"
42,"SUPPRF86181",66,62,71,20,0,52,71,51,"Pilot 8","Pilot 8: max feedback + text"
43,"SUPPRF86181",63,32,70,42,-1,59,71,28,"Pilot 8","Pilot 8: max feedback + text"
44,"SUPPRF86181",67,19,77,13,14,61,63,64,"Pilot 8","Pilot 8: max feedback + text"
45,"SUPPRF86181",72,21,8,-13,-12,84,20,21,"Pilot 8","Pilot 8: max feedback + text"
46,"SUPPRF86181",66,26,83,15,12,63,71,68,"Pilot 8","Pilot 8: max feedback + text"
47,"SUPPRF86181",79,23,88,17,25,76,63,71,"Pilot 8","Pilot 8: max feedback + text"
48,"SUPPRF86181",75,27,63,5,0,20,63,58,"Pilot 8","Pilot 8: max feedback + text"
1,"SUPPRF51200",51,58,61,29,24,21,37,32,"Pilot 8","Pilot 8: max feedback + text"
2,"SUPPRF51200",51,44,71,38,0,37,71,33,"Pilot 8","Pilot 8: max feedback + text"
3,"SUPPRF51200",41,47,6,-25,-14,38,20,31,"Pilot 8","Pilot 8: max feedback + text"
4,"SUPPRF51200",47,44,15,-24,-14,37,29,39,"Pilot 8","Pilot 8: max feedback + text"
5,"SUPPRF51200",42,49,62,8,-1,58,63,54,"Pilot 8","Pilot 8: max feedback + text"
6,"SUPPRF51200",24,11,47,45,27,86,20,2,"Pilot 8","Pilot 8: max feedback + text"
7,"SUPPRF51200",44,52,58,47,29,46,29,11,"Pilot 8","Pilot 8: max feedback + text"
8,"SUPPRF51200",47,52,94,65,23,42,71,29,"Pilot 8","Pilot 8: max feedback + text"
9,"SUPPRF51200",53,13,20,-11,0,49,20,31,"Pilot 8","Pilot 8: max feedback + text"
10,"SUPPRF51200",52,47,56,15,-15,48,71,41,"Pilot 8","Pilot 8: max feedback + text"
11,"SUPPRF51200",42,46,46,28,17,37,29,18,"Pilot 8","Pilot 8: max feedback + text"
12,"SUPPRF51200",34,47,70,24,-1,53,71,46,"Pilot 8","Pilot 8: max feedback + text"
13,"SUPPRF51200",48,42,24,5,-13,42,37,19,"Pilot 8","Pilot 8: max feedback + text"
14,"SUPPRF51200",44,49,28,-17,-1,44,29,45,"Pilot 8","Pilot 8: max feedback + text"
15,"SUPPRF51200",32,33,34,-26,-12,62,46,60,"Pilot 8","Pilot 8: max feedback + text"
16,"SUPPRF51200",37,34,41,-8,-13,56,54,49,"Pilot 8","Pilot 8: max feedback + text"
17,"SUPPRF51200",40,48,75,55,29,44,46,20,"Pilot 8","Pilot 8: max feedback + text"
18,"SUPPRF51200",47,56,37,21,0,47,37,16,"Pilot 8","Pilot 8: max feedback + text"
19,"SUPPRF51200",46,49,38,-6,-16,70,54,44,"Pilot 8","Pilot 8: max feedback + text"
20,"SUPPRF51200",42,38,63,13,0,49,63,50,"Pilot 8","Pilot 8: max feedback + text"
21,"SUPPRF51200",38,38,100,42,20,46,80,58,"Pilot 8","Pilot 8: max feedback + text"
22,"SUPPRF51200",63,39,47,5,-16,47,63,42,"Pilot 8","Pilot 8: max feedback + text"
23,"SUPPRF51200",49,49,46,-3,0,41,46,49,"Pilot 8","Pilot 8: max feedback + text"
24,"SUPPRF51200",52,42,35,19,15,58,20,16,"Pilot 8","Pilot 8: max feedback + text"
25,"SUPPRF51200",51,47,54,-45,0,87,54,99,"Pilot 8","Pilot 8: max feedback + text"
26,"SUPPRF51200",50,46,66,41,12,43,54,25,"Pilot 8","Pilot 8: max feedback + text"
27,"SUPPRF51200",45,40,96,64,16,49,80,32,"Pilot 8","Pilot 8: max feedback + text"
28,"SUPPRF51200",41,49,78,30,24,49,54,48,"Pilot 8","Pilot 8: max feedback + text"
29,"SUPPRF51200",39,40,58,14,12,45,46,44,"Pilot 8","Pilot 8: max feedback + text"
30,"SUPPRF51200",52,46,67,12,-13,56,80,55,"Pilot 8","Pilot 8: max feedback + text"
31,"SUPPRF51200",50,44,55,19,-16,57,71,36,"Pilot 8","Pilot 8: max feedback + text"
32,"SUPPRF51200",55,51,50,-11,-13,33,63,61,"Pilot 8","Pilot 8: max feedback + text"
33,"SUPPRF51200",54,55,81,44,1,56,80,37,"Pilot 8","Pilot 8: max feedback + text"
34,"SUPPRF51200",14,48,80,67,0,48,80,13,"Pilot 8","Pilot 8: max feedback + text"
35,"SUPPRF51200",76,31,22,-11,-15,79,37,33,"Pilot 8","Pilot 8: max feedback + text"
36,"SUPPRF51200",49,41,77,33,14,60,63,44,"Pilot 8","Pilot 8: max feedback + text"
37,"SUPPRF51200",51,47,45,3,-1,91,46,42,"Pilot 8","Pilot 8: max feedback + text"
38,"SUPPRF51200",61,27,16,-13,-13,96,29,29,"Pilot 8","Pilot 8: max feedback + text"
39,"SUPPRF51200",71,36,83,15,12,63,71,68,"Pilot 8","Pilot 8: max feedback + text"
40,"SUPPRF51200",53,63,88,5,25,84,63,83,"Pilot 8","Pilot 8: max feedback + text"
41,"SUPPRF51200",33,1,8,-22,-12,28,20,30,"Pilot 8","Pilot 8: max feedback + text"
42,"SUPPRF51200",74,5,19,-39,-1,18,20,58,"Pilot 8","Pilot 8: max feedback + text"
43,"SUPPRF51200",49,40,29,-33,0,53,29,62,"Pilot 8","Pilot 8: max feedback + text"
44,"SUPPRF51200",42,34,68,17,-12,53,80,51,"Pilot 8","Pilot 8: max feedback + text"
45,"SUPPRF51200",54,43,49,21,12,19,37,28,"Pilot 8","Pilot 8: max feedback + text"
46,"SUPPRF51200",39,61,55,-5,1,68,54,60,"Pilot 8","Pilot 8: max feedback + text"
47,"SUPPRF51200",58,47,33,-20,-13,42,46,53,"Pilot 8","Pilot 8: max feedback + text"
48,"SUPPRF51200",55,33,38,-1,1,39,37,39,"Pilot 8","Pilot 8: max feedback + text"
1,"SUPPRF34485",69,8,38,2,1,70,37,36,"Pilot 8","Pilot 8: max feedback + text"
2,"SUPPRF34485",95,0,80,-2,0,99,80,82,"Pilot 8","Pilot 8: max feedback + text"
3,"SUPPRF34485",59,9,8,-13,-12,83,20,21,"Pilot 8","Pilot 8: max feedback + text"
4,"SUPPRF34485",78,26,46,4,17,53,29,42,"Pilot 8","Pilot 8: max feedback + text"
5,"SUPPRF34485",83,16,66,17,12,62,54,49,"Pilot 8","Pilot 8: max feedback + text"
6,"SUPPRF34485",57,9,67,-13,-13,59,80,80,"Pilot 8","Pilot 8: max feedback + text"
7,"SUPPRF34485",53,7,20,-47,0,40,20,67,"Pilot 8","Pilot 8: max feedback + text"
8,"SUPPRF34485",65,2,81,3,1,45,80,78,"Pilot 8","Pilot 8: max feedback + text"
9,"SUPPRF34485",66,6,19,-2,-1,60,20,21,"Pilot 8","Pilot 8: max feedback + text"
10,"SUPPRF34485",82,4,94,18,23,77,71,76,"Pilot 8","Pilot 8: max feedback + text"
11,"SUPPRF34485",56,4,63,-12,0,78,63,75,"Pilot 8","Pilot 8: max feedback + text"
12,"SUPPRF34485",63,13,88,31,25,57,63,57,"Pilot 8","Pilot 8: max feedback + text"
13,"SUPPRF34485",75,16,47,22,27,61,20,25,"Pilot 8","Pilot 8: max feedback + text"
14,"SUPPRF34485",47,3,29,-16,0,58,29,45,"Pilot 8","Pilot 8: max feedback + text"
15,"SUPPRF34485",33,7,33,-19,-13,53,46,52,"Pilot 8","Pilot 8: max feedback + text"
16,"SUPPRF34485",54,14,38,2,-16,33,54,36,"Pilot 8","Pilot 8: max feedback + text"
17,"SUPPRF34485",52,16,46,-1,0,63,46,47,"Pilot 8","Pilot 8: max feedback + text"
18,"SUPPRF34485",61,2,71,13,0,49,71,58,"Pilot 8","Pilot 8: max feedback + text"
19,"SUPPRF34485",77,9,83,20,12,55,71,63,"Pilot 8","Pilot 8: max feedback + text"
20,"SUPPRF34485",65,13,75,18,29,55,46,57,"Pilot 8","Pilot 8: max feedback + text"
21,"SUPPRF34485",44,3,28,-36,-1,58,29,64,"Pilot 8","Pilot 8: max feedback + text"
22,"SUPPRF34485",65,27,58,-6,12,58,46,64,"Pilot 8","Pilot 8: max feedback + text"
23,"SUPPRF34485",64,20,34,-20,-12,72,46,54,"Pilot 8","Pilot 8: max feedback + text"
24,"SUPPRF34485",30,21,22,-40,-15,49,37,62,"Pilot 8","Pilot 8: max feedback + text"
25,"SUPPRF34485",70,14,58,30,29,46,29,28,"Pilot 8","Pilot 8: max feedback + text"
26,"SUPPRF34485",60,49,61,27,24,55,37,34,"Pilot 8","Pilot 8: max feedback + text"
27,"SUPPRF34485",65,23,68,-27,-12,66,80,95,"Pilot 8","Pilot 8: max feedback + text"
28,"SUPPRF34485",64,19,35,13,15,37,20,22,"Pilot 8","Pilot 8: max feedback + text"
29,"SUPPRF34485",68,27,49,10,12,56,37,39,"Pilot 8","Pilot 8: max feedback + text"
30,"SUPPRF34485",32,56,50,-12,-13,55,63,62,"Pilot 8","Pilot 8: max feedback + text"
31,"SUPPRF34485",67,25,100,41,20,33,80,59,"Pilot 8","Pilot 8: max feedback + text"
32,"SUPPRF34485",66,27,6,-33,-14,52,20,39,"Pilot 8","Pilot 8: max feedback + text"
33,"SUPPRF34485",67,22,56,32,-15,57,71,24,"Pilot 8","Pilot 8: max feedback + text"
34,"SUPPRF34485",69,27,55,11,1,59,54,44,"Pilot 8","Pilot 8: max feedback + text"
35,"SUPPRF34485",67,33,78,21,24,38,54,57,"Pilot 8","Pilot 8: max feedback + text"
36,"SUPPRF34485",49,15,47,-22,-16,55,63,69,"Pilot 8","Pilot 8: max feedback + text"
37,"SUPPRF34485",75,31,96,11,16,69,80,85,"Pilot 8","Pilot 8: max feedback + text"
38,"SUPPRF34485",61,18,54,-13,0,58,54,67,"Pilot 8","Pilot 8: max feedback + text"
39,"SUPPRF34485",69,33,45,-7,-1,65,46,52,"Pilot 8","Pilot 8: max feedback + text"
40,"SUPPRF34485",44,6,55,-20,-16,66,71,75,"Pilot 8","Pilot 8: max feedback + text"
41,"SUPPRF34485",51,72,16,-41,-13,47,29,57,"Pilot 8","Pilot 8: max feedback + text"
42,"SUPPRF34485",48,17,77,26,14,43,63,51,"Pilot 8","Pilot 8: max feedback + text"
43,"SUPPRF34485",23,42,62,-9,-1,65,63,71,"Pilot 8","Pilot 8: max feedback + text"
44,"SUPPRF34485",52,28,37,-5,0,25,37,42,"Pilot 8","Pilot 8: max feedback + text"
45,"SUPPRF34485",59,14,70,5,-1,60,71,65,"Pilot 8","Pilot 8: max feedback + text"
46,"SUPPRF34485",31,29,41,-8,-13,62,54,49,"Pilot 8","Pilot 8: max feedback + text"
47,"SUPPRF34485",31,28,15,-20,-14,49,29,35,"Pilot 8","Pilot 8: max feedback + text"
48,"SUPPRF34485",40,25,24,-8,-13,61,37,32,"Pilot 8","Pilot 8: max feedback + text"
1,"SUPPRF79962",36,0,8,-17,-12,72,20,25,"Pilot 8","Pilot 8: max feedback + text"
2,"SUPPRF79962",34,0,15,-15,-14,77,29,30,"Pilot 8","Pilot 8: max feedback + text"
3,"SUPPRF79962",34,0,55,-11,-16,61,71,66,"Pilot 8","Pilot 8: max feedback + text"
4,"SUPPRF79962",33,0,22,5,-15,0,37,17,"Pilot 8","Pilot 8: max feedback + text"
5,"SUPPRF79962",27,0,24,3,-13,61,37,21,"Pilot 8","Pilot 8: max feedback + text"
6,"SUPPRF79962",30,0,6,-15,-14,7,20,21,"Pilot 8","Pilot 8: max feedback + text"
7,"SUPPRF79962",32,0,88,20,25,63,63,68,"Pilot 8","Pilot 8: max feedback + text"
8,"SUPPRF79962",32,0,37,4,0,84,37,33,"Pilot 8","Pilot 8: max feedback + text"
9,"SUPPRF79962",31,0,29,-29,0,5,29,58,"Pilot 8","Pilot 8: max feedback + text"
10,"SUPPRF79962",29,0,67,21,-13,0,80,46,"Pilot 8","Pilot 8: max feedback + text"
11,"SUPPRF79962",29,0,41,-14,-13,60,54,55,"Pilot 8","Pilot 8: max feedback + text"
12,"SUPPRF79962",32,0,77,77,14,0,63,0,"Pilot 8","Pilot 8: max feedback + text"
13,"SUPPRF79962",39,0,78,27,24,36,54,51,"Pilot 8","Pilot 8: max feedback + text"
14,"SUPPRF79962",32,0,55,-4,1,55,54,59,"Pilot 8","Pilot 8: max feedback + text"
15,"SUPPRF79962",29,0,49,-1,12,27,37,50,"Pilot 8","Pilot 8: max feedback + text"
16,"SUPPRF79962",34,0,45,19,-1,62,46,26,"Pilot 8","Pilot 8: max feedback + text"
17,"SUPPRF79962",32,0,58,29,29,61,29,29,"Pilot 8","Pilot 8: max feedback + text"
18,"SUPPRF79962",27,0,47,10,-16,21,63,37,"Pilot 8","Pilot 8: max feedback + text"
19,"SUPPRF79962",33,0,96,24,16,78,80,72,"Pilot 8","Pilot 8: max feedback + text"
20,"SUPPRF79962",30,0,19,-1,-1,81,20,20,"Pilot 8","Pilot 8: max feedback + text"
21,"SUPPRF79962",33,0,71,1,0,71,71,70,"Pilot 8","Pilot 8: max feedback + text"
22,"SUPPRF79962",29,0,16,-16,-13,20,29,32,"Pilot 8","Pilot 8: max feedback + text"
23,"SUPPRF79962",34,0,100,16,20,83,80,84,"Pilot 8","Pilot 8: max feedback + text"
24,"SUPPRF79962",37,0,80,0,0,68,80,80,"Pilot 8","Pilot 8: max feedback + text"
25,"SUPPRF79962",30,0,68,-12,-12,61,80,80,"Pilot 8","Pilot 8: max feedback + text"
26,"SUPPRF79962",31,0,33,-12,-13,72,46,45,"Pilot 8","Pilot 8: max feedback + text"
27,"SUPPRF79962",35,0,38,-17,-16,68,54,55,"Pilot 8","Pilot 8: max feedback + text"
28,"SUPPRF79962",32,0,66,12,12,67,54,54,"Pilot 8","Pilot 8: max feedback + text"
29,"SUPPRF79962",29,0,58,18,12,16,46,40,"Pilot 8","Pilot 8: max feedback + text"
30,"SUPPRF79962",20,0,47,22,27,70,20,25,"Pilot 8","Pilot 8: max feedback + text"
31,"SUPPRF79962",17,0,34,-8,-12,70,46,42,"Pilot 8","Pilot 8: max feedback + text"
32,"SUPPRF79962",20,0,46,1,0,61,46,45,"Pilot 8","Pilot 8: max feedback + text"
33,"SUPPRF79962",24,0,46,20,17,77,29,26,"Pilot 8","Pilot 8: max feedback + text"
34,"SUPPRF79962",19,0,28,5,-1,65,29,23,"Pilot 8","Pilot 8: max feedback + text"
35,"SUPPRF79962",19,1,54,-6,0,67,54,60,"Pilot 8","Pilot 8: max feedback + text"
36,"SUPPRF79962",16,0,75,27,29,70,46,48,"Pilot 8","Pilot 8: max feedback + text"
37,"SUPPRF79962",16,0,62,15,-1,63,63,47,"Pilot 8","Pilot 8: max feedback + text"
38,"SUPPRF79962",17,0,70,-3,-1,80,71,73,"Pilot 8","Pilot 8: max feedback + text"
39,"SUPPRF79962",15,0,61,16,24,30,37,45,"Pilot 8","Pilot 8: max feedback + text"
40,"SUPPRF79962",17,0,20,-1,0,66,20,21,"Pilot 8","Pilot 8: max feedback + text"
41,"SUPPRF79962",14,0,81,53,1,32,80,28,"Pilot 8","Pilot 8: max feedback + text"
42,"SUPPRF79962",12,0,50,-18,-13,62,63,68,"Pilot 8","Pilot 8: max feedback + text"
43,"SUPPRF79962",12,0,56,-9,-15,79,71,65,"Pilot 8","Pilot 8: max feedback + text"
44,"SUPPRF79962",10,4,94,71,23,7,71,23,"Pilot 8","Pilot 8: max feedback + text"
45,"SUPPRF79962",16,0,38,-19,1,20,37,57,"Pilot 8","Pilot 8: max feedback + text"
46,"SUPPRF79962",11,0,83,12,12,32,71,71,"Pilot 8","Pilot 8: max feedback + text"
47,"SUPPRF79962",13,0,63,-1,0,36,63,64,"Pilot 8","Pilot 8: max feedback + text"
48,"SUPPRF79962",12,0,35,21,15,27,20,14,"Pilot 8","Pilot 8: max feedback + text"
1,"SUPPRF00818",71,0,78,25,24,63,54,53,"Pilot 8","Pilot 8: max feedback + text"
2,"SUPPRF00818",70,0,37,-3,0,63,37,40,"Pilot 8","Pilot 8: max feedback + text"
3,"SUPPRF00818",61,2,22,-13,-15,77,37,35,"Pilot 8","Pilot 8: max feedback + text"
4,"SUPPRF00818",66,0,29,4,0,73,29,25,"Pilot 8","Pilot 8: max feedback + text"
5,"SUPPRF00818",68,2,49,27,12,77,37,22,"Pilot 8","Pilot 8: max feedback + text"
6,"SUPPRF00818",70,0,71,44,0,89,71,27,"Pilot 8","Pilot 8: max feedback + text"
7,"SUPPRF00818",66,1,24,-11,-13,82,37,35,"Pilot 8","Pilot 8: max feedback + text"
8,"SUPPRF00818",75,0,96,23,16,78,80,73,"Pilot 8","Pilot 8: max feedback + text"
9,"SUPPRF00818",67,0,15,-10,-14,70,29,25,"Pilot 8","Pilot 8: max feedback + text"
10,"SUPPRF00818",65,0,16,-11,-13,66,29,27,"Pilot 8","Pilot 8: max feedback + text"
11,"SUPPRF00818",71,0,80,4,0,73,80,76,"Pilot 8","Pilot 8: max feedback + text"
12,"SUPPRF00818",73,1,38,13,1,79,37,25,"Pilot 8","Pilot 8: max feedback + text"
13,"SUPPRF00818",57,0,38,-11,-16,69,54,49,"Pilot 8","Pilot 8: max feedback + text"
14,"SUPPRF00818",53,0,6,-7,-14,65,20,13,"Pilot 8","Pilot 8: max feedback + text"
15,"SUPPRF00818",69,0,58,28,12,54,46,30,"Pilot 8","Pilot 8: max feedback + text"
16,"SUPPRF00818",74,0,70,-1,-1,73,71,71,"Pilot 8","Pilot 8: max feedback + text"
17,"SUPPRF00818",71,0,46,16,0,70,46,30,"Pilot 8","Pilot 8: max feedback + text"
18,"SUPPRF00818",74,0,66,7,12,77,54,59,"Pilot 8","Pilot 8: max feedback + text"
19,"SUPPRF00818",66,1,28,-6,-1,45,29,34,"Pilot 8","Pilot 8: max feedback + text"
20,"SUPPRF00818",72,0,61,24,24,72,37,37,"Pilot 8","Pilot 8: max feedback + text"
21,"SUPPRF00818",76,2,47,35,27,65,20,12,"Pilot 8","Pilot 8: max feedback + text"
22,"SUPPRF00818",63,0,55,17,1,64,54,38,"Pilot 8","Pilot 8: max feedback + text"
23,"SUPPRF00818",72,0,41,4,-13,64,54,37,"Pilot 8","Pilot 8: max feedback + text"
24,"SUPPRF00818",66,0,35,18,15,59,20,17,"Pilot 8","Pilot 8: max feedback + text"
25,"SUPPRF00818",72,0,54,13,0,52,54,41,"Pilot 8","Pilot 8: max feedback + text"
26,"SUPPRF00818",78,0,45,1,-1,45,46,44,"Pilot 8","Pilot 8: max feedback + text"
27,"SUPPRF00818",65,0,56,-7,-15,65,71,63,"Pilot 8","Pilot 8: max feedback + text"
28,"SUPPRF00818",89,0,75,34,29,78,46,41,"Pilot 8","Pilot 8: max feedback + text"
29,"SUPPRF00818",76,2,77,42,14,50,63,35,"Pilot 8","Pilot 8: max feedback + text"
30,"SUPPRF00818",65,0,20,8,0,59,20,12,"Pilot 8","Pilot 8: max feedback + text"
31,"SUPPRF00818",71,0,68,2,-12,68,80,66,"Pilot 8","Pilot 8: max feedback + text"
32,"SUPPRF00818",66,0,33,9,-13,49,46,24,"Pilot 8","Pilot 8: max feedback + text"
33,"SUPPRF00818",66,0,50,5,-13,69,63,45,"Pilot 8","Pilot 8: max feedback + text"
34,"SUPPRF00818",72,0,83,17,12,74,71,66,"Pilot 8","Pilot 8: max feedback + text"
35,"SUPPRF00818",72,0,19,2,-1,75,20,17,"Pilot 8","Pilot 8: max feedback + text"
36,"SUPPRF00818",74,0,46,13,17,67,29,33,"Pilot 8","Pilot 8: max feedback + text"
37,"SUPPRF00818",82,0,100,28,20,72,80,72,"Pilot 8","Pilot 8: max feedback + text"
38,"SUPPRF00818",75,0,81,10,1,75,80,71,"Pilot 8","Pilot 8: max feedback + text"
39,"SUPPRF00818",82,0,63,22,0,48,63,41,"Pilot 8","Pilot 8: max feedback + text"
40,"SUPPRF00818",71,0,47,-5,-16,52,63,52,"Pilot 8","Pilot 8: max feedback + text"
41,"SUPPRF00818",71,0,67,16,-13,40,80,51,"Pilot 8","Pilot 8: max feedback + text"
42,"SUPPRF00818",82,0,55,6,-16,58,71,49,"Pilot 8","Pilot 8: max feedback + text"
43,"SUPPRF00818",72,0,58,19,29,49,29,39,"Pilot 8","Pilot 8: max feedback + text"
44,"SUPPRF00818",59,1,34,-10,-12,60,46,44,"Pilot 8","Pilot 8: max feedback + text"
45,"SUPPRF00818",70,0,8,-1,-12,62,20,9,"Pilot 8","Pilot 8: max feedback + text"
46,"SUPPRF00818",80,0,88,44,25,67,63,44,"Pilot 8","Pilot 8: max feedback + text"
47,"SUPPRF00818",89,0,94,66,23,67,71,28,"Pilot 8","Pilot 8: max feedback + text"
48,"SUPPRF00818",75,0,62,15,-1,46,63,47,"Pilot 8","Pilot 8: max feedback + text"
1,"SUPPRF44058",69,65,81,62,1,71,80,19,"Pilot 8","Pilot 8: max feedback + text"
2,"SUPPRF44058",48,50,50,10,-13,84,63,40,"Pilot 8","Pilot 8: max feedback + text"
3,"SUPPRF44058",48,48,19,-21,-1,39,20,40,"Pilot 8","Pilot 8: max feedback + text"
4,"SUPPRF44058",68,51,16,-47,-13,65,29,63,"Pilot 8","Pilot 8: max feedback + text"
5,"SUPPRF44058",49,48,29,-31,0,62,29,60,"Pilot 8","Pilot 8: max feedback + text"
6,"SUPPRF44058",50,51,78,45,24,52,54,33,"Pilot 8","Pilot 8: max feedback + text"
7,"SUPPRF44058",50,50,47,37,-16,83,63,10,"Pilot 8","Pilot 8: max feedback + text"
8,"SUPPRF44058",51,51,66,54,12,86,54,12,"Pilot 8","Pilot 8: max feedback + text"
9,"SUPPRF44058",50,51,96,46,16,51,80,50,"Pilot 8","Pilot 8: max feedback + text"
10,"SUPPRF44058",53,54,83,71,12,20,71,12,"Pilot 8","Pilot 8: max feedback + text"
11,"SUPPRF44058",63,32,94,78,23,20,71,16,"Pilot 8","Pilot 8: max feedback + text"
12,"SUPPRF44058",52,52,54,37,0,34,54,17,"Pilot 8","Pilot 8: max feedback + text"
13,"SUPPRF44058",50,54,46,27,0,36,46,19,"Pilot 8","Pilot 8: max feedback + text"
14,"SUPPRF44058",50,50,33,-18,-13,51,46,51,"Pilot 8","Pilot 8: max feedback + text"
15,"SUPPRF44058",52,51,55,3,1,50,54,52,"Pilot 8","Pilot 8: max feedback + text"
16,"SUPPRF44058",51,53,67,35,-13,49,80,32,"Pilot 8","Pilot 8: max feedback + text"
17,"SUPPRF44058",51,54,45,-8,-1,52,46,53,"Pilot 8","Pilot 8: max feedback + text"
18,"SUPPRF44058",49,52,38,-13,1,50,37,51,"Pilot 8","Pilot 8: max feedback + text"
19,"SUPPRF44058",50,52,88,38,25,51,63,50,"Pilot 8","Pilot 8: max feedback + text"
20,"SUPPRF44058",51,50,46,-6,17,51,29,52,"Pilot 8","Pilot 8: max feedback + text"
21,"SUPPRF44058",51,52,71,48,0,29,71,23,"Pilot 8","Pilot 8: max feedback + text"
22,"SUPPRF44058",52,51,77,-13,14,91,63,90,"Pilot 8","Pilot 8: max feedback + text"
23,"SUPPRF44058",48,51,80,29,0,52,80,51,"Pilot 8","Pilot 8: max feedback + text"
24,"SUPPRF44058",49,52,62,28,-1,50,63,34,"Pilot 8","Pilot 8: max feedback + text"
25,"SUPPRF44058",75,43,28,-3,-1,36,29,31,"Pilot 8","Pilot 8: max feedback + text"
26,"SUPPRF44058",52,49,34,-3,-12,34,46,37,"Pilot 8","Pilot 8: max feedback + text"
27,"SUPPRF44058",47,49,37,-12,0,51,37,49,"Pilot 8","Pilot 8: max feedback + text"
28,"SUPPRF44058",46,50,35,-30,15,66,20,65,"Pilot 8","Pilot 8: max feedback + text"
29,"SUPPRF44058",52,51,63,22,0,39,63,41,"Pilot 8","Pilot 8: max feedback + text"
30,"SUPPRF44058",50,51,56,8,-15,50,71,48,"Pilot 8","Pilot 8: max feedback + text"
31,"SUPPRF44058",45,43,15,-9,-14,24,29,24,"Pilot 8","Pilot 8: max feedback + text"
32,"SUPPRF44058",52,50,100,59,20,39,80,41,"Pilot 8","Pilot 8: max feedback + text"
33,"SUPPRF44058",52,50,6,-43,-14,49,20,49,"Pilot 8","Pilot 8: max feedback + text"
34,"SUPPRF44058",47,47,68,18,-12,51,80,50,"Pilot 8","Pilot 8: max feedback + text"
35,"SUPPRF44058",49,51,70,31,-1,36,71,39,"Pilot 8","Pilot 8: max feedback + text"
36,"SUPPRF44058",48,50,20,-15,0,30,20,35,"Pilot 8","Pilot 8: max feedback + text"
37,"SUPPRF44058",47,49,49,30,12,16,37,19,"Pilot 8","Pilot 8: max feedback + text"
38,"SUPPRF44058",53,53,55,11,-16,51,71,44,"Pilot 8","Pilot 8: max feedback + text"
39,"SUPPRF44058",52,52,58,-8,12,65,46,66,"Pilot 8","Pilot 8: max feedback + text"
40,"SUPPRF44058",51,50,75,35,29,43,46,40,"Pilot 8","Pilot 8: max feedback + text"
41,"SUPPRF44058",51,50,58,8,29,50,29,50,"Pilot 8","Pilot 8: max feedback + text"
42,"SUPPRF44058",51,51,22,-23,-15,37,37,45,"Pilot 8","Pilot 8: max feedback + text"
43,"SUPPRF44058",51,52,61,11,24,51,37,50,"Pilot 8","Pilot 8: max feedback + text"
44,"SUPPRF44058",48,48,38,-12,-16,50,54,50,"Pilot 8","Pilot 8: max feedback + text"
45,"SUPPRF44058",39,40,8,-41,-12,50,20,49,"Pilot 8","Pilot 8: max feedback + text"
46,"SUPPRF44058",50,49,24,-25,-13,51,37,49,"Pilot 8","Pilot 8: max feedback + text"
47,"SUPPRF44058",49,52,47,32,27,19,20,15,"Pilot 8","Pilot 8: max feedback + text"
48,"SUPPRF44058",45,49,41,-8,-13,51,54,49,"Pilot 8","Pilot 8: max feedback + text"
1,"SUPPRF69688",66,22,29,3,0,54,29,26,"Pilot 8","Pilot 8: max feedback + text"
2,"SUPPRF69688",63,30,47,-16,-16,57,63,63,"Pilot 8","Pilot 8: max feedback + text"
3,"SUPPRF69688",65,27,46,13,0,60,46,33,"Pilot 8","Pilot 8: max feedback + text"
4,"SUPPRF69688",56,35,24,-8,-13,59,37,32,"Pilot 8","Pilot 8: max feedback + text"
5,"SUPPRF69688",55,36,55,-7,-16,61,71,62,"Pilot 8","Pilot 8: max feedback + text"
6,"SUPPRF69688",56,33,56,-3,-15,42,71,59,"Pilot 8","Pilot 8: max feedback + text"
7,"SUPPRF69688",53,40,15,-8,-14,46,29,23,"Pilot 8","Pilot 8: max feedback + text"
8,"SUPPRF69688",67,30,80,12,0,50,80,68,"Pilot 8","Pilot 8: max feedback + text"
9,"SUPPRF69688",56,40,28,5,-1,45,29,23,"Pilot 8","Pilot 8: max feedback + text"
10,"SUPPRF69688",63,36,55,15,1,45,54,40,"Pilot 8","Pilot 8: max feedback + text"
11,"SUPPRF69688",73,26,35,21,15,49,20,14,"Pilot 8","Pilot 8: max feedback + text"
12,"SUPPRF69688",72,23,100,28,20,47,80,72,"Pilot 8","Pilot 8: max feedback + text"
13,"SUPPRF69688",52,46,63,5,0,24,63,58,"Pilot 8","Pilot 8: max feedback + text"
14,"SUPPRF69688",61,28,50,-7,-13,44,63,57,"Pilot 8","Pilot 8: max feedback + text"
15,"SUPPRF69688",63,23,61,28,24,51,37,33,"Pilot 8","Pilot 8: max feedback + text"
16,"SUPPRF69688",61,32,38,-7,-16,50,54,45,"Pilot 8","Pilot 8: max feedback + text"
17,"SUPPRF69688",68,25,70,6,-1,50,71,64,"Pilot 8","Pilot 8: max feedback + text"
18,"SUPPRF69688",29,65,41,2,-13,33,54,39,"Pilot 8","Pilot 8: max feedback + text"
19,"SUPPRF69688",60,29,67,15,-13,37,80,52,"Pilot 8","Pilot 8: max feedback + text"
20,"SUPPRF69688",64,34,71,10,0,56,71,61,"Pilot 8","Pilot 8: max feedback + text"
21,"SUPPRF69688",60,33,75,28,29,51,46,47,"Pilot 8","Pilot 8: max feedback + text"
22,"SUPPRF69688",69,27,83,17,12,40,71,66,"Pilot 8","Pilot 8: max feedback + text"
23,"SUPPRF69688",58,51,58,38,29,47,29,20,"Pilot 8","Pilot 8: max feedback + text"
24,"SUPPRF69688",50,56,20,4,0,48,20,16,"Pilot 8","Pilot 8: max feedback + text"
25,"SUPPRF69688",49,53,47,24,27,52,20,23,"Pilot 8","Pilot 8: max feedback + text"
26,"SUPPRF69688",62,52,49,29,12,46,37,20,"Pilot 8","Pilot 8: max feedback + text"
27,"SUPPRF69688",45,51,78,39,24,37,54,39,"Pilot 8","Pilot 8: max feedback + text"
28,"SUPPRF69688",48,45,96,26,16,51,80,70,"Pilot 8","Pilot 8: max feedback + text"
29,"SUPPRF69688",48,49,54,18,0,47,54,36,"Pilot 8","Pilot 8: max feedback + text"
30,"SUPPRF69688",45,55,16,0,-13,38,29,16,"Pilot 8","Pilot 8: max feedback + text"
31,"SUPPRF69688",43,54,6,-14,-14,50,20,20,"Pilot 8","Pilot 8: max feedback + text"
32,"SUPPRF69688",48,49,81,6,1,50,80,75,"Pilot 8","Pilot 8: max feedback + text"
33,"SUPPRF69688",49,47,19,2,-1,44,20,17,"Pilot 8","Pilot 8: max feedback + text"
34,"SUPPRF69688",46,47,33,-9,-13,49,46,42,"Pilot 8","Pilot 8: max feedback + text"
35,"SUPPRF69688",50,48,58,13,12,50,46,45,"Pilot 8","Pilot 8: max feedback + text"
36,"SUPPRF69688",49,47,94,30,23,49,71,64,"Pilot 8","Pilot 8: max feedback + text"
37,"SUPPRF69688",49,48,62,11,-1,49,63,51,"Pilot 8","Pilot 8: max feedback + text"
38,"SUPPRF69688",48,49,68,2,-12,46,80,66,"Pilot 8","Pilot 8: max feedback + text"
39,"SUPPRF69688",50,48,66,18,12,49,54,48,"Pilot 8","Pilot 8: max feedback + text"
40,"SUPPRF69688",48,48,88,25,25,49,63,63,"Pilot 8","Pilot 8: max feedback + text"
41,"SUPPRF69688",48,48,45,4,-1,47,46,41,"Pilot 8","Pilot 8: max feedback + text"
42,"SUPPRF69688",50,49,37,6,0,48,37,31,"Pilot 8","Pilot 8: max feedback + text"
43,"SUPPRF69688",50,49,38,-6,1,29,37,44,"Pilot 8","Pilot 8: max feedback + text"
44,"SUPPRF69688",48,48,8,-10,-12,47,20,18,"Pilot 8","Pilot 8: max feedback + text"
45,"SUPPRF69688",48,47,77,34,14,48,63,43,"Pilot 8","Pilot 8: max feedback + text"
46,"SUPPRF69688",47,49,46,27,17,48,29,19,"Pilot 8","Pilot 8: max feedback + text"
47,"SUPPRF69688",49,49,34,-11,-12,48,46,45,"Pilot 8","Pilot 8: max feedback + text"
48,"SUPPRF69688",48,48,22,-15,-15,50,37,37,"Pilot 8","Pilot 8: max feedback + text"
1,"SUPPRF14681",60,74,88,64,25,68,63,24,"Pilot 8","Pilot 8: max feedback + text"
2,"SUPPRF14681",50,78,49,-2,12,57,37,51,"Pilot 8","Pilot 8: max feedback + text"
3,"SUPPRF14681",66,63,61,35,24,47,37,26,"Pilot 8","Pilot 8: max feedback + text"
4,"SUPPRF14681",51,91,34,-3,-12,54,46,37,"Pilot 8","Pilot 8: max feedback + text"
5,"SUPPRF14681",51,73,62,14,-1,69,63,48,"Pilot 8","Pilot 8: max feedback + text"
6,"SUPPRF14681",57,82,71,40,0,20,71,31,"Pilot 8","Pilot 8: max feedback + text"
7,"SUPPRF14681",63,72,83,32,12,21,71,51,"Pilot 8","Pilot 8: max feedback + text"
8,"SUPPRF14681",57,74,46,14,0,69,46,32,"Pilot 8","Pilot 8: max feedback + text"
9,"SUPPRF14681",54,72,78,20,24,27,54,58,"Pilot 8","Pilot 8: max feedback + text"
10,"SUPPRF14681",57,76,46,26,17,86,29,20,"Pilot 8","Pilot 8: max feedback + text"
11,"SUPPRF14681",31,88,16,-22,-13,49,29,38,"Pilot 8","Pilot 8: max feedback + text"
12,"SUPPRF14681",52,80,29,20,0,90,29,9,"Pilot 8","Pilot 8: max feedback + text"
13,"SUPPRF14681",54,56,75,45,29,89,46,30,"Pilot 8","Pilot 8: max feedback + text"
14,"SUPPRF14681",52,60,47,30,27,87,20,17,"Pilot 8","Pilot 8: max feedback + text"
15,"SUPPRF14681",49,89,77,44,14,55,63,33,"Pilot 8","Pilot 8: max feedback + text"
16,"SUPPRF14681",51,79,58,27,29,13,29,31,"Pilot 8","Pilot 8: max feedback + text"
17,"SUPPRF14681",23,94,67,-8,-13,8,80,75,"Pilot 8","Pilot 8: max feedback + text"
18,"SUPPRF14681",53,50,35,27,15,89,20,8,"Pilot 8","Pilot 8: max feedback + text"
19,"SUPPRF14681",48,87,19,0,-1,96,20,19,"Pilot 8","Pilot 8: max feedback + text"
20,"SUPPRF14681",53,76,20,1,0,79,20,19,"Pilot 8","Pilot 8: max feedback + text"
21,"SUPPRF14681",50,80,68,0,-12,42,80,68,"Pilot 8","Pilot 8: max feedback + text"
22,"SUPPRF14681",13,98,38,30,-16,93,54,8,"Pilot 8","Pilot 8: max feedback + text"
23,"SUPPRF14681",28,74,15,-16,-14,91,29,31,"Pilot 8","Pilot 8: max feedback + text"
24,"SUPPRF14681",51,81,50,12,-13,64,63,38,"Pilot 8","Pilot 8: max feedback + text"
25,"SUPPRF14681",31,75,24,-7,-13,21,37,31,"Pilot 8","Pilot 8: max feedback + text"
26,"SUPPRF14681",51,83,47,7,-16,55,63,40,"Pilot 8","Pilot 8: max feedback + text"
27,"SUPPRF14681",46,65,55,12,1,71,54,43,"Pilot 8","Pilot 8: max feedback + text"
28,"SUPPRF14681",32,59,66,38,12,19,54,28,"Pilot 8","Pilot 8: max feedback + text"
29,"SUPPRF14681",67,65,22,-7,-15,78,37,29,"Pilot 8","Pilot 8: max feedback + text"
30,"SUPPRF14681",49,63,70,17,-1,80,71,53,"Pilot 8","Pilot 8: max feedback + text"
31,"SUPPRF14681",57,53,55,1,-16,71,71,54,"Pilot 8","Pilot 8: max feedback + text"
32,"SUPPRF14681",74,75,45,29,-1,99,46,16,"Pilot 8","Pilot 8: max feedback + text"
33,"SUPPRF14681",82,58,58,26,12,82,46,32,"Pilot 8","Pilot 8: max feedback + text"
34,"SUPPRF14681",52,74,56,-2,-15,45,71,58,"Pilot 8","Pilot 8: max feedback + text"
35,"SUPPRF14681",58,52,54,22,0,72,54,32,"Pilot 8","Pilot 8: max feedback + text"
36,"SUPPRF14681",82,73,63,10,0,18,63,53,"Pilot 8","Pilot 8: max feedback + text"
37,"SUPPRF14681",83,50,94,45,23,81,71,49,"Pilot 8","Pilot 8: max feedback + text"
38,"SUPPRF14681",49,57,33,2,-13,87,46,31,"Pilot 8","Pilot 8: max feedback + text"
39,"SUPPRF14681",77,56,28,6,-1,77,29,22,"Pilot 8","Pilot 8: max feedback + text"
40,"SUPPRF14681",53,72,81,25,1,58,80,56,"Pilot 8","Pilot 8: max feedback + text"
41,"SUPPRF14681",52,72,80,50,0,7,80,30,"Pilot 8","Pilot 8: max feedback + text"
42,"SUPPRF14681",42,70,38,21,1,10,37,17,"Pilot 8","Pilot 8: max feedback + text"
43,"SUPPRF14681",67,50,8,-7,-12,94,20,15,"Pilot 8","Pilot 8: max feedback + text"
44,"SUPPRF14681",91,67,96,45,16,85,80,51,"Pilot 8","Pilot 8: max feedback + text"
45,"SUPPRF14681",36,54,41,-6,-13,75,54,47,"Pilot 8","Pilot 8: max feedback + text"
46,"SUPPRF14681",92,17,100,35,20,22,80,65,"Pilot 8","Pilot 8: max feedback + text"
47,"SUPPRF14681",55,74,37,17,0,93,37,20,"Pilot 8","Pilot 8: max feedback + text"
48,"SUPPRF14681",74,91,6,2,-14,9,20,4,"Pilot 8","Pilot 8: max feedback + text"
1,"SUPPRF28831",62,15,34,-11,-12,66,46,45,"Pilot 8","Pilot 8: max feedback + text"
2,"SUPPRF28831",60,15,35,15,15,70,20,20,"Pilot 8","Pilot 8: max feedback + text"
3,"SUPPRF28831",58,17,47,13,27,76,20,34,"Pilot 8","Pilot 8: max feedback + text"
4,"SUPPRF28831",73,13,83,5,12,75,71,78,"Pilot 8","Pilot 8: max feedback + text"
5,"SUPPRF28831",69,0,94,20,23,72,71,74,"Pilot 8","Pilot 8: max feedback + text"
6,"SUPPRF28831",66,0,66,-5,12,78,54,71,"Pilot 8","Pilot 8: max feedback + text"
7,"SUPPRF28831",66,0,33,-13,-13,32,46,46,"Pilot 8","Pilot 8: max feedback + text"
8,"SUPPRF28831",70,0,88,18,25,49,63,70,"Pilot 8","Pilot 8: max feedback + text"
9,"SUPPRF28831",57,0,67,-12,-13,77,80,79,"Pilot 8","Pilot 8: max feedback + text"
10,"SUPPRF28831",67,0,20,0,0,0,20,20,"Pilot 8","Pilot 8: max feedback + text"
11,"SUPPRF28831",76,0,62,-5,-1,23,63,67,"Pilot 8","Pilot 8: max feedback + text"
12,"SUPPRF28831",66,0,61,36,24,100,37,25,"Pilot 8","Pilot 8: max feedback + text"
13,"SUPPRF28831",65,0,24,-17,-13,75,37,41,"Pilot 8","Pilot 8: max feedback + text"
14,"SUPPRF28831",64,3,47,-28,-16,94,63,75,"Pilot 8","Pilot 8: max feedback + text"
15,"SUPPRF28831",69,0,55,-13,-16,50,71,68,"Pilot 8","Pilot 8: max feedback + text"
16,"SUPPRF28831",64,0,50,-23,-13,72,63,73,"Pilot 8","Pilot 8: max feedback + text"
17,"SUPPRF28831",60,0,22,-46,-15,0,37,68,"Pilot 8","Pilot 8: max feedback + text"
18,"SUPPRF28831",68,0,68,0,-12,76,80,68,"Pilot 8","Pilot 8: max feedback + text"
19,"SUPPRF28831",72,3,58,-13,29,75,29,71,"Pilot 8","Pilot 8: max feedback + text"
20,"SUPPRF28831",66,0,55,-21,1,72,54,76,"Pilot 8","Pilot 8: max feedback + text"
21,"SUPPRF28831",72,0,75,32,29,10,46,43,"Pilot 8","Pilot 8: max feedback + text"
22,"SUPPRF28831",65,0,54,-17,0,68,54,71,"Pilot 8","Pilot 8: max feedback + text"
23,"SUPPRF28831",67,0,29,23,0,100,29,6,"Pilot 8","Pilot 8: max feedback + text"
24,"SUPPRF28831",70,0,6,-5,-14,73,20,11,"Pilot 8","Pilot 8: max feedback + text"
25,"SUPPRF28831",75,0,96,11,16,16,80,85,"Pilot 8","Pilot 8: max feedback + text"
26,"SUPPRF28831",71,0,56,-19,-15,77,71,75,"Pilot 8","Pilot 8: max feedback + text"
27,"SUPPRF28831",70,0,78,40,24,78,54,38,"Pilot 8","Pilot 8: max feedback + text"
28,"SUPPRF28831",74,0,15,-28,-14,63,29,43,"Pilot 8","Pilot 8: max feedback + text"
29,"SUPPRF28831",70,0,41,-26,-13,74,54,67,"Pilot 8","Pilot 8: max feedback + text"
30,"SUPPRF28831",66,0,63,-3,0,66,63,66,"Pilot 8","Pilot 8: max feedback + text"
31,"SUPPRF28831",63,0,58,20,12,12,46,38,"Pilot 8","Pilot 8: max feedback + text"
32,"SUPPRF28831",66,0,16,-26,-13,78,29,42,"Pilot 8","Pilot 8: max feedback + text"
33,"SUPPRF28831",68,0,71,-8,0,95,71,79,"Pilot 8","Pilot 8: max feedback + text"
34,"SUPPRF28831",81,2,46,21,17,81,29,25,"Pilot 8","Pilot 8: max feedback + text"
35,"SUPPRF28831",67,0,38,-34,-16,74,54,72,"Pilot 8","Pilot 8: max feedback + text"
36,"SUPPRF28831",72,0,19,-11,-1,77,20,30,"Pilot 8","Pilot 8: max feedback + text"
37,"SUPPRF28831",71,0,49,7,12,73,37,42,"Pilot 8","Pilot 8: max feedback + text"
38,"SUPPRF28831",68,0,8,-20,-12,80,20,28,"Pilot 8","Pilot 8: max feedback + text"
39,"SUPPRF28831",70,0,28,2,-1,76,29,26,"Pilot 8","Pilot 8: max feedback + text"
40,"SUPPRF28831",67,0,70,-10,-1,87,71,80,"Pilot 8","Pilot 8: max feedback + text"
41,"SUPPRF28831",74,0,45,-4,-1,84,46,49,"Pilot 8","Pilot 8: max feedback + text"
42,"SUPPRF28831",66,0,38,38,1,0,37,0,"Pilot 8","Pilot 8: max feedback + text"
43,"SUPPRF28831",76,0,77,18,14,75,63,59,"Pilot 8","Pilot 8: max feedback + text"
44,"SUPPRF28831",70,0,46,-3,0,86,46,49,"Pilot 8","Pilot 8: max feedback + text"
45,"SUPPRF28831",68,0,37,-6,0,87,37,43,"Pilot 8","Pilot 8: max feedback + text"
46,"SUPPRF28831",75,0,80,-4,0,22,80,84,"Pilot 8","Pilot 8: max feedback + text"
47,"SUPPRF28831",76,0,100,13,20,82,80,87,"Pilot 8","Pilot 8: max feedback + text"
48,"SUPPRF28831",74,0,81,3,1,72,80,78,"Pilot 8","Pilot 8: max feedback + text"
1,"SUPPRF77733",53,51,8,-42,-12,50,20,50,"Pilot 8","Pilot 8: max feedback + text"
2,"SUPPRF77733",49,49,38,-25,-16,50,54,63,"Pilot 8","Pilot 8: max feedback + text"
3,"SUPPRF77733",50,50,47,-15,-16,50,63,62,"Pilot 8","Pilot 8: max feedback + text"
4,"SUPPRF77733",51,51,71,21,0,50,71,50,"Pilot 8","Pilot 8: max feedback + text"
5,"SUPPRF77733",50,48,61,-11,24,50,37,72,"Pilot 8","Pilot 8: max feedback + text"
6,"SUPPRF77733",51,53,45,0,-1,50,46,45,"Pilot 8","Pilot 8: max feedback + text"
7,"SUPPRF77733",51,50,34,-13,-12,50,46,47,"Pilot 8","Pilot 8: max feedback + text"
8,"SUPPRF77733",50,48,28,-2,-1,50,29,30,"Pilot 8","Pilot 8: max feedback + text"
9,"SUPPRF77733",50,50,50,5,-13,49,63,45,"Pilot 8","Pilot 8: max feedback + text"
10,"SUPPRF77733",48,48,56,-14,-15,50,71,70,"Pilot 8","Pilot 8: max feedback + text"
11,"SUPPRF77733",49,48,62,2,-1,50,63,60,"Pilot 8","Pilot 8: max feedback + text"
12,"SUPPRF77733",48,48,47,3,27,50,20,44,"Pilot 8","Pilot 8: max feedback + text"
13,"SUPPRF77733",49,47,22,-22,-15,50,37,44,"Pilot 8","Pilot 8: max feedback + text"
14,"SUPPRF77733",48,49,66,22,12,50,54,44,"Pilot 8","Pilot 8: max feedback + text"
15,"SUPPRF77733",50,49,46,-1,0,50,46,47,"Pilot 8","Pilot 8: max feedback + text"
16,"SUPPRF77733",49,48,78,20,24,50,54,58,"Pilot 8","Pilot 8: max feedback + text"
17,"SUPPRF77733",47,49,80,0,0,50,80,80,"Pilot 8","Pilot 8: max feedback + text"
18,"SUPPRF77733",48,48,49,5,12,50,37,44,"Pilot 8","Pilot 8: max feedback + text"
19,"SUPPRF77733",49,49,54,-7,0,50,54,61,"Pilot 8","Pilot 8: max feedback + text"
20,"SUPPRF77733",47,49,58,-2,12,50,46,60,"Pilot 8","Pilot 8: max feedback + text"
21,"SUPPRF77733",49,52,88,23,25,50,63,65,"Pilot 8","Pilot 8: max feedback + text"
22,"SUPPRF77733",50,49,24,-20,-13,50,37,44,"Pilot 8","Pilot 8: max feedback + text"
23,"SUPPRF77733",50,47,46,16,17,50,29,30,"Pilot 8","Pilot 8: max feedback + text"
24,"SUPPRF77733",50,50,100,32,20,50,80,68,"Pilot 8","Pilot 8: max feedback + text"
25,"SUPPRF77733",51,49,70,10,-1,50,71,60,"Pilot 8","Pilot 8: max feedback + text"
26,"SUPPRF77733",50,47,68,-2,-12,50,80,70,"Pilot 8","Pilot 8: max feedback + text"
27,"SUPPRF77733",50,47,83,24,12,50,71,59,"Pilot 8","Pilot 8: max feedback + text"
28,"SUPPRF77733",50,47,41,-19,-13,50,54,60,"Pilot 8","Pilot 8: max feedback + text"
29,"SUPPRF77733",48,45,81,19,1,50,80,62,"Pilot 8","Pilot 8: max feedback + text"
30,"SUPPRF77733",49,49,38,-25,1,50,37,63,"Pilot 8","Pilot 8: max feedback + text"
31,"SUPPRF77733",49,47,75,20,29,50,46,55,"Pilot 8","Pilot 8: max feedback + text"
32,"SUPPRF77733",48,49,96,28,16,50,80,68,"Pilot 8","Pilot 8: max feedback + text"
33,"SUPPRF77733",47,47,67,-11,-13,50,80,78,"Pilot 8","Pilot 8: max feedback + text"
34,"SUPPRF77733",49,49,77,7,14,50,63,70,"Pilot 8","Pilot 8: max feedback + text"
35,"SUPPRF77733",46,48,19,-42,-1,50,20,61,"Pilot 8","Pilot 8: max feedback + text"
36,"SUPPRF77733",50,48,20,-1,0,50,20,21,"Pilot 8","Pilot 8: max feedback + text"
37,"SUPPRF77733",47,47,63,1,0,50,63,62,"Pilot 8","Pilot 8: max feedback + text"
38,"SUPPRF77733",47,48,29,-9,0,50,29,38,"Pilot 8","Pilot 8: max feedback + text"
39,"SUPPRF77733",48,48,6,-28,-14,50,20,34,"Pilot 8","Pilot 8: max feedback + text"
40,"SUPPRF77733",51,50,15,-10,-14,50,29,25,"Pilot 8","Pilot 8: max feedback + text"
41,"SUPPRF77733",47,47,55,-4,1,50,54,59,"Pilot 8","Pilot 8: max feedback + text"
42,"SUPPRF77733",48,47,37,-13,0,28,37,50,"Pilot 8","Pilot 8: max feedback + text"
43,"SUPPRF77733",46,48,33,-6,-13,50,46,39,"Pilot 8","Pilot 8: max feedback + text"
44,"SUPPRF77733",48,47,58,28,29,50,29,30,"Pilot 8","Pilot 8: max feedback + text"
45,"SUPPRF77733",47,49,35,-24,15,50,20,59,"Pilot 8","Pilot 8: max feedback + text"
46,"SUPPRF77733",47,47,94,29,23,50,71,65,"Pilot 8","Pilot 8: max feedback + text"
47,"SUPPRF77733",46,48,55,-17,-16,50,71,72,"Pilot 8","Pilot 8: max feedback + text"
48,"SUPPRF77733",49,48,16,-16,-13,50,29,32,"Pilot 8","Pilot 8: max feedback + text"
1,"SUPPRF28820",51,51,63,13,0,51,63,50,"Pilot 8","Pilot 8: max feedback + text"
2,"SUPPRF28820",50,51,88,38,25,52,63,50,"Pilot 8","Pilot 8: max feedback + text"
3,"SUPPRF28820",48,49,22,-18,-15,72,37,40,"Pilot 8","Pilot 8: max feedback + text"
4,"SUPPRF28820",50,49,81,8,1,62,80,73,"Pilot 8","Pilot 8: max feedback + text"
5,"SUPPRF28820",50,51,47,27,27,82,20,20,"Pilot 8","Pilot 8: max feedback + text"
6,"SUPPRF28820",53,55,45,-7,-1,65,46,52,"Pilot 8","Pilot 8: max feedback + text"
7,"SUPPRF28820",52,52,55,0,-16,62,71,55,"Pilot 8","Pilot 8: max feedback + text"
8,"SUPPRF28820",74,24,71,16,0,60,71,55,"Pilot 8","Pilot 8: max feedback + text"
9,"SUPPRF28820",67,30,66,12,12,58,54,54,"Pilot 8","Pilot 8: max feedback + text"
10,"SUPPRF28820",75,24,46,-14,0,63,46,60,"Pilot 8","Pilot 8: max feedback + text"
11,"SUPPRF28820",69,24,61,11,24,64,37,50,"Pilot 8","Pilot 8: max feedback + text"
12,"SUPPRF28820",74,30,38,-12,1,62,37,50,"Pilot 8","Pilot 8: max feedback + text"
13,"SUPPRF28820",82,12,94,19,23,76,71,75,"Pilot 8","Pilot 8: max feedback + text"
14,"SUPPRF28820",75,25,37,-13,0,33,37,50,"Pilot 8","Pilot 8: max feedback + text"
15,"SUPPRF28820",82,18,78,25,24,62,54,53,"Pilot 8","Pilot 8: max feedback + text"
16,"SUPPRF28820",75,15,8,-42,-12,31,20,50,"Pilot 8","Pilot 8: max feedback + text"
17,"SUPPRF28820",81,18,46,-6,17,57,29,52,"Pilot 8","Pilot 8: max feedback + text"
18,"SUPPRF28820",81,16,16,-49,-13,63,29,65,"Pilot 8","Pilot 8: max feedback + text"
19,"SUPPRF28820",73,20,24,0,-13,52,37,24,"Pilot 8","Pilot 8: max feedback + text"
20,"SUPPRF28820",82,18,28,-3,-1,49,29,31,"Pilot 8","Pilot 8: max feedback + text"
21,"SUPPRF28820",76,12,20,5,0,71,20,15,"Pilot 8","Pilot 8: max feedback + text"
22,"SUPPRF28820",76,17,54,7,0,70,54,47,"Pilot 8","Pilot 8: max feedback + text"
23,"SUPPRF28820",84,14,56,-2,-15,64,71,58,"Pilot 8","Pilot 8: max feedback + text"
24,"SUPPRF28820",84,13,67,-5,-13,74,80,72,"Pilot 8","Pilot 8: max feedback + text"
25,"SUPPRF28820",82,19,80,10,0,55,80,70,"Pilot 8","Pilot 8: max feedback + text"
26,"SUPPRF28820",79,17,83,7,12,63,71,76,"Pilot 8","Pilot 8: max feedback + text"
27,"SUPPRF28820",88,21,15,-12,-14,48,29,27,"Pilot 8","Pilot 8: max feedback + text"
28,"SUPPRF28820",88,16,29,-6,0,56,29,35,"Pilot 8","Pilot 8: max feedback + text"
29,"SUPPRF28820",83,23,34,-19,-12,65,46,53,"Pilot 8","Pilot 8: max feedback + text"
30,"SUPPRF28820",84,15,35,0,15,55,20,35,"Pilot 8","Pilot 8: max feedback + text"
31,"SUPPRF28820",86,11,70,13,-1,52,71,57,"Pilot 8","Pilot 8: max feedback + text"
32,"SUPPRF28820",83,8,55,7,1,66,54,48,"Pilot 8","Pilot 8: max feedback + text"
33,"SUPPRF28820",85,10,50,-11,-13,47,63,61,"Pilot 8","Pilot 8: max feedback + text"
34,"SUPPRF28820",89,13,38,-24,-16,47,54,62,"Pilot 8","Pilot 8: max feedback + text"
35,"SUPPRF28820",99,0,100,41,20,50,80,59,"Pilot 8","Pilot 8: max feedback + text"
36,"SUPPRF28820",88,8,77,9,14,52,63,68,"Pilot 8","Pilot 8: max feedback + text"
37,"SUPPRF28820",72,5,6,-27,-14,71,20,33,"Pilot 8","Pilot 8: max feedback + text"
38,"SUPPRF28820",89,7,58,-18,29,19,29,76,"Pilot 8","Pilot 8: max feedback + text"
39,"SUPPRF28820",89,12,19,-42,-1,32,20,61,"Pilot 8","Pilot 8: max feedback + text"
40,"SUPPRF28820",94,7,96,22,16,29,80,74,"Pilot 8","Pilot 8: max feedback + text"
41,"SUPPRF28820",87,8,58,9,12,49,46,49,"Pilot 8","Pilot 8: max feedback + text"
42,"SUPPRF28820",92,7,47,-39,-16,19,63,86,"Pilot 8","Pilot 8: max feedback + text"
43,"SUPPRF28820",87,7,75,25,29,17,46,50,"Pilot 8","Pilot 8: max feedback + text"
44,"SUPPRF28820",91,12,41,-38,-13,15,54,79,"Pilot 8","Pilot 8: max feedback + text"
45,"SUPPRF28820",88,5,68,-7,-12,18,80,75,"Pilot 8","Pilot 8: max feedback + text"
46,"SUPPRF28820",88,11,62,16,-1,14,63,46,"Pilot 8","Pilot 8: max feedback + text"
47,"SUPPRF28820",92,6,33,-46,-13,50,46,79,"Pilot 8","Pilot 8: max feedback + text"
48,"SUPPRF28820",89,10,49,-1,12,48,37,50,"Pilot 8","Pilot 8: max feedback + text"
1,"SUPPRF53839",77,64,78,52,24,38,54,26,"Pilot 8","Pilot 8: max feedback + text"
2,"SUPPRF53839",69,61,41,10,-13,62,54,31,"Pilot 8","Pilot 8: max feedback + text"
3,"SUPPRF53839",27,49,28,0,-1,5,29,28,"Pilot 8","Pilot 8: max feedback + text"
4,"SUPPRF53839",48,53,56,21,-15,26,71,35,"Pilot 8","Pilot 8: max feedback + text"
5,"SUPPRF53839",34,51,16,-15,-13,72,29,31,"Pilot 8","Pilot 8: max feedback + text"
6,"SUPPRF53839",50,49,63,-17,0,81,63,80,"Pilot 8","Pilot 8: max feedback + text"
7,"SUPPRF53839",48,47,49,26,12,1,37,23,"Pilot 8","Pilot 8: max feedback + text"
8,"SUPPRF53839",37,37,45,4,-1,50,46,41,"Pilot 8","Pilot 8: max feedback + text"
9,"SUPPRF53839",45,63,24,-11,-13,20,37,35,"Pilot 8","Pilot 8: max feedback + text"
10,"SUPPRF53839",95,31,100,22,20,68,80,78,"Pilot 8","Pilot 8: max feedback + text"
11,"SUPPRF53839",78,37,29,18,0,73,29,11,"Pilot 8","Pilot 8: max feedback + text"
12,"SUPPRF53839",33,72,61,-11,24,8,37,72,"Pilot 8","Pilot 8: max feedback + text"
13,"SUPPRF53839",30,52,62,-33,-1,86,63,95,"Pilot 8","Pilot 8: max feedback + text"
14,"SUPPRF53839",41,60,33,-19,-13,20,46,52,"Pilot 8","Pilot 8: max feedback + text"
15,"SUPPRF53839",34,42,38,15,1,20,37,23,"Pilot 8","Pilot 8: max feedback + text"
16,"SUPPRF53839",52,42,58,29,12,35,46,29,"Pilot 8","Pilot 8: max feedback + text"
17,"SUPPRF53839",47,47,88,22,25,72,63,66,"Pilot 8","Pilot 8: max feedback + text"
18,"SUPPRF53839",44,51,68,-21,-12,87,80,89,"Pilot 8","Pilot 8: max feedback + text"
19,"SUPPRF53839",24,28,38,-33,-16,69,54,71,"Pilot 8","Pilot 8: max feedback + text"
20,"SUPPRF53839",11,66,8,-7,-12,74,20,15,"Pilot 8","Pilot 8: max feedback + text"
21,"SUPPRF53839",23,62,20,10,0,89,20,10,"Pilot 8","Pilot 8: max feedback + text"
22,"SUPPRF53839",19,75,55,-19,-16,75,71,74,"Pilot 8","Pilot 8: max feedback + text"
23,"SUPPRF53839",23,78,50,-4,-13,57,63,54,"Pilot 8","Pilot 8: max feedback + text"
24,"SUPPRF53839",78,21,96,19,16,65,80,77,"Pilot 8","Pilot 8: max feedback + text"
25,"SUPPRF53839",21,77,34,-6,-12,71,46,40,"Pilot 8","Pilot 8: max feedback + text"
26,"SUPPRF53839",82,71,80,43,0,72,80,37,"Pilot 8","Pilot 8: max feedback + text"
27,"SUPPRF53839",40,77,55,-20,1,83,54,75,"Pilot 8","Pilot 8: max feedback + text"
28,"SUPPRF53839",14,87,6,-13,-14,78,20,19,"Pilot 8","Pilot 8: max feedback + text"
29,"SUPPRF53839",24,75,54,-10,0,79,54,64,"Pilot 8","Pilot 8: max feedback + text"
30,"SUPPRF53839",38,63,58,2,29,2,29,56,"Pilot 8","Pilot 8: max feedback + text"
31,"SUPPRF53839",75,55,77,34,14,40,63,43,"Pilot 8","Pilot 8: max feedback + text"
32,"SUPPRF53839",57,67,81,20,1,62,80,61,"Pilot 8","Pilot 8: max feedback + text"
33,"SUPPRF53839",52,65,22,-27,-15,0,37,49,"Pilot 8","Pilot 8: max feedback + text"
34,"SUPPRF53839",75,54,19,5,-1,6,20,14,"Pilot 8","Pilot 8: max feedback + text"
35,"SUPPRF53839",91,59,94,31,23,77,71,63,"Pilot 8","Pilot 8: max feedback + text"
36,"SUPPRF53839",88,47,83,18,12,69,71,65,"Pilot 8","Pilot 8: max feedback + text"
37,"SUPPRF53839",61,72,47,2,-16,60,63,45,"Pilot 8","Pilot 8: max feedback + text"
38,"SUPPRF53839",65,73,66,28,12,44,54,38,"Pilot 8","Pilot 8: max feedback + text"
39,"SUPPRF53839",68,48,75,11,29,75,46,64,"Pilot 8","Pilot 8: max feedback + text"
40,"SUPPRF53839",57,49,46,-15,0,57,46,61,"Pilot 8","Pilot 8: max feedback + text"
41,"SUPPRF53839",60,49,67,-17,-13,93,80,84,"Pilot 8","Pilot 8: max feedback + text"
42,"SUPPRF53839",73,73,35,24,15,58,20,11,"Pilot 8","Pilot 8: max feedback + text"
43,"SUPPRF53839",57,63,46,-11,17,55,29,57,"Pilot 8","Pilot 8: max feedback + text"
44,"SUPPRF53839",54,55,47,39,27,81,20,8,"Pilot 8","Pilot 8: max feedback + text"
45,"SUPPRF53839",39,64,70,12,-1,60,71,58,"Pilot 8","Pilot 8: max feedback + text"
46,"SUPPRF53839",70,73,37,15,0,64,37,22,"Pilot 8","Pilot 8: max feedback + text"
47,"SUPPRF53839",45,62,71,19,0,44,71,52,"Pilot 8","Pilot 8: max feedback + text"
48,"SUPPRF53839",63,70,15,-36,-14,75,29,51,"Pilot 8","Pilot 8: max feedback + text"
1,"SUPPRF31306",94,1,24,-11,-13,61,37,35,"Pilot 9","Pilot 9: bigger feedback + text"
2,"SUPPRF31306",97,3,56,-25,-15,63,71,81,"Pilot 9","Pilot 9: bigger feedback + text"
3,"SUPPRF31306",98,1,67,-6,-13,58,80,73,"Pilot 9","Pilot 9: bigger feedback + text"
4,"SUPPRF31306",98,2,22,-1,-15,39,37,23,"Pilot 9","Pilot 9: bigger feedback + text"
5,"SUPPRF31306",97,1,38,-8,-16,32,54,46,"Pilot 9","Pilot 9: bigger feedback + text"
6,"SUPPRF31306",97,2,8,-31,-12,9,20,39,"Pilot 9","Pilot 9: bigger feedback + text"
7,"SUPPRF31306",97,2,6,-11,-14,20,20,17,"Pilot 9","Pilot 9: bigger feedback + text"
8,"SUPPRF31306",97,4,16,-4,-13,35,29,20,"Pilot 9","Pilot 9: bigger feedback + text"
9,"SUPPRF31306",96,4,54,34,0,78,54,20,"Pilot 9","Pilot 9: bigger feedback + text"
10,"SUPPRF31306",97,2,100,72,20,77,80,28,"Pilot 9","Pilot 9: bigger feedback + text"
11,"SUPPRF31306",99,1,94,6,23,90,71,88,"Pilot 9","Pilot 9: bigger feedback + text"
12,"SUPPRF31306",95,4,63,2,0,69,63,61,"Pilot 9","Pilot 9: bigger feedback + text"
13,"SUPPRF31306",95,4,61,13,24,49,37,48,"Pilot 9","Pilot 9: bigger feedback + text"
14,"SUPPRF31306",94,1,41,-24,-13,66,54,65,"Pilot 9","Pilot 9: bigger feedback + text"
15,"SUPPRF31306",96,3,58,-1,12,42,46,59,"Pilot 9","Pilot 9: bigger feedback + text"
16,"SUPPRF31306",96,4,83,37,12,58,71,46,"Pilot 9","Pilot 9: bigger feedback + text"
17,"SUPPRF31306",98,3,88,75,25,68,63,13,"Pilot 9","Pilot 9: bigger feedback + text"
18,"SUPPRF31306",96,5,49,13,12,74,37,36,"Pilot 9","Pilot 9: bigger feedback + text"
19,"SUPPRF31306",19,73,50,-8,-13,65,63,58,"Pilot 9","Pilot 9: bigger feedback + text"
20,"SUPPRF31306",12,26,37,-3,0,69,37,40,"Pilot 9","Pilot 9: bigger feedback + text"
21,"SUPPRF31306",31,24,80,7,0,53,80,73,"Pilot 9","Pilot 9: bigger feedback + text"
22,"SUPPRF31306",19,24,81,17,1,47,80,64,"Pilot 9","Pilot 9: bigger feedback + text"
23,"SUPPRF31306",19,20,47,23,27,63,20,24,"Pilot 9","Pilot 9: bigger feedback + text"
24,"SUPPRF31306",13,14,78,43,24,78,54,35,"Pilot 9","Pilot 9: bigger feedback + text"
25,"SUPPRF31306",3,26,15,-33,-14,26,29,48,"Pilot 9","Pilot 9: bigger feedback + text"
26,"SUPPRF31306",8,35,58,-7,29,54,29,65,"Pilot 9","Pilot 9: bigger feedback + text"
27,"SUPPRF31306",2,41,55,1,1,66,54,54,"Pilot 9","Pilot 9: bigger feedback + text"
28,"SUPPRF31306",63,10,46,26,17,73,29,20,"Pilot 9","Pilot 9: bigger feedback + text"
29,"SUPPRF31306",2,41,70,11,-1,61,71,59,"Pilot 9","Pilot 9: bigger feedback + text"
30,"SUPPRF31306",7,75,47,-1,-16,26,63,48,"Pilot 9","Pilot 9: bigger feedback + text"
31,"SUPPRF31306",7,68,71,11,0,57,71,60,"Pilot 9","Pilot 9: bigger feedback + text"
32,"SUPPRF31306",8,77,46,13,0,66,46,33,"Pilot 9","Pilot 9: bigger feedback + text"
33,"SUPPRF31306",4,90,33,-12,-13,100,46,45,"Pilot 9","Pilot 9: bigger feedback + text"
34,"SUPPRF31306",10,93,77,24,14,30,63,53,"Pilot 9","Pilot 9: bigger feedback + text"
35,"SUPPRF31306",5,96,45,-9,-1,78,46,54,"Pilot 9","Pilot 9: bigger feedback + text"
36,"SUPPRF31306",13,100,55,-9,-16,30,71,64,"Pilot 9","Pilot 9: bigger feedback + text"
37,"SUPPRF31306",0,100,29,-35,0,42,29,64,"Pilot 9","Pilot 9: bigger feedback + text"
38,"SUPPRF31306",2,98,20,4,0,79,20,16,"Pilot 9","Pilot 9: bigger feedback + text"
39,"SUPPRF31306",3,80,28,-2,-1,69,29,30,"Pilot 9","Pilot 9: bigger feedback + text"
40,"SUPPRF31306",37,53,34,-10,-12,60,46,44,"Pilot 9","Pilot 9: bigger feedback + text"
41,"SUPPRF31306",9,96,38,-10,1,29,37,48,"Pilot 9","Pilot 9: bigger feedback + text"
42,"SUPPRF31306",0,100,96,45,16,21,80,51,"Pilot 9","Pilot 9: bigger feedback + text"
43,"SUPPRF31306",0,99,35,15,15,100,20,20,"Pilot 9","Pilot 9: bigger feedback + text"
44,"SUPPRF31306",6,100,68,-3,-12,22,80,71,"Pilot 9","Pilot 9: bigger feedback + text"
45,"SUPPRF31306",0,100,19,-2,-1,72,20,21,"Pilot 9","Pilot 9: bigger feedback + text"
46,"SUPPRF31306",0,89,66,11,12,65,54,55,"Pilot 9","Pilot 9: bigger feedback + text"
47,"SUPPRF31306",0,100,75,27,29,74,46,48,"Pilot 9","Pilot 9: bigger feedback + text"
48,"SUPPRF31306",0,84,62,-13,-1,74,63,75,"Pilot 9","Pilot 9: bigger feedback + text"
1,"SUPPRF86350",49,68,61,25,24,45,37,36,"Pilot 9","Pilot 9: bigger feedback + text"
2,"SUPPRF86350",68,37,94,13,23,67,71,81,"Pilot 9","Pilot 9: bigger feedback + text"
3,"SUPPRF86350",29,52,55,-18,-16,73,71,73,"Pilot 9","Pilot 9: bigger feedback + text"
4,"SUPPRF86350",65,37,78,18,24,53,54,60,"Pilot 9","Pilot 9: bigger feedback + text"
5,"SUPPRF86350",48,44,20,-13,0,29,20,33,"Pilot 9","Pilot 9: bigger feedback + text"
6,"SUPPRF86350",30,51,22,-28,-15,36,37,50,"Pilot 9","Pilot 9: bigger feedback + text"
7,"SUPPRF86350",58,47,71,-12,0,71,71,83,"Pilot 9","Pilot 9: bigger feedback + text"
8,"SUPPRF86350",27,12,8,-54,-12,64,20,62,"Pilot 9","Pilot 9: bigger feedback + text"
9,"SUPPRF86350",53,42,62,-1,-1,41,63,63,"Pilot 9","Pilot 9: bigger feedback + text"
10,"SUPPRF86350",65,51,16,-14,-13,43,29,30,"Pilot 9","Pilot 9: bigger feedback + text"
11,"SUPPRF86350",99,21,100,63,20,18,80,37,"Pilot 9","Pilot 9: bigger feedback + text"
12,"SUPPRF86350",55,60,58,12,12,54,46,46,"Pilot 9","Pilot 9: bigger feedback + text"
13,"SUPPRF86350",51,23,88,30,25,9,63,58,"Pilot 9","Pilot 9: bigger feedback + text"
14,"SUPPRF86350",76,25,81,4,1,67,80,77,"Pilot 9","Pilot 9: bigger feedback + text"
15,"SUPPRF86350",50,30,41,-23,-13,67,54,64,"Pilot 9","Pilot 9: bigger feedback + text"
16,"SUPPRF86350",50,50,34,-21,-12,32,46,55,"Pilot 9","Pilot 9: bigger feedback + text"
17,"SUPPRF86350",76,50,77,27,14,15,63,50,"Pilot 9","Pilot 9: bigger feedback + text"
18,"SUPPRF86350",30,42,70,-6,-1,75,71,76,"Pilot 9","Pilot 9: bigger feedback + text"
19,"SUPPRF86350",51,53,46,19,17,16,29,27,"Pilot 9","Pilot 9: bigger feedback + text"
20,"SUPPRF86350",52,56,46,12,0,66,46,34,"Pilot 9","Pilot 9: bigger feedback + text"
21,"SUPPRF86350",53,50,50,-6,-13,65,63,56,"Pilot 9","Pilot 9: bigger feedback + text"
22,"SUPPRF86350",21,58,6,-23,-14,58,20,29,"Pilot 9","Pilot 9: bigger feedback + text"
23,"SUPPRF86350",48,57,49,17,12,30,37,32,"Pilot 9","Pilot 9: bigger feedback + text"
24,"SUPPRF86350",46,48,54,-8,0,53,54,62,"Pilot 9","Pilot 9: bigger feedback + text"
25,"SUPPRF86350",51,50,38,1,1,54,37,37,"Pilot 9","Pilot 9: bigger feedback + text"
26,"SUPPRF86350",3,93,15,-20,-14,32,29,35,"Pilot 9","Pilot 9: bigger feedback + text"
27,"SUPPRF86350",12,54,75,29,29,31,46,46,"Pilot 9","Pilot 9: bigger feedback + text"
28,"SUPPRF86350",43,37,56,-18,-15,61,71,74,"Pilot 9","Pilot 9: bigger feedback + text"
29,"SUPPRF86350",49,37,37,-8,0,50,37,45,"Pilot 9","Pilot 9: bigger feedback + text"
30,"SUPPRF86350",39,54,29,-19,0,48,29,48,"Pilot 9","Pilot 9: bigger feedback + text"
31,"SUPPRF86350",46,46,83,17,12,53,71,66,"Pilot 9","Pilot 9: bigger feedback + text"
32,"SUPPRF86350",50,46,68,14,-12,53,80,54,"Pilot 9","Pilot 9: bigger feedback + text"
33,"SUPPRF86350",49,45,47,-2,27,51,20,49,"Pilot 9","Pilot 9: bigger feedback + text"
34,"SUPPRF86350",46,51,24,-32,-13,59,37,56,"Pilot 9","Pilot 9: bigger feedback + text"
35,"SUPPRF86350",53,47,67,-5,-13,66,80,72,"Pilot 9","Pilot 9: bigger feedback + text"
36,"SUPPRF86350",47,52,35,-19,15,49,20,54,"Pilot 9","Pilot 9: bigger feedback + text"
37,"SUPPRF86350",53,50,28,-29,-1,50,29,57,"Pilot 9","Pilot 9: bigger feedback + text"
38,"SUPPRF86350",49,54,38,-10,-16,59,54,48,"Pilot 9","Pilot 9: bigger feedback + text"
39,"SUPPRF86350",53,49,47,0,-16,28,63,47,"Pilot 9","Pilot 9: bigger feedback + text"
40,"SUPPRF86350",1,50,33,-14,-13,43,46,47,"Pilot 9","Pilot 9: bigger feedback + text"
41,"SUPPRF86350",80,50,80,29,0,47,80,51,"Pilot 9","Pilot 9: bigger feedback + text"
42,"SUPPRF86350",97,52,96,34,16,50,80,62,"Pilot 9","Pilot 9: bigger feedback + text"
43,"SUPPRF86350",64,68,19,-52,-1,70,20,71,"Pilot 9","Pilot 9: bigger feedback + text"
44,"SUPPRF86350",59,64,63,2,0,64,63,61,"Pilot 9","Pilot 9: bigger feedback + text"
45,"SUPPRF86350",59,60,58,15,29,46,29,43,"Pilot 9","Pilot 9: bigger feedback + text"
46,"SUPPRF86350",54,65,45,-5,-1,66,46,50,"Pilot 9","Pilot 9: bigger feedback + text"
47,"SUPPRF86350",55,61,55,4,1,48,54,51,"Pilot 9","Pilot 9: bigger feedback + text"
48,"SUPPRF86350",61,66,66,20,12,78,54,46,"Pilot 9","Pilot 9: bigger feedback + text"
1,"SUPPRF93485",62,2,71,-10,0,86,71,81,"Pilot 9","Pilot 9: bigger feedback + text"
2,"SUPPRF93485",46,3,50,-6,-13,71,63,56,"Pilot 9","Pilot 9: bigger feedback + text"
3,"SUPPRF93485",57,17,96,58,16,53,80,38,"Pilot 9","Pilot 9: bigger feedback + text"
4,"SUPPRF93485",23,0,28,-23,-1,77,29,51,"Pilot 9","Pilot 9: bigger feedback + text"
5,"SUPPRF93485",26,7,16,-46,-13,45,29,62,"Pilot 9","Pilot 9: bigger feedback + text"
6,"SUPPRF93485",30,7,6,-10,-14,78,20,16,"Pilot 9","Pilot 9: bigger feedback + text"
7,"SUPPRF93485",34,21,47,-24,-16,73,63,71,"Pilot 9","Pilot 9: bigger feedback + text"
8,"SUPPRF93485",34,22,38,7,1,78,37,31,"Pilot 9","Pilot 9: bigger feedback + text"
9,"SUPPRF93485",69,3,63,8,0,45,63,55,"Pilot 9","Pilot 9: bigger feedback + text"
10,"SUPPRF93485",48,4,45,21,-1,45,46,24,"Pilot 9","Pilot 9: bigger feedback + text"
11,"SUPPRF93485",76,28,46,-3,17,58,29,49,"Pilot 9","Pilot 9: bigger feedback + text"
12,"SUPPRF93485",62,17,19,-39,-1,43,20,58,"Pilot 9","Pilot 9: bigger feedback + text"
13,"SUPPRF93485",46,47,34,-26,-12,43,46,60,"Pilot 9","Pilot 9: bigger feedback + text"
14,"SUPPRF93485",57,51,49,-18,12,26,37,67,"Pilot 9","Pilot 9: bigger feedback + text"
15,"SUPPRF93485",100,9,100,14,20,60,80,86,"Pilot 9","Pilot 9: bigger feedback + text"
16,"SUPPRF93485",41,48,22,-32,-15,39,37,54,"Pilot 9","Pilot 9: bigger feedback + text"
17,"SUPPRF93485",34,5,67,24,-13,44,80,43,"Pilot 9","Pilot 9: bigger feedback + text"
18,"SUPPRF93485",64,0,68,6,-12,68,80,62,"Pilot 9","Pilot 9: bigger feedback + text"
19,"SUPPRF93485",70,7,56,4,-15,35,71,52,"Pilot 9","Pilot 9: bigger feedback + text"
20,"SUPPRF93485",41,66,66,7,12,39,54,59,"Pilot 9","Pilot 9: bigger feedback + text"
21,"SUPPRF93485",68,39,54,30,0,52,54,24,"Pilot 9","Pilot 9: bigger feedback + text"
22,"SUPPRF93485",45,16,58,10,29,29,29,48,"Pilot 9","Pilot 9: bigger feedback + text"
23,"SUPPRF93485",64,48,55,6,-16,39,71,49,"Pilot 9","Pilot 9: bigger feedback + text"
24,"SUPPRF93485",70,11,94,31,23,14,71,63,"Pilot 9","Pilot 9: bigger feedback + text"
25,"SUPPRF93485",78,4,78,29,24,30,54,49,"Pilot 9","Pilot 9: bigger feedback + text"
26,"SUPPRF93485",80,15,38,-25,-16,21,54,63,"Pilot 9","Pilot 9: bigger feedback + text"
27,"SUPPRF93485",70,51,20,-44,0,58,20,64,"Pilot 9","Pilot 9: bigger feedback + text"
28,"SUPPRF93485",77,48,77,38,14,57,63,39,"Pilot 9","Pilot 9: bigger feedback + text"
29,"SUPPRF93485",75,54,46,16,0,47,46,30,"Pilot 9","Pilot 9: bigger feedback + text"
30,"SUPPRF93485",77,20,80,-5,0,81,80,85,"Pilot 9","Pilot 9: bigger feedback + text"
31,"SUPPRF93485",69,16,15,-16,-14,51,29,31,"Pilot 9","Pilot 9: bigger feedback + text"
32,"SUPPRF93485",61,37,29,3,0,22,29,26,"Pilot 9","Pilot 9: bigger feedback + text"
33,"SUPPRF93485",36,11,33,-21,-13,25,46,54,"Pilot 9","Pilot 9: bigger feedback + text"
34,"SUPPRF93485",56,13,61,34,24,38,37,27,"Pilot 9","Pilot 9: bigger feedback + text"
35,"SUPPRF93485",71,11,47,-11,27,41,20,58,"Pilot 9","Pilot 9: bigger feedback + text"
36,"SUPPRF93485",81,53,83,33,12,47,71,50,"Pilot 9","Pilot 9: bigger feedback + text"
37,"SUPPRF93485",75,10,35,22,15,45,20,13,"Pilot 9","Pilot 9: bigger feedback + text"
38,"SUPPRF93485",80,0,55,5,1,73,54,50,"Pilot 9","Pilot 9: bigger feedback + text"
39,"SUPPRF93485",77,0,41,-7,-13,62,54,48,"Pilot 9","Pilot 9: bigger feedback + text"
40,"SUPPRF93485",74,25,62,15,-1,65,63,47,"Pilot 9","Pilot 9: bigger feedback + text"
41,"SUPPRF93485",73,21,37,7,0,63,37,30,"Pilot 9","Pilot 9: bigger feedback + text"
42,"SUPPRF93485",78,17,75,17,29,75,46,58,"Pilot 9","Pilot 9: bigger feedback + text"
43,"SUPPRF93485",73,16,58,28,12,58,46,30,"Pilot 9","Pilot 9: bigger feedback + text"
44,"SUPPRF93485",78,19,88,21,25,53,63,67,"Pilot 9","Pilot 9: bigger feedback + text"
45,"SUPPRF93485",75,0,24,4,-13,61,37,20,"Pilot 9","Pilot 9: bigger feedback + text"
46,"SUPPRF93485",83,11,8,-8,-12,76,20,16,"Pilot 9","Pilot 9: bigger feedback + text"
47,"SUPPRF93485",81,5,81,38,1,12,80,43,"Pilot 9","Pilot 9: bigger feedback + text"
48,"SUPPRF93485",80,5,70,-2,-1,87,71,72,"Pilot 9","Pilot 9: bigger feedback + text"
1,"SUPPRF70813",75,27,77,16,14,50,63,61,"Pilot 9","Pilot 9: bigger feedback + text"
2,"SUPPRF70813",71,31,19,-19,-1,67,20,38,"Pilot 9","Pilot 9: bigger feedback + text"
3,"SUPPRF70813",61,24,37,0,0,62,37,37,"Pilot 9","Pilot 9: bigger feedback + text"
4,"SUPPRF70813",70,32,34,-34,-12,58,46,68,"Pilot 9","Pilot 9: bigger feedback + text"
5,"SUPPRF70813",74,21,71,6,0,47,71,65,"Pilot 9","Pilot 9: bigger feedback + text"
6,"SUPPRF70813",74,28,20,-43,0,71,20,63,"Pilot 9","Pilot 9: bigger feedback + text"
7,"SUPPRF70813",81,29,45,6,-1,69,46,39,"Pilot 9","Pilot 9: bigger feedback + text"
8,"SUPPRF70813",75,19,96,56,16,65,80,40,"Pilot 9","Pilot 9: bigger feedback + text"
9,"SUPPRF70813",83,22,61,0,24,31,37,61,"Pilot 9","Pilot 9: bigger feedback + text"
10,"SUPPRF70813",73,29,38,-29,1,83,37,67,"Pilot 9","Pilot 9: bigger feedback + text"
11,"SUPPRF70813",65,27,15,-13,-14,65,29,28,"Pilot 9","Pilot 9: bigger feedback + text"
12,"SUPPRF70813",75,27,49,17,12,69,37,32,"Pilot 9","Pilot 9: bigger feedback + text"
13,"SUPPRF70813",72,26,94,72,23,69,71,22,"Pilot 9","Pilot 9: bigger feedback + text"
14,"SUPPRF70813",74,21,66,43,12,74,54,23,"Pilot 9","Pilot 9: bigger feedback + text"
15,"SUPPRF70813",69,27,75,28,29,72,46,47,"Pilot 9","Pilot 9: bigger feedback + text"
16,"SUPPRF70813",68,26,78,9,24,52,54,69,"Pilot 9","Pilot 9: bigger feedback + text"
17,"SUPPRF70813",69,27,47,-5,-16,76,63,52,"Pilot 9","Pilot 9: bigger feedback + text"
18,"SUPPRF70813",69,26,55,-11,1,79,54,66,"Pilot 9","Pilot 9: bigger feedback + text"
19,"SUPPRF70813",65,33,58,21,29,65,29,37,"Pilot 9","Pilot 9: bigger feedback + text"
20,"SUPPRF70813",75,22,80,7,0,63,80,73,"Pilot 9","Pilot 9: bigger feedback + text"
21,"SUPPRF70813",62,25,56,-10,-15,85,71,66,"Pilot 9","Pilot 9: bigger feedback + text"
22,"SUPPRF70813",77,32,55,35,-16,26,71,20,"Pilot 9","Pilot 9: bigger feedback + text"
23,"SUPPRF70813",58,25,88,25,25,75,63,63,"Pilot 9","Pilot 9: bigger feedback + text"
24,"SUPPRF70813",65,31,28,-12,-1,67,29,40,"Pilot 9","Pilot 9: bigger feedback + text"
25,"SUPPRF70813",68,32,22,-40,-15,33,37,62,"Pilot 9","Pilot 9: bigger feedback + text"
26,"SUPPRF70813",73,32,38,-11,-16,29,54,49,"Pilot 9","Pilot 9: bigger feedback + text"
27,"SUPPRF70813",64,33,50,20,-13,69,63,30,"Pilot 9","Pilot 9: bigger feedback + text"
28,"SUPPRF70813",69,28,83,15,12,49,71,68,"Pilot 9","Pilot 9: bigger feedback + text"
29,"SUPPRF70813",65,31,16,-49,-13,47,29,65,"Pilot 9","Pilot 9: bigger feedback + text"
30,"SUPPRF70813",67,25,81,14,1,30,80,67,"Pilot 9","Pilot 9: bigger feedback + text"
31,"SUPPRF70813",57,33,35,-9,15,68,20,44,"Pilot 9","Pilot 9: bigger feedback + text"
32,"SUPPRF70813",70,25,100,48,20,63,80,52,"Pilot 9","Pilot 9: bigger feedback + text"
33,"SUPPRF70813",66,34,29,-36,0,30,29,65,"Pilot 9","Pilot 9: bigger feedback + text"
34,"SUPPRF70813",65,29,70,14,-1,61,71,56,"Pilot 9","Pilot 9: bigger feedback + text"
35,"SUPPRF70813",61,26,67,25,-13,65,80,42,"Pilot 9","Pilot 9: bigger feedback + text"
36,"SUPPRF70813",73,23,58,28,12,72,46,30,"Pilot 9","Pilot 9: bigger feedback + text"
37,"SUPPRF70813",67,33,8,-11,-12,68,20,19,"Pilot 9","Pilot 9: bigger feedback + text"
38,"SUPPRF70813",67,26,46,-19,17,69,29,65,"Pilot 9","Pilot 9: bigger feedback + text"
39,"SUPPRF70813",60,23,68,37,-12,63,80,31,"Pilot 9","Pilot 9: bigger feedback + text"
40,"SUPPRF70813",67,34,47,-18,27,76,20,65,"Pilot 9","Pilot 9: bigger feedback + text"
41,"SUPPRF70813",65,27,33,-13,-13,68,46,46,"Pilot 9","Pilot 9: bigger feedback + text"
42,"SUPPRF70813",72,32,63,24,0,72,63,39,"Pilot 9","Pilot 9: bigger feedback + text"
43,"SUPPRF70813",72,31,6,-51,-14,65,20,57,"Pilot 9","Pilot 9: bigger feedback + text"
44,"SUPPRF70813",72,29,41,-17,-13,76,54,58,"Pilot 9","Pilot 9: bigger feedback + text"
45,"SUPPRF70813",66,25,54,-10,0,72,54,64,"Pilot 9","Pilot 9: bigger feedback + text"
46,"SUPPRF70813",59,32,24,-36,-13,65,37,60,"Pilot 9","Pilot 9: bigger feedback + text"
47,"SUPPRF70813",61,34,46,-8,0,67,46,54,"Pilot 9","Pilot 9: bigger feedback + text"
48,"SUPPRF70813",70,35,62,5,-1,68,63,57,"Pilot 9","Pilot 9: bigger feedback + text"
1,"SUPPRF86378",67,12,66,36,12,82,54,30,"Pilot 9","Pilot 9: bigger feedback + text"
2,"SUPPRF86378",83,19,61,18,24,76,37,43,"Pilot 9","Pilot 9: bigger feedback + text"
3,"SUPPRF86378",55,16,20,-42,0,72,20,62,"Pilot 9","Pilot 9: bigger feedback + text"
4,"SUPPRF86378",51,15,37,-14,0,68,37,51,"Pilot 9","Pilot 9: bigger feedback + text"
5,"SUPPRF86378",53,20,34,-11,-12,63,46,45,"Pilot 9","Pilot 9: bigger feedback + text"
6,"SUPPRF86378",51,35,35,21,15,57,20,14,"Pilot 9","Pilot 9: bigger feedback + text"
7,"SUPPRF86378",63,23,19,-8,-1,60,20,27,"Pilot 9","Pilot 9: bigger feedback + text"
8,"SUPPRF86378",73,17,71,38,0,32,71,33,"Pilot 9","Pilot 9: bigger feedback + text"
9,"SUPPRF86378",92,6,100,49,20,53,80,51,"Pilot 9","Pilot 9: bigger feedback + text"
10,"SUPPRF86378",77,12,41,-2,-13,61,54,43,"Pilot 9","Pilot 9: bigger feedback + text"
11,"SUPPRF86378",80,11,83,14,12,76,71,69,"Pilot 9","Pilot 9: bigger feedback + text"
12,"SUPPRF86378",72,14,28,5,-1,62,29,23,"Pilot 9","Pilot 9: bigger feedback + text"
13,"SUPPRF86378",83,10,81,13,1,72,80,68,"Pilot 9","Pilot 9: bigger feedback + text"
14,"SUPPRF86378",84,15,54,13,0,60,54,41,"Pilot 9","Pilot 9: bigger feedback + text"
15,"SUPPRF86378",90,10,38,-15,1,54,37,53,"Pilot 9","Pilot 9: bigger feedback + text"
16,"SUPPRF86378",84,8,75,42,29,50,46,33,"Pilot 9","Pilot 9: bigger feedback + text"
17,"SUPPRF86378",91,10,38,-7,-16,70,54,45,"Pilot 9","Pilot 9: bigger feedback + text"
18,"SUPPRF86378",91,13,47,28,27,78,20,19,"Pilot 9","Pilot 9: bigger feedback + text"
19,"SUPPRF86378",87,12,67,-11,-13,86,80,78,"Pilot 9","Pilot 9: bigger feedback + text"
20,"SUPPRF86378",83,12,50,2,-13,42,63,48,"Pilot 9","Pilot 9: bigger feedback + text"
21,"SUPPRF86378",85,10,77,30,14,83,63,47,"Pilot 9","Pilot 9: bigger feedback + text"
22,"SUPPRF86378",83,20,56,-18,-15,66,71,74,"Pilot 9","Pilot 9: bigger feedback + text"
23,"SUPPRF86378",85,16,55,9,1,29,54,46,"Pilot 9","Pilot 9: bigger feedback + text"
24,"SUPPRF86378",85,12,29,10,0,50,29,19,"Pilot 9","Pilot 9: bigger feedback + text"
25,"SUPPRF86378",84,10,62,26,-1,71,63,36,"Pilot 9","Pilot 9: bigger feedback + text"
26,"SUPPRF86378",84,20,22,-28,-15,33,37,50,"Pilot 9","Pilot 9: bigger feedback + text"
27,"SUPPRF86378",79,15,47,14,-16,55,63,33,"Pilot 9","Pilot 9: bigger feedback + text"
28,"SUPPRF86378",18,22,33,-7,-13,61,46,40,"Pilot 9","Pilot 9: bigger feedback + text"
29,"SUPPRF86378",70,11,80,5,0,73,80,75,"Pilot 9","Pilot 9: bigger feedback + text"
30,"SUPPRF86378",79,23,6,-14,-14,73,20,20,"Pilot 9","Pilot 9: bigger feedback + text"
31,"SUPPRF86378",80,13,45,2,-1,58,46,43,"Pilot 9","Pilot 9: bigger feedback + text"
32,"SUPPRF86378",79,14,63,5,0,77,63,58,"Pilot 9","Pilot 9: bigger feedback + text"
33,"SUPPRF86378",75,19,58,1,12,66,46,57,"Pilot 9","Pilot 9: bigger feedback + text"
34,"SUPPRF86378",82,23,96,31,16,66,80,65,"Pilot 9","Pilot 9: bigger feedback + text"
35,"SUPPRF86378",85,20,68,52,-12,78,80,16,"Pilot 9","Pilot 9: bigger feedback + text"
36,"SUPPRF86378",81,4,55,-10,-16,89,71,65,"Pilot 9","Pilot 9: bigger feedback + text"
37,"SUPPRF86378",67,15,94,24,23,65,71,70,"Pilot 9","Pilot 9: bigger feedback + text"
38,"SUPPRF86378",79,22,46,-6,0,47,46,52,"Pilot 9","Pilot 9: bigger feedback + text"
39,"SUPPRF86378",75,32,78,34,24,69,54,44,"Pilot 9","Pilot 9: bigger feedback + text"
40,"SUPPRF86378",78,22,8,-8,-12,65,20,16,"Pilot 9","Pilot 9: bigger feedback + text"
41,"SUPPRF86378",82,11,16,-16,-13,56,29,32,"Pilot 9","Pilot 9: bigger feedback + text"
42,"SUPPRF86378",82,22,58,31,29,38,29,27,"Pilot 9","Pilot 9: bigger feedback + text"
43,"SUPPRF86378",72,21,15,-12,-14,42,29,27,"Pilot 9","Pilot 9: bigger feedback + text"
44,"SUPPRF86378",86,14,88,47,25,50,63,41,"Pilot 9","Pilot 9: bigger feedback + text"
45,"SUPPRF86378",84,24,49,13,12,57,37,36,"Pilot 9","Pilot 9: bigger feedback + text"
46,"SUPPRF86378",76,12,70,-5,-1,82,71,75,"Pilot 9","Pilot 9: bigger feedback + text"
47,"SUPPRF86378",83,24,24,-10,-13,48,37,34,"Pilot 9","Pilot 9: bigger feedback + text"
48,"SUPPRF86378",92,25,46,25,17,41,29,21,"Pilot 9","Pilot 9: bigger feedback + text"
1,"SUPPRF66344",47,0,38,-7,-16,48,54,45,"Pilot 9","Pilot 9: bigger feedback + text"
2,"SUPPRF66344",48,0,58,35,12,0,46,23,"Pilot 9","Pilot 9: bigger feedback + text"
3,"SUPPRF66344",47,0,96,37,16,45,80,59,"Pilot 9","Pilot 9: bigger feedback + text"
4,"SUPPRF66344",48,0,35,18,15,74,20,17,"Pilot 9","Pilot 9: bigger feedback + text"
5,"SUPPRF66344",49,0,24,-21,-13,0,37,45,"Pilot 9","Pilot 9: bigger feedback + text"
6,"SUPPRF66344",47,0,15,-19,-14,46,29,34,"Pilot 9","Pilot 9: bigger feedback + text"
7,"SUPPRF66344",47,0,8,-13,-12,0,20,21,"Pilot 9","Pilot 9: bigger feedback + text"
8,"SUPPRF66344",47,0,94,39,23,0,71,55,"Pilot 9","Pilot 9: bigger feedback + text"
9,"SUPPRF66344",48,0,63,7,0,0,63,56,"Pilot 9","Pilot 9: bigger feedback + text"
10,"SUPPRF66344",48,0,47,-9,-16,2,63,56,"Pilot 9","Pilot 9: bigger feedback + text"
11,"SUPPRF66344",46,0,62,10,-1,0,63,52,"Pilot 9","Pilot 9: bigger feedback + text"
12,"SUPPRF66344",47,0,47,28,27,0,20,19,"Pilot 9","Pilot 9: bigger feedback + text"
13,"SUPPRF66344",48,0,34,8,-12,0,46,26,"Pilot 9","Pilot 9: bigger feedback + text"
14,"SUPPRF66344",49,0,22,-14,-15,0,37,36,"Pilot 9","Pilot 9: bigger feedback + text"
15,"SUPPRF66344",49,0,54,12,0,0,54,42,"Pilot 9","Pilot 9: bigger feedback + text"
16,"SUPPRF66344",47,0,77,39,14,0,63,38,"Pilot 9","Pilot 9: bigger feedback + text"
17,"SUPPRF66344",48,0,41,-23,-13,50,54,64,"Pilot 9","Pilot 9: bigger feedback + text"
18,"SUPPRF66344",48,0,68,3,-12,0,80,65,"Pilot 9","Pilot 9: bigger feedback + text"
19,"SUPPRF66344",49,0,19,-29,-1,0,20,48,"Pilot 9","Pilot 9: bigger feedback + text"
20,"SUPPRF66344",47,0,28,2,-1,0,29,26,"Pilot 9","Pilot 9: bigger feedback + text"
21,"SUPPRF66344",47,0,6,-18,-14,0,20,24,"Pilot 9","Pilot 9: bigger feedback + text"
22,"SUPPRF66344",49,0,45,13,-1,0,46,32,"Pilot 9","Pilot 9: bigger feedback + text"
23,"SUPPRF66344",46,0,78,41,24,0,54,37,"Pilot 9","Pilot 9: bigger feedback + text"
24,"SUPPRF66344",46,0,38,9,1,0,37,29,"Pilot 9","Pilot 9: bigger feedback + text"
25,"SUPPRF66344",47,0,81,27,1,45,80,54,"Pilot 9","Pilot 9: bigger feedback + text"
26,"SUPPRF66344",47,0,58,9,29,34,29,49,"Pilot 9","Pilot 9: bigger feedback + text"
27,"SUPPRF66344",50,0,50,-2,-13,47,63,52,"Pilot 9","Pilot 9: bigger feedback + text"
28,"SUPPRF66344",49,0,33,-16,-13,48,46,49,"Pilot 9","Pilot 9: bigger feedback + text"
29,"SUPPRF66344",47,0,55,7,1,0,54,48,"Pilot 9","Pilot 9: bigger feedback + text"
30,"SUPPRF66344",48,0,61,12,24,5,37,49,"Pilot 9","Pilot 9: bigger feedback + text"
31,"SUPPRF66344",48,0,66,25,12,6,54,41,"Pilot 9","Pilot 9: bigger feedback + text"
32,"SUPPRF66344",46,0,75,54,29,49,46,21,"Pilot 9","Pilot 9: bigger feedback + text"
33,"SUPPRF66344",48,0,55,-6,-16,39,71,61,"Pilot 9","Pilot 9: bigger feedback + text"
34,"SUPPRF66344",49,0,83,31,12,45,71,52,"Pilot 9","Pilot 9: bigger feedback + text"
35,"SUPPRF66344",50,0,20,-7,0,43,20,27,"Pilot 9","Pilot 9: bigger feedback + text"
36,"SUPPRF66344",47,0,70,20,-1,45,71,50,"Pilot 9","Pilot 9: bigger feedback + text"
37,"SUPPRF66344",45,0,29,4,0,47,29,25,"Pilot 9","Pilot 9: bigger feedback + text"
38,"SUPPRF66344",66,0,100,37,20,47,80,63,"Pilot 9","Pilot 9: bigger feedback + text"
39,"SUPPRF66344",50,0,67,11,-13,50,80,56,"Pilot 9","Pilot 9: bigger feedback + text"
40,"SUPPRF66344",49,0,37,-9,0,4,37,46,"Pilot 9","Pilot 9: bigger feedback + text"
41,"SUPPRF66344",48,0,80,12,0,48,80,68,"Pilot 9","Pilot 9: bigger feedback + text"
42,"SUPPRF66344",48,0,46,7,0,49,46,39,"Pilot 9","Pilot 9: bigger feedback + text"
43,"SUPPRF66344",49,0,88,41,25,7,63,47,"Pilot 9","Pilot 9: bigger feedback + text"
44,"SUPPRF66344",47,0,56,-1,-15,46,71,57,"Pilot 9","Pilot 9: bigger feedback + text"
45,"SUPPRF66344",50,0,46,23,17,46,29,23,"Pilot 9","Pilot 9: bigger feedback + text"
46,"SUPPRF66344",49,0,16,-3,-13,46,29,19,"Pilot 9","Pilot 9: bigger feedback + text"
47,"SUPPRF66344",48,0,49,25,12,45,37,24,"Pilot 9","Pilot 9: bigger feedback + text"
48,"SUPPRF66344",47,0,71,15,0,2,71,56,"Pilot 9","Pilot 9: bigger feedback + text"
1,"SUPPRF60832",27,72,41,-19,-13,62,54,60,"Pilot 9","Pilot 9: bigger feedback + text"
2,"SUPPRF60832",96,1,100,11,20,89,80,89,"Pilot 9","Pilot 9: bigger feedback + text"
3,"SUPPRF60832",18,85,34,7,-12,77,46,27,"Pilot 9","Pilot 9: bigger feedback + text"
4,"SUPPRF60832",9,86,49,19,12,81,37,30,"Pilot 9","Pilot 9: bigger feedback + text"
5,"SUPPRF60832",68,43,58,17,12,83,46,41,"Pilot 9","Pilot 9: bigger feedback + text"
6,"SUPPRF60832",18,68,38,11,-16,47,54,27,"Pilot 9","Pilot 9: bigger feedback + text"
7,"SUPPRF60832",83,25,55,49,1,49,54,6,"Pilot 9","Pilot 9: bigger feedback + text"
8,"SUPPRF60832",64,35,47,-7,-16,35,63,54,"Pilot 9","Pilot 9: bigger feedback + text"
9,"SUPPRF60832",84,12,68,1,-12,30,80,67,"Pilot 9","Pilot 9: bigger feedback + text"
10,"SUPPRF60832",77,31,61,44,24,75,37,17,"Pilot 9","Pilot 9: bigger feedback + text"
11,"SUPPRF60832",1,99,15,-56,-14,59,29,71,"Pilot 9","Pilot 9: bigger feedback + text"
12,"SUPPRF60832",32,59,19,5,-1,91,20,14,"Pilot 9","Pilot 9: bigger feedback + text"
13,"SUPPRF60832",76,34,55,22,-16,45,71,33,"Pilot 9","Pilot 9: bigger feedback + text"
14,"SUPPRF60832",3,98,6,-16,-14,13,20,22,"Pilot 9","Pilot 9: bigger feedback + text"
15,"SUPPRF60832",98,4,96,30,16,80,80,66,"Pilot 9","Pilot 9: bigger feedback + text"
16,"SUPPRF60832",92,8,78,36,24,25,54,42,"Pilot 9","Pilot 9: bigger feedback + text"
17,"SUPPRF60832",24,86,28,-17,-1,51,29,45,"Pilot 9","Pilot 9: bigger feedback + text"
18,"SUPPRF60832",21,72,37,-27,0,14,37,64,"Pilot 9","Pilot 9: bigger feedback + text"
19,"SUPPRF60832",74,27,71,15,0,33,71,56,"Pilot 9","Pilot 9: bigger feedback + text"
20,"SUPPRF60832",84,28,77,32,14,49,63,45,"Pilot 9","Pilot 9: bigger feedback + text"
21,"SUPPRF60832",65,32,47,26,27,76,20,21,"Pilot 9","Pilot 9: bigger feedback + text"
22,"SUPPRF60832",67,31,58,-13,29,80,29,71,"Pilot 9","Pilot 9: bigger feedback + text"
23,"SUPPRF60832",81,31,75,23,29,58,46,52,"Pilot 9","Pilot 9: bigger feedback + text"
24,"SUPPRF60832",69,23,63,-5,0,82,63,68,"Pilot 9","Pilot 9: bigger feedback + text"
25,"SUPPRF60832",5,92,16,-38,-13,35,29,54,"Pilot 9","Pilot 9: bigger feedback + text"
26,"SUPPRF60832",61,42,56,5,-15,53,71,51,"Pilot 9","Pilot 9: bigger feedback + text"
27,"SUPPRF60832",72,32,50,16,-13,19,63,34,"Pilot 9","Pilot 9: bigger feedback + text"
28,"SUPPRF60832",79,34,66,20,12,30,54,46,"Pilot 9","Pilot 9: bigger feedback + text"
29,"SUPPRF60832",70,25,67,-5,-13,71,80,72,"Pilot 9","Pilot 9: bigger feedback + text"
30,"SUPPRF60832",18,65,38,-16,1,20,37,54,"Pilot 9","Pilot 9: bigger feedback + text"
31,"SUPPRF60832",71,16,83,60,12,9,71,23,"Pilot 9","Pilot 9: bigger feedback + text"
32,"SUPPRF60832",80,30,62,-3,-1,26,63,65,"Pilot 9","Pilot 9: bigger feedback + text"
33,"SUPPRF60832",98,1,70,2,-1,1,71,68,"Pilot 9","Pilot 9: bigger feedback + text"
34,"SUPPRF60832",12,85,24,-14,-13,36,37,38,"Pilot 9","Pilot 9: bigger feedback + text"
35,"SUPPRF60832",20,84,22,-12,-15,56,37,34,"Pilot 9","Pilot 9: bigger feedback + text"
36,"SUPPRF60832",98,1,94,49,23,1,71,45,"Pilot 9","Pilot 9: bigger feedback + text"
37,"SUPPRF60832",2,97,8,-15,-12,84,20,23,"Pilot 9","Pilot 9: bigger feedback + text"
38,"SUPPRF60832",61,33,33,-2,-13,16,46,35,"Pilot 9","Pilot 9: bigger feedback + text"
39,"SUPPRF60832",88,11,80,26,0,16,80,54,"Pilot 9","Pilot 9: bigger feedback + text"
40,"SUPPRF60832",96,10,81,31,1,61,80,50,"Pilot 9","Pilot 9: bigger feedback + text"
41,"SUPPRF60832",72,39,35,19,15,87,20,16,"Pilot 9","Pilot 9: bigger feedback + text"
42,"SUPPRF60832",41,53,20,-5,0,71,20,25,"Pilot 9","Pilot 9: bigger feedback + text"
43,"SUPPRF60832",75,24,46,22,0,86,46,24,"Pilot 9","Pilot 9: bigger feedback + text"
44,"SUPPRF60832",39,70,46,17,17,30,29,29,"Pilot 9","Pilot 9: bigger feedback + text"
45,"SUPPRF60832",93,16,88,29,25,21,63,59,"Pilot 9","Pilot 9: bigger feedback + text"
46,"SUPPRF60832",63,34,54,-13,0,44,54,67,"Pilot 9","Pilot 9: bigger feedback + text"
47,"SUPPRF60832",58,43,45,-7,-1,71,46,52,"Pilot 9","Pilot 9: bigger feedback + text"
48,"SUPPRF60832",70,26,29,1,0,77,29,28,"Pilot 9","Pilot 9: bigger feedback + text"
1,"SUPPRF79935",29,29,55,32,1,41,54,23,"Pilot 9","Pilot 9: bigger feedback + text"
2,"SUPPRF79935",30,26,63,-16,0,79,63,79,"Pilot 9","Pilot 9: bigger feedback + text"
3,"SUPPRF79935",30,31,33,-46,-13,69,46,79,"Pilot 9","Pilot 9: bigger feedback + text"
4,"SUPPRF79935",31,29,75,20,29,60,46,55,"Pilot 9","Pilot 9: bigger feedback + text"
5,"SUPPRF79935",31,28,71,-8,0,73,71,79,"Pilot 9","Pilot 9: bigger feedback + text"
6,"SUPPRF79935",28,30,66,-3,12,69,54,69,"Pilot 9","Pilot 9: bigger feedback + text"
7,"SUPPRF79935",33,34,88,22,25,70,63,66,"Pilot 9","Pilot 9: bigger feedback + text"
8,"SUPPRF79935",31,27,58,19,29,48,29,39,"Pilot 9","Pilot 9: bigger feedback + text"
9,"SUPPRF79935",28,31,70,-5,-1,70,71,75,"Pilot 9","Pilot 9: bigger feedback + text"
10,"SUPPRF79935",33,31,19,-31,-1,53,20,50,"Pilot 9","Pilot 9: bigger feedback + text"
11,"SUPPRF79935",31,34,46,-2,17,46,29,48,"Pilot 9","Pilot 9: bigger feedback + text"
12,"SUPPRF79935",28,28,35,-43,15,77,20,78,"Pilot 9","Pilot 9: bigger feedback + text"
13,"SUPPRF79935",22,25,45,22,-1,24,46,23,"Pilot 9","Pilot 9: bigger feedback + text"
14,"SUPPRF79935",28,29,96,62,16,41,80,34,"Pilot 9","Pilot 9: bigger feedback + text"
15,"SUPPRF79935",27,22,34,-51,-12,80,46,85,"Pilot 9","Pilot 9: bigger feedback + text"
16,"SUPPRF79935",18,19,68,47,-12,42,80,21,"Pilot 9","Pilot 9: bigger feedback + text"
17,"SUPPRF79935",22,22,6,-16,-14,22,20,22,"Pilot 9","Pilot 9: bigger feedback + text"
18,"SUPPRF79935",25,25,55,28,-16,27,71,27,"Pilot 9","Pilot 9: bigger feedback + text"
19,"SUPPRF79935",22,23,47,21,27,51,20,26,"Pilot 9","Pilot 9: bigger feedback + text"
20,"SUPPRF79935",27,26,46,-29,0,69,46,75,"Pilot 9","Pilot 9: bigger feedback + text"
21,"SUPPRF79935",31,36,77,45,14,51,63,32,"Pilot 9","Pilot 9: bigger feedback + text"
22,"SUPPRF79935",29,26,38,-44,-16,85,54,82,"Pilot 9","Pilot 9: bigger feedback + text"
23,"SUPPRF79935",34,36,41,-29,-13,63,54,70,"Pilot 9","Pilot 9: bigger feedback + text"
24,"SUPPRF79935",51,50,24,-43,-13,73,37,67,"Pilot 9","Pilot 9: bigger feedback + text"
25,"SUPPRF79935",32,35,62,-21,-1,84,63,83,"Pilot 9","Pilot 9: bigger feedback + text"
26,"SUPPRF79935",32,42,61,-14,24,68,37,75,"Pilot 9","Pilot 9: bigger feedback + text"
27,"SUPPRF79935",37,45,67,26,-13,55,80,41,"Pilot 9","Pilot 9: bigger feedback + text"
28,"SUPPRF79935",21,31,100,28,20,71,80,72,"Pilot 9","Pilot 9: bigger feedback + text"
29,"SUPPRF79935",34,33,81,31,1,47,80,50,"Pilot 9","Pilot 9: bigger feedback + text"
30,"SUPPRF79935",30,30,49,-17,12,70,37,66,"Pilot 9","Pilot 9: bigger feedback + text"
31,"SUPPRF79935",33,32,16,-64,-13,87,29,80,"Pilot 9","Pilot 9: bigger feedback + text"
32,"SUPPRF79935",34,35,56,-37,-15,84,71,93,"Pilot 9","Pilot 9: bigger feedback + text"
33,"SUPPRF79935",35,37,38,-31,1,82,37,69,"Pilot 9","Pilot 9: bigger feedback + text"
34,"SUPPRF79935",37,57,78,17,24,65,54,61,"Pilot 9","Pilot 9: bigger feedback + text"
35,"SUPPRF79935",24,28,28,-6,-1,31,29,34,"Pilot 9","Pilot 9: bigger feedback + text"
36,"SUPPRF79935",30,33,58,-3,12,67,46,61,"Pilot 9","Pilot 9: bigger feedback + text"
37,"SUPPRF79935",40,46,54,16,0,42,54,38,"Pilot 9","Pilot 9: bigger feedback + text"
38,"SUPPRF79935",23,32,37,-2,0,40,37,39,"Pilot 9","Pilot 9: bigger feedback + text"
39,"SUPPRF79935",27,27,20,-6,0,23,20,26,"Pilot 9","Pilot 9: bigger feedback + text"
40,"SUPPRF79935",31,37,83,51,12,35,71,32,"Pilot 9","Pilot 9: bigger feedback + text"
41,"SUPPRF79935",20,29,50,23,-13,33,63,27,"Pilot 9","Pilot 9: bigger feedback + text"
42,"SUPPRF79935",36,47,80,36,0,51,80,44,"Pilot 9","Pilot 9: bigger feedback + text"
43,"SUPPRF79935",30,27,47,2,-16,52,63,45,"Pilot 9","Pilot 9: bigger feedback + text"
44,"SUPPRF79935",42,38,29,-21,0,48,29,50,"Pilot 9","Pilot 9: bigger feedback + text"
45,"SUPPRF79935",32,33,15,-12,-14,70,29,27,"Pilot 9","Pilot 9: bigger feedback + text"
46,"SUPPRF79935",23,25,8,-87,-12,87,20,95,"Pilot 9","Pilot 9: bigger feedback + text"
47,"SUPPRF79935",30,31,94,57,23,41,71,37,"Pilot 9","Pilot 9: bigger feedback + text"
48,"SUPPRF79935",24,25,22,-3,-15,29,37,25,"Pilot 9","Pilot 9: bigger feedback + text"
1,"SUPPRF35697",48,33,35,7,15,65,20,28,"Pilot 9","Pilot 9: bigger feedback + text"
2,"SUPPRF35697",60,27,55,1,1,55,54,54,"Pilot 9","Pilot 9: bigger feedback + text"
3,"SUPPRF35697",58,41,38,-17,1,44,37,55,"Pilot 9","Pilot 9: bigger feedback + text"
4,"SUPPRF35697",52,28,47,18,27,61,20,29,"Pilot 9","Pilot 9: bigger feedback + text"
5,"SUPPRF35697",48,41,28,-26,-1,50,29,54,"Pilot 9","Pilot 9: bigger feedback + text"
6,"SUPPRF35697",42,32,100,68,20,25,80,32,"Pilot 9","Pilot 9: bigger feedback + text"
7,"SUPPRF35697",57,37,46,-5,17,44,29,51,"Pilot 9","Pilot 9: bigger feedback + text"
8,"SUPPRF35697",56,39,70,11,-1,41,71,59,"Pilot 9","Pilot 9: bigger feedback + text"
9,"SUPPRF35697",40,30,6,-55,-14,40,20,61,"Pilot 9","Pilot 9: bigger feedback + text"
10,"SUPPRF35697",52,47,22,-34,-15,38,37,56,"Pilot 9","Pilot 9: bigger feedback + text"
11,"SUPPRF35697",52,38,24,-33,-13,42,37,57,"Pilot 9","Pilot 9: bigger feedback + text"
12,"SUPPRF35697",36,46,15,-30,-14,43,29,45,"Pilot 9","Pilot 9: bigger feedback + text"
13,"SUPPRF35697",46,38,45,-3,-1,34,46,48,"Pilot 9","Pilot 9: bigger feedback + text"
14,"SUPPRF35697",39,44,33,-15,-13,55,46,48,"Pilot 9","Pilot 9: bigger feedback + text"
15,"SUPPRF35697",43,38,81,11,1,56,80,70,"Pilot 9","Pilot 9: bigger feedback + text"
16,"SUPPRF35697",37,50,29,-20,0,48,29,49,"Pilot 9","Pilot 9: bigger feedback + text"
17,"SUPPRF35697",49,47,34,33,-12,1,46,1,"Pilot 9","Pilot 9: bigger feedback + text"
18,"SUPPRF35697",39,50,38,-13,-16,50,54,51,"Pilot 9","Pilot 9: bigger feedback + text"
19,"SUPPRF35697",48,50,88,36,25,50,63,52,"Pilot 9","Pilot 9: bigger feedback + text"
20,"SUPPRF35697",57,48,63,18,0,57,63,45,"Pilot 9","Pilot 9: bigger feedback + text"
21,"SUPPRF35697",51,58,56,-3,-15,59,71,59,"Pilot 9","Pilot 9: bigger feedback + text"
22,"SUPPRF35697",54,45,8,-17,-12,55,20,25,"Pilot 9","Pilot 9: bigger feedback + text"
23,"SUPPRF35697",57,42,50,5,-13,60,63,45,"Pilot 9","Pilot 9: bigger feedback + text"
24,"SUPPRF35697",55,46,83,22,12,55,71,61,"Pilot 9","Pilot 9: bigger feedback + text"
25,"SUPPRF35697",40,48,16,-20,-13,55,29,36,"Pilot 9","Pilot 9: bigger feedback + text"
26,"SUPPRF35697",57,64,67,-15,-13,73,80,82,"Pilot 9","Pilot 9: bigger feedback + text"
27,"SUPPRF35697",52,48,75,14,29,45,46,61,"Pilot 9","Pilot 9: bigger feedback + text"
28,"SUPPRF35697",64,31,94,16,23,70,71,78,"Pilot 9","Pilot 9: bigger feedback + text"
29,"SUPPRF35697",52,46,66,8,12,52,54,58,"Pilot 9","Pilot 9: bigger feedback + text"
30,"SUPPRF35697",36,40,54,0,0,53,54,54,"Pilot 9","Pilot 9: bigger feedback + text"
31,"SUPPRF35697",41,55,55,-10,-16,49,71,65,"Pilot 9","Pilot 9: bigger feedback + text"
32,"SUPPRF35697",30,57,20,-2,0,62,20,22,"Pilot 9","Pilot 9: bigger feedback + text"
33,"SUPPRF35697",44,39,37,-10,0,33,37,47,"Pilot 9","Pilot 9: bigger feedback + text"
34,"SUPPRF35697",51,43,61,-2,24,43,37,63,"Pilot 9","Pilot 9: bigger feedback + text"
35,"SUPPRF35697",54,45,49,3,12,51,37,46,"Pilot 9","Pilot 9: bigger feedback + text"
36,"SUPPRF35697",49,51,77,34,14,57,63,43,"Pilot 9","Pilot 9: bigger feedback + text"
37,"SUPPRF35697",71,37,80,5,0,56,80,75,"Pilot 9","Pilot 9: bigger feedback + text"
38,"SUPPRF35697",50,64,68,12,-12,55,80,56,"Pilot 9","Pilot 9: bigger feedback + text"
39,"SUPPRF35697",59,47,47,-28,-16,74,63,75,"Pilot 9","Pilot 9: bigger feedback + text"
40,"SUPPRF35697",53,43,41,-15,-13,44,54,56,"Pilot 9","Pilot 9: bigger feedback + text"
41,"SUPPRF35697",49,41,46,-14,0,39,46,60,"Pilot 9","Pilot 9: bigger feedback + text"
42,"SUPPRF35697",43,52,58,12,29,41,29,46,"Pilot 9","Pilot 9: bigger feedback + text"
43,"SUPPRF35697",41,51,58,9,12,38,46,49,"Pilot 9","Pilot 9: bigger feedback + text"
44,"SUPPRF35697",42,50,71,24,0,36,71,47,"Pilot 9","Pilot 9: bigger feedback + text"
45,"SUPPRF35697",45,56,62,8,-1,41,63,54,"Pilot 9","Pilot 9: bigger feedback + text"
46,"SUPPRF35697",27,51,19,-5,-1,24,20,24,"Pilot 9","Pilot 9: bigger feedback + text"
47,"SUPPRF35697",53,44,78,29,24,40,54,49,"Pilot 9","Pilot 9: bigger feedback + text"
48,"SUPPRF35697",71,34,96,23,16,71,80,73,"Pilot 9","Pilot 9: bigger feedback + text"
1,"SUPPRF37035",48,46,45,8,-1,31,46,37,"Pilot 9","Pilot 9: bigger feedback + text"
2,"SUPPRF37035",45,45,19,-1,-1,97,20,20,"Pilot 9","Pilot 9: bigger feedback + text"
3,"SUPPRF37035",49,49,20,4,0,41,20,16,"Pilot 9","Pilot 9: bigger feedback + text"
4,"SUPPRF37035",47,51,49,7,12,49,37,42,"Pilot 9","Pilot 9: bigger feedback + text"
5,"SUPPRF37035",51,50,81,25,1,48,80,56,"Pilot 9","Pilot 9: bigger feedback + text"
6,"SUPPRF37035",23,26,96,20,16,96,80,76,"Pilot 9","Pilot 9: bigger feedback + text"
7,"SUPPRF37035",44,45,77,36,14,39,63,41,"Pilot 9","Pilot 9: bigger feedback + text"
8,"SUPPRF37035",49,48,71,19,0,71,71,52,"Pilot 9","Pilot 9: bigger feedback + text"
9,"SUPPRF37035",57,52,88,22,25,96,63,66,"Pilot 9","Pilot 9: bigger feedback + text"
10,"SUPPRF37035",49,56,61,10,24,80,37,51,"Pilot 9","Pilot 9: bigger feedback + text"
11,"SUPPRF37035",49,50,8,-8,-12,85,20,16,"Pilot 9","Pilot 9: bigger feedback + text"
12,"SUPPRF37035",51,53,38,1,-16,49,54,37,"Pilot 9","Pilot 9: bigger feedback + text"
13,"SUPPRF37035",51,54,78,26,24,55,54,52,"Pilot 9","Pilot 9: bigger feedback + text"
14,"SUPPRF37035",51,53,41,-21,-13,84,54,62,"Pilot 9","Pilot 9: bigger feedback + text"
15,"SUPPRF37035",55,57,58,15,12,41,46,43,"Pilot 9","Pilot 9: bigger feedback + text"
16,"SUPPRF37035",59,53,50,1,-13,71,63,49,"Pilot 9","Pilot 9: bigger feedback + text"
17,"SUPPRF37035",54,52,83,29,12,85,71,54,"Pilot 9","Pilot 9: bigger feedback + text"
18,"SUPPRF37035",49,49,24,-9,-13,86,37,33,"Pilot 9","Pilot 9: bigger feedback + text"
19,"SUPPRF37035",48,51,22,-2,-15,95,37,24,"Pilot 9","Pilot 9: bigger feedback + text"
20,"SUPPRF37035",55,57,54,7,0,89,54,47,"Pilot 9","Pilot 9: bigger feedback + text"
21,"SUPPRF37035",52,55,56,2,-15,81,71,54,"Pilot 9","Pilot 9: bigger feedback + text"
22,"SUPPRF37035",45,49,35,19,15,92,20,16,"Pilot 9","Pilot 9: bigger feedback + text"
23,"SUPPRF37035",59,59,75,37,29,81,46,38,"Pilot 9","Pilot 9: bigger feedback + text"
24,"SUPPRF37035",48,54,55,10,1,86,54,45,"Pilot 9","Pilot 9: bigger feedback + text"
25,"SUPPRF37035",53,63,58,27,29,84,29,31,"Pilot 9","Pilot 9: bigger feedback + text"
26,"SUPPRF37035",21,79,67,-12,-13,86,80,79,"Pilot 9","Pilot 9: bigger feedback + text"
27,"SUPPRF37035",52,44,33,-30,-13,60,46,63,"Pilot 9","Pilot 9: bigger feedback + text"
28,"SUPPRF37035",53,51,100,72,20,31,80,28,"Pilot 9","Pilot 9: bigger feedback + text"
29,"SUPPRF37035",51,55,70,28,-1,44,71,42,"Pilot 9","Pilot 9: bigger feedback + text"
30,"SUPPRF37035",50,50,15,-20,-14,71,29,35,"Pilot 9","Pilot 9: bigger feedback + text"
31,"SUPPRF37035",55,55,66,15,12,55,54,51,"Pilot 9","Pilot 9: bigger feedback + text"
32,"SUPPRF37035",55,53,37,-10,0,82,37,47,"Pilot 9","Pilot 9: bigger feedback + text"
33,"SUPPRF37035",50,49,47,12,27,33,20,35,"Pilot 9","Pilot 9: bigger feedback + text"
34,"SUPPRF37035",52,53,47,1,-16,69,63,46,"Pilot 9","Pilot 9: bigger feedback + text"
35,"SUPPRF37035",51,50,28,-8,-1,84,29,36,"Pilot 9","Pilot 9: bigger feedback + text"
36,"SUPPRF37035",47,50,68,42,-12,81,80,26,"Pilot 9","Pilot 9: bigger feedback + text"
37,"SUPPRF37035",51,49,55,-2,-16,57,71,57,"Pilot 9","Pilot 9: bigger feedback + text"
38,"SUPPRF37035",55,54,34,-14,-12,82,46,48,"Pilot 9","Pilot 9: bigger feedback + text"
39,"SUPPRF37035",50,51,38,-15,1,83,37,53,"Pilot 9","Pilot 9: bigger feedback + text"
40,"SUPPRF37035",50,48,80,-1,0,79,80,81,"Pilot 9","Pilot 9: bigger feedback + text"
41,"SUPPRF37035",52,56,46,-10,17,53,29,56,"Pilot 9","Pilot 9: bigger feedback + text"
42,"SUPPRF37035",52,50,46,-2,0,52,46,48,"Pilot 9","Pilot 9: bigger feedback + text"
43,"SUPPRF37035",52,56,16,-39,-13,59,29,55,"Pilot 9","Pilot 9: bigger feedback + text"
44,"SUPPRF37035",54,54,29,5,0,86,29,24,"Pilot 9","Pilot 9: bigger feedback + text"
45,"SUPPRF37035",49,53,6,-12,-14,84,20,18,"Pilot 9","Pilot 9: bigger feedback + text"
46,"SUPPRF37035",62,58,94,32,23,67,71,62,"Pilot 9","Pilot 9: bigger feedback + text"
47,"SUPPRF37035",52,61,63,12,0,77,63,51,"Pilot 9","Pilot 9: bigger feedback + text"
48,"SUPPRF37035",55,54,62,13,-1,51,63,49,"Pilot 9","Pilot 9: bigger feedback + text"
1,"SUPPRF68142",50,37,15,-11,-14,39,29,26,"Pilot 9","Pilot 9: bigger feedback + text"
2,"SUPPRF68142",49,52,75,43,29,48,46,32,"Pilot 9","Pilot 9: bigger feedback + text"
3,"SUPPRF68142",48,27,56,-1,-15,50,71,57,"Pilot 9","Pilot 9: bigger feedback + text"
4,"SUPPRF68142",52,50,22,-31,-15,50,37,53,"Pilot 9","Pilot 9: bigger feedback + text"
5,"SUPPRF68142",48,51,100,58,20,48,80,42,"Pilot 9","Pilot 9: bigger feedback + text"
6,"SUPPRF68142",47,46,77,25,14,50,63,52,"Pilot 9","Pilot 9: bigger feedback + text"
7,"SUPPRF68142",50,51,61,33,24,33,37,28,"Pilot 9","Pilot 9: bigger feedback + text"
8,"SUPPRF68142",42,45,94,31,23,52,71,63,"Pilot 9","Pilot 9: bigger feedback + text"
9,"SUPPRF68142",51,45,33,-12,-13,45,46,45,"Pilot 9","Pilot 9: bigger feedback + text"
10,"SUPPRF68142",49,49,83,29,12,48,71,54,"Pilot 9","Pilot 9: bigger feedback + text"
11,"SUPPRF68142",52,42,62,4,-1,46,63,58,"Pilot 9","Pilot 9: bigger feedback + text"
12,"SUPPRF68142",44,50,71,24,0,50,71,47,"Pilot 9","Pilot 9: bigger feedback + text"
13,"SUPPRF68142",50,48,66,11,12,38,54,55,"Pilot 9","Pilot 9: bigger feedback + text"
14,"SUPPRF68142",46,47,47,24,27,44,20,23,"Pilot 9","Pilot 9: bigger feedback + text"
15,"SUPPRF68142",49,45,46,23,17,55,29,23,"Pilot 9","Pilot 9: bigger feedback + text"
16,"SUPPRF68142",48,49,28,-20,-1,43,29,48,"Pilot 9","Pilot 9: bigger feedback + text"
17,"SUPPRF68142",52,50,38,-4,1,30,37,42,"Pilot 9","Pilot 9: bigger feedback + text"
18,"SUPPRF68142",49,48,20,-7,0,68,20,27,"Pilot 9","Pilot 9: bigger feedback + text"
19,"SUPPRF68142",47,50,47,-11,-16,40,63,58,"Pilot 9","Pilot 9: bigger feedback + text"
20,"SUPPRF68142",49,54,38,-29,-16,50,54,67,"Pilot 9","Pilot 9: bigger feedback + text"
21,"SUPPRF68142",51,45,78,23,24,66,54,55,"Pilot 9","Pilot 9: bigger feedback + text"
22,"SUPPRF68142",48,46,67,2,-13,41,80,65,"Pilot 9","Pilot 9: bigger feedback + text"
23,"SUPPRF68142",48,46,41,-11,-13,48,54,52,"Pilot 9","Pilot 9: bigger feedback + text"
24,"SUPPRF68142",49,48,58,9,12,45,46,49,"Pilot 9","Pilot 9: bigger feedback + text"
25,"SUPPRF68142",51,47,70,18,-1,46,71,52,"Pilot 9","Pilot 9: bigger feedback + text"
26,"SUPPRF68142",53,49,45,-6,-1,48,46,51,"Pilot 9","Pilot 9: bigger feedback + text"
27,"SUPPRF68142",48,46,16,-30,-13,51,29,46,"Pilot 9","Pilot 9: bigger feedback + text"
28,"SUPPRF68142",46,51,58,28,29,71,29,30,"Pilot 9","Pilot 9: bigger feedback + text"
29,"SUPPRF68142",25,22,46,-4,0,50,46,50,"Pilot 9","Pilot 9: bigger feedback + text"
30,"SUPPRF68142",38,48,68,15,-12,49,80,53,"Pilot 9","Pilot 9: bigger feedback + text"
31,"SUPPRF68142",50,31,50,1,-13,0,63,49,"Pilot 9","Pilot 9: bigger feedback + text"
32,"SUPPRF68142",50,48,88,37,25,49,63,51,"Pilot 9","Pilot 9: bigger feedback + text"
33,"SUPPRF68142",49,50,29,-25,0,47,29,54,"Pilot 9","Pilot 9: bigger feedback + text"
34,"SUPPRF68142",48,47,55,-17,-16,69,71,72,"Pilot 9","Pilot 9: bigger feedback + text"
35,"SUPPRF68142",48,43,63,15,0,45,63,48,"Pilot 9","Pilot 9: bigger feedback + text"
36,"SUPPRF68142",46,47,19,-28,-1,2,20,47,"Pilot 9","Pilot 9: bigger feedback + text"
37,"SUPPRF68142",42,42,24,-9,-13,4,37,33,"Pilot 9","Pilot 9: bigger feedback + text"
38,"SUPPRF68142",42,46,54,51,0,63,54,3,"Pilot 9","Pilot 9: bigger feedback + text"
39,"SUPPRF68142",49,46,81,36,1,41,80,45,"Pilot 9","Pilot 9: bigger feedback + text"
40,"SUPPRF68142",46,45,49,2,12,46,37,47,"Pilot 9","Pilot 9: bigger feedback + text"
41,"SUPPRF68142",47,47,34,-9,-12,43,46,43,"Pilot 9","Pilot 9: bigger feedback + text"
42,"SUPPRF68142",46,48,80,33,0,24,80,47,"Pilot 9","Pilot 9: bigger feedback + text"
43,"SUPPRF68142",44,46,35,-3,15,14,20,38,"Pilot 9","Pilot 9: bigger feedback + text"
44,"SUPPRF68142",38,42,6,-37,-14,45,20,43,"Pilot 9","Pilot 9: bigger feedback + text"
45,"SUPPRF68142",39,48,55,14,1,59,54,41,"Pilot 9","Pilot 9: bigger feedback + text"
46,"SUPPRF68142",50,45,96,45,16,54,80,51,"Pilot 9","Pilot 9: bigger feedback + text"
47,"SUPPRF68142",27,45,8,-35,-12,46,20,43,"Pilot 9","Pilot 9: bigger feedback + text"
48,"SUPPRF68142",46,48,37,-6,0,45,37,43,"Pilot 9","Pilot 9: bigger feedback + text"
1,"SUPPRF88148",51,2,94,53,23,26,71,41,"Pilot 9","Pilot 9: bigger feedback + text"
2,"SUPPRF88148",55,0,100,56,20,14,80,44,"Pilot 9","Pilot 9: bigger feedback + text"
3,"SUPPRF88148",49,2,77,26,14,58,63,51,"Pilot 9","Pilot 9: bigger feedback + text"
4,"SUPPRF88148",39,1,16,-36,-13,15,29,52,"Pilot 9","Pilot 9: bigger feedback + text"
5,"SUPPRF88148",53,2,70,13,-1,60,71,57,"Pilot 9","Pilot 9: bigger feedback + text"
6,"SUPPRF88148",47,1,29,11,0,63,29,18,"Pilot 9","Pilot 9: bigger feedback + text"
7,"SUPPRF88148",45,1,41,-7,-13,73,54,48,"Pilot 9","Pilot 9: bigger feedback + text"
8,"SUPPRF88148",65,1,45,34,-1,74,46,11,"Pilot 9","Pilot 9: bigger feedback + text"
9,"SUPPRF88148",57,3,56,-4,-15,70,71,60,"Pilot 9","Pilot 9: bigger feedback + text"
10,"SUPPRF88148",52,1,28,1,-1,50,29,27,"Pilot 9","Pilot 9: bigger feedback + text"
11,"SUPPRF88148",50,1,46,24,0,33,46,22,"Pilot 9","Pilot 9: bigger feedback + text"
12,"SUPPRF88148",54,3,71,9,0,61,71,62,"Pilot 9","Pilot 9: bigger feedback + text"
13,"SUPPRF88148",47,5,47,23,27,35,20,24,"Pilot 9","Pilot 9: bigger feedback + text"
14,"SUPPRF88148",60,1,58,40,29,60,29,18,"Pilot 9","Pilot 9: bigger feedback + text"
15,"SUPPRF88148",49,2,35,19,15,61,20,16,"Pilot 9","Pilot 9: bigger feedback + text"
16,"SUPPRF88148",53,2,81,17,1,53,80,64,"Pilot 9","Pilot 9: bigger feedback + text"
17,"SUPPRF88148",61,1,54,15,0,47,54,39,"Pilot 9","Pilot 9: bigger feedback + text"
18,"SUPPRF88148",45,0,49,20,12,60,37,29,"Pilot 9","Pilot 9: bigger feedback + text"
19,"SUPPRF88148",50,0,22,-13,-15,60,37,35,"Pilot 9","Pilot 9: bigger feedback + text"
20,"SUPPRF88148",53,1,55,8,-16,51,71,47,"Pilot 9","Pilot 9: bigger feedback + text"
21,"SUPPRF88148",44,2,38,9,1,14,37,29,"Pilot 9","Pilot 9: bigger feedback + text"
22,"SUPPRF88148",45,5,50,21,-13,67,63,29,"Pilot 9","Pilot 9: bigger feedback + text"
23,"SUPPRF88148",45,0,61,39,24,14,37,22,"Pilot 9","Pilot 9: bigger feedback + text"
24,"SUPPRF88148",43,0,38,3,-16,44,54,35,"Pilot 9","Pilot 9: bigger feedback + text"
25,"SUPPRF88148",44,1,47,18,-16,52,63,29,"Pilot 9","Pilot 9: bigger feedback + text"
26,"SUPPRF88148",52,1,80,30,0,73,80,50,"Pilot 9","Pilot 9: bigger feedback + text"
27,"SUPPRF88148",41,0,83,31,12,53,71,52,"Pilot 9","Pilot 9: bigger feedback + text"
28,"SUPPRF88148",29,1,62,31,-1,67,63,31,"Pilot 9","Pilot 9: bigger feedback + text"
29,"SUPPRF88148",45,2,67,-12,-13,67,80,79,"Pilot 9","Pilot 9: bigger feedback + text"
30,"SUPPRF88148",31,53,37,6,0,52,37,31,"Pilot 9","Pilot 9: bigger feedback + text"
31,"SUPPRF88148",57,8,78,59,24,68,54,19,"Pilot 9","Pilot 9: bigger feedback + text"
32,"SUPPRF88148",52,0,15,-5,-14,86,29,20,"Pilot 9","Pilot 9: bigger feedback + text"
33,"SUPPRF88148",35,0,88,62,25,79,63,26,"Pilot 9","Pilot 9: bigger feedback + text"
34,"SUPPRF88148",32,19,20,-4,0,76,20,24,"Pilot 9","Pilot 9: bigger feedback + text"
35,"SUPPRF88148",30,5,46,31,17,85,29,15,"Pilot 9","Pilot 9: bigger feedback + text"
36,"SUPPRF88148",25,1,33,-1,-13,55,46,34,"Pilot 9","Pilot 9: bigger feedback + text"
37,"SUPPRF88148",26,4,96,58,16,20,80,38,"Pilot 9","Pilot 9: bigger feedback + text"
38,"SUPPRF88148",26,0,19,3,-1,63,20,16,"Pilot 9","Pilot 9: bigger feedback + text"
39,"SUPPRF88148",28,2,68,62,-12,82,80,6,"Pilot 9","Pilot 9: bigger feedback + text"
40,"SUPPRF88148",29,3,55,37,1,70,54,18,"Pilot 9","Pilot 9: bigger feedback + text"
41,"SUPPRF88148",7,7,66,53,12,88,54,13,"Pilot 9","Pilot 9: bigger feedback + text"
42,"SUPPRF88148",33,7,34,-15,-12,62,46,49,"Pilot 9","Pilot 9: bigger feedback + text"
43,"SUPPRF88148",32,10,24,0,-13,20,37,24,"Pilot 9","Pilot 9: bigger feedback + text"
44,"SUPPRF88148",12,6,8,-8,-12,20,20,16,"Pilot 9","Pilot 9: bigger feedback + text"
45,"SUPPRF88148",72,1,75,43,29,26,46,32,"Pilot 9","Pilot 9: bigger feedback + text"
46,"SUPPRF88148",35,6,63,-1,0,69,63,64,"Pilot 9","Pilot 9: bigger feedback + text"
47,"SUPPRF88148",15,2,6,-7,-14,69,20,13,"Pilot 9","Pilot 9: bigger feedback + text"
48,"SUPPRF88148",21,2,58,20,12,11,46,38,"Pilot 9","Pilot 9: bigger feedback + text"
1,"SUPPRF99152",99,41,100,34,20,26,80,66,"Pilot 9","Pilot 9: bigger feedback + text"
2,"SUPPRF99152",69,37,62,-8,-1,53,63,70,"Pilot 9","Pilot 9: bigger feedback + text"
3,"SUPPRF99152",73,38,35,5,15,59,20,30,"Pilot 9","Pilot 9: bigger feedback + text"
4,"SUPPRF99152",52,49,19,-11,-1,26,20,30,"Pilot 9","Pilot 9: bigger feedback + text"
5,"SUPPRF99152",37,52,22,-18,-15,50,37,40,"Pilot 9","Pilot 9: bigger feedback + text"
6,"SUPPRF99152",28,62,24,-26,-13,50,37,50,"Pilot 9","Pilot 9: bigger feedback + text"
7,"SUPPRF99152",55,44,58,14,12,43,46,44,"Pilot 9","Pilot 9: bigger feedback + text"
8,"SUPPRF99152",62,37,71,12,0,36,71,59,"Pilot 9","Pilot 9: bigger feedback + text"
9,"SUPPRF99152",65,37,78,28,24,25,54,50,"Pilot 9","Pilot 9: bigger feedback + text"
10,"SUPPRF99152",74,35,58,14,29,28,29,44,"Pilot 9","Pilot 9: bigger feedback + text"
11,"SUPPRF99152",50,50,41,-24,-13,62,54,65,"Pilot 9","Pilot 9: bigger feedback + text"
12,"SUPPRF99152",40,54,16,-14,-13,26,29,30,"Pilot 9","Pilot 9: bigger feedback + text"
13,"SUPPRF99152",64,31,47,19,27,29,20,28,"Pilot 9","Pilot 9: bigger feedback + text"
14,"SUPPRF99152",52,42,50,-10,-13,25,63,60,"Pilot 9","Pilot 9: bigger feedback + text"
15,"SUPPRF99152",57,35,54,0,0,37,54,54,"Pilot 9","Pilot 9: bigger feedback + text"
16,"SUPPRF99152",49,52,29,-11,0,24,29,40,"Pilot 9","Pilot 9: bigger feedback + text"
17,"SUPPRF99152",69,33,88,33,25,45,63,55,"Pilot 9","Pilot 9: bigger feedback + text"
18,"SUPPRF99152",52,53,28,-12,-1,55,29,40,"Pilot 9","Pilot 9: bigger feedback + text"
19,"SUPPRF99152",81,31,96,46,16,33,80,50,"Pilot 9","Pilot 9: bigger feedback + text"
20,"SUPPRF99152",48,51,33,-17,-13,44,46,50,"Pilot 9","Pilot 9: bigger feedback + text"
21,"SUPPRF99152",55,45,38,-8,1,42,37,46,"Pilot 9","Pilot 9: bigger feedback + text"
22,"SUPPRF99152",55,37,46,16,17,18,29,30,"Pilot 9","Pilot 9: bigger feedback + text"
23,"SUPPRF99152",59,35,61,17,24,35,37,44,"Pilot 9","Pilot 9: bigger feedback + text"
24,"SUPPRF99152",68,41,37,-5,0,39,37,42,"Pilot 9","Pilot 9: bigger feedback + text"
25,"SUPPRF99152",68,45,66,12,12,56,54,54,"Pilot 9","Pilot 9: bigger feedback + text"
26,"SUPPRF99152",72,25,81,14,1,41,80,67,"Pilot 9","Pilot 9: bigger feedback + text"
27,"SUPPRF99152",69,26,49,-2,12,21,37,51,"Pilot 9","Pilot 9: bigger feedback + text"
28,"SUPPRF99152",56,47,45,16,-1,34,46,29,"Pilot 9","Pilot 9: bigger feedback + text"
29,"SUPPRF99152",54,52,38,-14,-16,53,54,52,"Pilot 9","Pilot 9: bigger feedback + text"
30,"SUPPRF99152",66,33,56,2,-15,26,71,54,"Pilot 9","Pilot 9: bigger feedback + text"
31,"SUPPRF99152",67,46,20,0,0,53,20,20,"Pilot 9","Pilot 9: bigger feedback + text"
32,"SUPPRF99152",67,35,55,0,1,71,54,55,"Pilot 9","Pilot 9: bigger feedback + text"
33,"SUPPRF99152",69,43,46,11,0,56,46,35,"Pilot 9","Pilot 9: bigger feedback + text"
34,"SUPPRF99152",67,44,83,33,12,43,71,50,"Pilot 9","Pilot 9: bigger feedback + text"
35,"SUPPRF99152",61,33,67,-4,-13,59,80,71,"Pilot 9","Pilot 9: bigger feedback + text"
36,"SUPPRF99152",68,31,68,-4,-12,60,80,72,"Pilot 9","Pilot 9: bigger feedback + text"
37,"SUPPRF99152",64,37,63,15,0,40,63,48,"Pilot 9","Pilot 9: bigger feedback + text"
38,"SUPPRF99152",56,50,15,-17,-14,56,29,32,"Pilot 9","Pilot 9: bigger feedback + text"
39,"SUPPRF99152",64,41,70,6,-1,33,71,64,"Pilot 9","Pilot 9: bigger feedback + text"
40,"SUPPRF99152",72,32,75,27,29,58,46,48,"Pilot 9","Pilot 9: bigger feedback + text"
41,"SUPPRF99152",57,44,55,-17,-16,40,71,72,"Pilot 9","Pilot 9: bigger feedback + text"
42,"SUPPRF99152",55,49,47,-11,-16,30,63,58,"Pilot 9","Pilot 9: bigger feedback + text"
43,"SUPPRF99152",83,26,94,21,23,57,71,73,"Pilot 9","Pilot 9: bigger feedback + text"
44,"SUPPRF99152",39,66,6,-24,-14,31,20,30,"Pilot 9","Pilot 9: bigger feedback + text"
45,"SUPPRF99152",24,65,8,-17,-12,27,20,25,"Pilot 9","Pilot 9: bigger feedback + text"
46,"SUPPRF99152",50,50,34,-6,-12,36,46,40,"Pilot 9","Pilot 9: bigger feedback + text"
47,"SUPPRF99152",63,47,80,-1,0,50,80,81,"Pilot 9","Pilot 9: bigger feedback + text"
48,"SUPPRF99152",66,46,77,26,14,32,63,51,"Pilot 9","Pilot 9: bigger feedback + text"
1,"SUPPRF85444",66,66,58,-7,29,27,29,65,"Pilot 9","Pilot 9: bigger feedback + text"
2,"SUPPRF85444",34,75,29,-25,0,63,29,54,"Pilot 9","Pilot 9: bigger feedback + text"
3,"SUPPRF85444",57,62,47,25,27,63,20,22,"Pilot 9","Pilot 9: bigger feedback + text"
4,"SUPPRF85444",84,30,88,5,25,79,63,83,"Pilot 9","Pilot 9: bigger feedback + text"
5,"SUPPRF85444",67,40,80,18,0,57,80,62,"Pilot 9","Pilot 9: bigger feedback + text"
6,"SUPPRF85444",67,26,83,1,12,86,71,82,"Pilot 9","Pilot 9: bigger feedback + text"
7,"SUPPRF85444",63,33,22,-11,-15,71,37,33,"Pilot 9","Pilot 9: bigger feedback + text"
8,"SUPPRF85444",54,27,28,-7,-1,55,29,35,"Pilot 9","Pilot 9: bigger feedback + text"
9,"SUPPRF85444",64,19,38,9,1,57,37,29,"Pilot 9","Pilot 9: bigger feedback + text"
10,"SUPPRF85444",67,8,66,2,12,78,54,64,"Pilot 9","Pilot 9: bigger feedback + text"
11,"SUPPRF85444",26,22,15,-17,-14,66,29,32,"Pilot 9","Pilot 9: bigger feedback + text"
12,"SUPPRF85444",75,4,62,-8,-1,71,63,70,"Pilot 9","Pilot 9: bigger feedback + text"
13,"SUPPRF85444",77,2,68,28,-12,40,80,40,"Pilot 9","Pilot 9: bigger feedback + text"
14,"SUPPRF85444",82,2,49,41,12,38,37,8,"Pilot 9","Pilot 9: bigger feedback + text"
15,"SUPPRF85444",67,2,70,-7,-1,81,71,77,"Pilot 9","Pilot 9: bigger feedback + text"
16,"SUPPRF85444",88,0,78,12,24,66,54,66,"Pilot 9","Pilot 9: bigger feedback + text"
17,"SUPPRF85444",94,0,35,16,15,51,20,19,"Pilot 9","Pilot 9: bigger feedback + text"
18,"SUPPRF85444",30,1,24,-29,-13,63,37,53,"Pilot 9","Pilot 9: bigger feedback + text"
19,"SUPPRF85444",50,4,41,-24,-13,54,54,65,"Pilot 9","Pilot 9: bigger feedback + text"
20,"SUPPRF85444",77,1,67,-12,-13,79,80,79,"Pilot 9","Pilot 9: bigger feedback + text"
21,"SUPPRF85444",75,0,61,25,24,38,37,36,"Pilot 9","Pilot 9: bigger feedback + text"
22,"SUPPRF85444",69,1,37,-2,0,70,37,39,"Pilot 9","Pilot 9: bigger feedback + text"
23,"SUPPRF85444",80,0,75,43,29,59,46,32,"Pilot 9","Pilot 9: bigger feedback + text"
24,"SUPPRF85444",85,0,100,27,20,78,80,73,"Pilot 9","Pilot 9: bigger feedback + text"
25,"SUPPRF85444",76,1,77,17,14,78,63,60,"Pilot 9","Pilot 9: bigger feedback + text"
26,"SUPPRF85444",77,1,63,-3,0,83,63,66,"Pilot 9","Pilot 9: bigger feedback + text"
27,"SUPPRF85444",92,1,96,16,16,84,80,80,"Pilot 9","Pilot 9: bigger feedback + text"
28,"SUPPRF85444",76,1,20,-39,0,80,20,59,"Pilot 9","Pilot 9: bigger feedback + text"
29,"SUPPRF85444",86,1,45,7,-1,38,46,38,"Pilot 9","Pilot 9: bigger feedback + text"
30,"SUPPRF85444",27,1,34,-16,-12,72,46,50,"Pilot 9","Pilot 9: bigger feedback + text"
31,"SUPPRF85444",90,0,81,5,1,71,80,76,"Pilot 9","Pilot 9: bigger feedback + text"
32,"SUPPRF85444",86,0,54,-1,0,85,54,55,"Pilot 9","Pilot 9: bigger feedback + text"
33,"SUPPRF85444",79,1,38,-17,-16,76,54,55,"Pilot 9","Pilot 9: bigger feedback + text"
34,"SUPPRF85444",80,1,58,2,12,72,46,56,"Pilot 9","Pilot 9: bigger feedback + text"
35,"SUPPRF85444",80,0,6,-16,-14,78,20,22,"Pilot 9","Pilot 9: bigger feedback + text"
36,"SUPPRF85444",62,2,56,17,-15,55,71,39,"Pilot 9","Pilot 9: bigger feedback + text"
37,"SUPPRF85444",54,2,55,-14,1,73,54,69,"Pilot 9","Pilot 9: bigger feedback + text"
38,"SUPPRF85444",77,1,71,20,0,27,71,51,"Pilot 9","Pilot 9: bigger feedback + text"
39,"SUPPRF85444",78,1,46,10,17,73,29,36,"Pilot 9","Pilot 9: bigger feedback + text"
40,"SUPPRF85444",19,0,19,-24,-1,75,20,43,"Pilot 9","Pilot 9: bigger feedback + text"
41,"SUPPRF85444",23,0,47,-4,-16,76,63,51,"Pilot 9","Pilot 9: bigger feedback + text"
42,"SUPPRF85444",92,1,94,39,23,78,71,55,"Pilot 9","Pilot 9: bigger feedback + text"
43,"SUPPRF85444",22,1,46,-19,0,33,46,65,"Pilot 9","Pilot 9: bigger feedback + text"
44,"SUPPRF85444",14,0,8,-43,-12,67,20,51,"Pilot 9","Pilot 9: bigger feedback + text"
45,"SUPPRF85444",19,1,33,-19,-13,29,46,52,"Pilot 9","Pilot 9: bigger feedback + text"
46,"SUPPRF85444",9,0,55,-4,-16,78,71,59,"Pilot 9","Pilot 9: bigger feedback + text"
47,"SUPPRF85444",10,0,50,-5,-13,31,63,55,"Pilot 9","Pilot 9: bigger feedback + text"
48,"SUPPRF85444",6,1,16,-35,-13,37,29,51,"Pilot 9","Pilot 9: bigger feedback + text"
1,"SUPPRF85297",41,60,38,-1,1,65,37,39,"Pilot 9","Pilot 9: bigger feedback + text"
2,"SUPPRF85297",43,50,58,14,12,61,46,44,"Pilot 9","Pilot 9: bigger feedback + text"
3,"SUPPRF85297",43,48,46,-4,0,66,46,50,"Pilot 9","Pilot 9: bigger feedback + text"
4,"SUPPRF85297",44,52,28,-8,-1,54,29,36,"Pilot 9","Pilot 9: bigger feedback + text"
5,"SUPPRF85297",50,46,75,27,29,67,46,48,"Pilot 9","Pilot 9: bigger feedback + text"
6,"SUPPRF85297",43,62,33,1,-13,48,46,32,"Pilot 9","Pilot 9: bigger feedback + text"
7,"SUPPRF85297",52,61,62,-3,-1,68,63,65,"Pilot 9","Pilot 9: bigger feedback + text"
8,"SUPPRF85297",46,56,61,25,24,63,37,36,"Pilot 9","Pilot 9: bigger feedback + text"
9,"SUPPRF85297",46,52,35,12,15,58,20,23,"Pilot 9","Pilot 9: bigger feedback + text"
10,"SUPPRF85297",43,49,66,11,12,34,54,55,"Pilot 9","Pilot 9: bigger feedback + text"
11,"SUPPRF85297",47,49,63,-3,0,47,63,66,"Pilot 9","Pilot 9: bigger feedback + text"
12,"SUPPRF85297",49,53,50,1,-13,5,63,49,"Pilot 9","Pilot 9: bigger feedback + text"
13,"SUPPRF85297",44,47,24,-25,-13,16,37,49,"Pilot 9","Pilot 9: bigger feedback + text"
14,"SUPPRF85297",49,53,81,-5,1,70,80,86,"Pilot 9","Pilot 9: bigger feedback + text"
15,"SUPPRF85297",57,48,58,32,29,58,29,26,"Pilot 9","Pilot 9: bigger feedback + text"
16,"SUPPRF85297",32,54,38,-25,-16,60,54,63,"Pilot 9","Pilot 9: bigger feedback + text"
17,"SUPPRF85297",61,48,80,0,0,64,80,80,"Pilot 9","Pilot 9: bigger feedback + text"
18,"SUPPRF85297",52,57,29,5,0,44,29,24,"Pilot 9","Pilot 9: bigger feedback + text"
19,"SUPPRF85297",31,59,22,-27,-15,17,37,49,"Pilot 9","Pilot 9: bigger feedback + text"
20,"SUPPRF85297",39,47,19,-5,-1,53,20,24,"Pilot 9","Pilot 9: bigger feedback + text"
21,"SUPPRF85297",75,48,94,15,23,69,71,79,"Pilot 9","Pilot 9: bigger feedback + text"
22,"SUPPRF85297",52,42,55,-25,-16,75,71,80,"Pilot 9","Pilot 9: bigger feedback + text"
23,"SUPPRF85297",48,50,15,-3,-14,65,29,18,"Pilot 9","Pilot 9: bigger feedback + text"
24,"SUPPRF85297",48,40,34,6,-12,66,46,28,"Pilot 9","Pilot 9: bigger feedback + text"
25,"SUPPRF85297",47,48,83,32,12,50,71,51,"Pilot 9","Pilot 9: bigger feedback + text"
26,"SUPPRF85297",50,49,47,9,-16,45,63,38,"Pilot 9","Pilot 9: bigger feedback + text"
27,"SUPPRF85297",50,48,47,24,27,72,20,23,"Pilot 9","Pilot 9: bigger feedback + text"
28,"SUPPRF85297",50,50,96,43,16,24,80,53,"Pilot 9","Pilot 9: bigger feedback + text"
29,"SUPPRF85297",51,48,70,13,-1,19,71,57,"Pilot 9","Pilot 9: bigger feedback + text"
30,"SUPPRF85297",39,49,8,-18,-12,64,20,26,"Pilot 9","Pilot 9: bigger feedback + text"
31,"SUPPRF85297",46,50,54,-6,0,19,54,60,"Pilot 9","Pilot 9: bigger feedback + text"
32,"SUPPRF85297",48,47,37,11,0,48,37,26,"Pilot 9","Pilot 9: bigger feedback + text"
33,"SUPPRF85297",52,52,77,43,14,49,63,34,"Pilot 9","Pilot 9: bigger feedback + text"
34,"SUPPRF85297",49,56,78,8,24,38,54,70,"Pilot 9","Pilot 9: bigger feedback + text"
35,"SUPPRF85297",51,52,71,31,0,37,71,40,"Pilot 9","Pilot 9: bigger feedback + text"
36,"SUPPRF85297",33,48,6,-14,-14,65,20,20,"Pilot 9","Pilot 9: bigger feedback + text"
37,"SUPPRF85297",44,50,56,-24,-15,51,71,80,"Pilot 9","Pilot 9: bigger feedback + text"
38,"SUPPRF85297",48,51,41,-18,-13,64,54,59,"Pilot 9","Pilot 9: bigger feedback + text"
39,"SUPPRF85297",49,52,55,15,1,45,54,40,"Pilot 9","Pilot 9: bigger feedback + text"
40,"SUPPRF85297",50,52,49,18,12,64,37,31,"Pilot 9","Pilot 9: bigger feedback + text"
41,"SUPPRF85297",49,49,46,-6,17,53,29,52,"Pilot 9","Pilot 9: bigger feedback + text"
42,"SUPPRF85297",49,52,100,60,20,50,80,40,"Pilot 9","Pilot 9: bigger feedback + text"
43,"SUPPRF85297",52,53,45,9,-1,55,46,36,"Pilot 9","Pilot 9: bigger feedback + text"
44,"SUPPRF85297",52,61,68,4,-12,59,80,64,"Pilot 9","Pilot 9: bigger feedback + text"
45,"SUPPRF85297",40,42,16,-37,-13,22,29,53,"Pilot 9","Pilot 9: bigger feedback + text"
46,"SUPPRF85297",52,51,67,-17,-13,78,80,84,"Pilot 9","Pilot 9: bigger feedback + text"
47,"SUPPRF85297",48,46,20,-31,0,51,20,51,"Pilot 9","Pilot 9: bigger feedback + text"
48,"SUPPRF85297",49,48,88,58,25,66,63,30,"Pilot 9","Pilot 9: bigger feedback + text"
1,"SUPPRF10856",67,37,80,5,0,65,80,75,"Pilot 9","Pilot 9: bigger feedback + text"
2,"SUPPRF10856",68,53,62,31,-1,74,63,31,"Pilot 9","Pilot 9: bigger feedback + text"
3,"SUPPRF10856",62,46,47,-21,-16,75,63,68,"Pilot 9","Pilot 9: bigger feedback + text"
4,"SUPPRF10856",60,41,22,-23,-15,40,37,45,"Pilot 9","Pilot 9: bigger feedback + text"
5,"SUPPRF10856",46,60,58,13,12,70,46,45,"Pilot 9","Pilot 9: bigger feedback + text"
6,"SUPPRF10856",61,46,24,-16,-13,75,37,40,"Pilot 9","Pilot 9: bigger feedback + text"
7,"SUPPRF10856",60,39,68,-12,-12,75,80,80,"Pilot 9","Pilot 9: bigger feedback + text"
8,"SUPPRF10856",54,43,46,13,17,75,29,33,"Pilot 9","Pilot 9: bigger feedback + text"
9,"SUPPRF10856",60,46,55,-15,-16,75,71,70,"Pilot 9","Pilot 9: bigger feedback + text"
10,"SUPPRF10856",64,44,96,19,16,70,80,77,"Pilot 9","Pilot 9: bigger feedback + text"
11,"SUPPRF10856",45,39,33,-7,-13,70,46,40,"Pilot 9","Pilot 9: bigger feedback + text"
12,"SUPPRF10856",57,44,34,-6,-12,70,46,40,"Pilot 9","Pilot 9: bigger feedback + text"
13,"SUPPRF10856",57,45,67,2,-13,40,80,65,"Pilot 9","Pilot 9: bigger feedback + text"
14,"SUPPRF10856",63,41,29,-1,0,70,29,30,"Pilot 9","Pilot 9: bigger feedback + text"
15,"SUPPRF10856",64,42,77,2,14,60,63,75,"Pilot 9","Pilot 9: bigger feedback + text"
16,"SUPPRF10856",62,43,19,-3,-1,29,20,22,"Pilot 9","Pilot 9: bigger feedback + text"
17,"SUPPRF10856",57,43,56,-14,-15,75,71,70,"Pilot 9","Pilot 9: bigger feedback + text"
18,"SUPPRF10856",58,43,15,-13,-14,75,29,28,"Pilot 9","Pilot 9: bigger feedback + text"
19,"SUPPRF10856",60,41,66,11,12,35,54,55,"Pilot 9","Pilot 9: bigger feedback + text"
20,"SUPPRF10856",59,43,41,-17,-13,60,54,58,"Pilot 9","Pilot 9: bigger feedback + text"
21,"SUPPRF10856",58,39,6,-12,-14,55,20,18,"Pilot 9","Pilot 9: bigger feedback + text"
22,"SUPPRF10856",65,42,83,18,12,80,71,65,"Pilot 9","Pilot 9: bigger feedback + text"
23,"SUPPRF10856",62,39,47,17,27,65,20,30,"Pilot 9","Pilot 9: bigger feedback + text"
24,"SUPPRF10856",60,46,8,-27,-12,60,20,35,"Pilot 9","Pilot 9: bigger feedback + text"
25,"SUPPRF10856",62,39,63,-2,0,70,63,65,"Pilot 9","Pilot 9: bigger feedback + text"
26,"SUPPRF10856",59,48,55,-5,1,40,54,60,"Pilot 9","Pilot 9: bigger feedback + text"
27,"SUPPRF10856",56,42,75,14,29,70,46,61,"Pilot 9","Pilot 9: bigger feedback + text"
28,"SUPPRF10856",59,42,46,-14,0,75,46,60,"Pilot 9","Pilot 9: bigger feedback + text"
29,"SUPPRF10856",61,39,58,43,29,60,29,15,"Pilot 9","Pilot 9: bigger feedback + text"
30,"SUPPRF10856",62,37,71,6,0,65,71,65,"Pilot 9","Pilot 9: bigger feedback + text"
31,"SUPPRF10856",60,40,16,-10,-13,75,29,26,"Pilot 9","Pilot 9: bigger feedback + text"
32,"SUPPRF10856",61,43,70,15,-1,70,71,55,"Pilot 9","Pilot 9: bigger feedback + text"
33,"SUPPRF10856",57,41,38,-20,-16,51,54,58,"Pilot 9","Pilot 9: bigger feedback + text"
34,"SUPPRF10856",60,39,50,-20,-13,55,63,70,"Pilot 9","Pilot 9: bigger feedback + text"
35,"SUPPRF10856",64,42,94,24,23,80,71,70,"Pilot 9","Pilot 9: bigger feedback + text"
36,"SUPPRF10856",62,40,45,5,-1,50,46,40,"Pilot 9","Pilot 9: bigger feedback + text"
37,"SUPPRF10856",60,46,49,-7,12,35,37,56,"Pilot 9","Pilot 9: bigger feedback + text"
38,"SUPPRF10856",61,40,100,21,20,70,80,79,"Pilot 9","Pilot 9: bigger feedback + text"
39,"SUPPRF10856",58,44,54,-13,0,75,54,67,"Pilot 9","Pilot 9: bigger feedback + text"
40,"SUPPRF10856",62,38,20,0,0,57,20,20,"Pilot 9","Pilot 9: bigger feedback + text"
41,"SUPPRF10856",61,42,28,-12,-1,37,29,40,"Pilot 9","Pilot 9: bigger feedback + text"
42,"SUPPRF10856",58,40,38,-2,1,70,37,40,"Pilot 9","Pilot 9: bigger feedback + text"
43,"SUPPRF10856",61,43,37,7,0,39,37,30,"Pilot 9","Pilot 9: bigger feedback + text"
44,"SUPPRF10856",59,42,61,21,24,60,37,40,"Pilot 9","Pilot 9: bigger feedback + text"
45,"SUPPRF10856",58,40,35,15,15,65,20,20,"Pilot 9","Pilot 9: bigger feedback + text"
46,"SUPPRF10856",58,43,88,33,25,51,63,55,"Pilot 9","Pilot 9: bigger feedback + text"
47,"SUPPRF10856",61,43,81,4,1,70,80,77,"Pilot 9","Pilot 9: bigger feedback + text"
48,"SUPPRF10856",56,44,78,23,24,37,54,55,"Pilot 9","Pilot 9: bigger feedback + text"
1,"SUPPRF24628",28,21,16,-11,-13,69,29,27,"Pilot 9","Pilot 9: bigger feedback + text"
2,"SUPPRF24628",56,21,47,23,27,72,20,24,"Pilot 9","Pilot 9: bigger feedback + text"
3,"SUPPRF24628",73,25,6,-15,-14,64,20,21,"Pilot 9","Pilot 9: bigger feedback + text"
4,"SUPPRF24628",73,3,67,-9,-13,76,80,76,"Pilot 9","Pilot 9: bigger feedback + text"
5,"SUPPRF24628",78,6,55,-22,-16,74,71,77,"Pilot 9","Pilot 9: bigger feedback + text"
6,"SUPPRF24628",25,76,58,17,12,59,46,41,"Pilot 9","Pilot 9: bigger feedback + text"
7,"SUPPRF24628",67,17,38,2,1,63,37,36,"Pilot 9","Pilot 9: bigger feedback + text"
8,"SUPPRF24628",64,62,19,2,-1,43,20,17,"Pilot 9","Pilot 9: bigger feedback + text"
9,"SUPPRF24628",91,52,78,24,24,60,54,54,"Pilot 9","Pilot 9: bigger feedback + text"
10,"SUPPRF24628",89,60,88,15,25,82,63,73,"Pilot 9","Pilot 9: bigger feedback + text"
11,"SUPPRF24628",35,63,54,-16,0,75,54,70,"Pilot 9","Pilot 9: bigger feedback + text"
12,"SUPPRF24628",39,33,50,-6,-13,28,63,56,"Pilot 9","Pilot 9: bigger feedback + text"
13,"SUPPRF24628",47,60,66,-4,12,49,54,70,"Pilot 9","Pilot 9: bigger feedback + text"
14,"SUPPRF24628",69,62,80,1,0,71,80,79,"Pilot 9","Pilot 9: bigger feedback + text"
15,"SUPPRF24628",100,43,100,32,20,49,80,68,"Pilot 9","Pilot 9: bigger feedback + text"
16,"SUPPRF24628",98,21,83,2,12,30,71,81,"Pilot 9","Pilot 9: bigger feedback + text"
17,"SUPPRF24628",30,48,20,0,0,41,20,20,"Pilot 9","Pilot 9: bigger feedback + text"
18,"SUPPRF24628",62,38,63,-4,0,30,63,67,"Pilot 9","Pilot 9: bigger feedback + text"
19,"SUPPRF24628",12,70,22,-25,-15,22,37,47,"Pilot 9","Pilot 9: bigger feedback + text"
20,"SUPPRF24628",17,50,33,-21,-13,42,46,54,"Pilot 9","Pilot 9: bigger feedback + text"
21,"SUPPRF24628",80,29,70,0,-1,32,71,70,"Pilot 9","Pilot 9: bigger feedback + text"
22,"SUPPRF24628",59,33,28,13,-1,68,29,15,"Pilot 9","Pilot 9: bigger feedback + text"
23,"SUPPRF24628",59,25,34,-17,-12,38,46,51,"Pilot 9","Pilot 9: bigger feedback + text"
24,"SUPPRF24628",65,37,81,5,1,61,80,76,"Pilot 9","Pilot 9: bigger feedback + text"
25,"SUPPRF24628",65,66,46,21,17,24,29,25,"Pilot 9","Pilot 9: bigger feedback + text"
26,"SUPPRF24628",28,26,15,-22,-14,14,29,37,"Pilot 9","Pilot 9: bigger feedback + text"
27,"SUPPRF24628",20,39,24,-19,-13,27,37,43,"Pilot 9","Pilot 9: bigger feedback + text"
28,"SUPPRF24628",59,39,47,10,-16,26,63,37,"Pilot 9","Pilot 9: bigger feedback + text"
29,"SUPPRF24628",50,33,56,7,-15,1,71,49,"Pilot 9","Pilot 9: bigger feedback + text"
30,"SUPPRF24628",51,39,75,23,29,25,46,52,"Pilot 9","Pilot 9: bigger feedback + text"
31,"SUPPRF24628",99,10,94,41,23,34,71,53,"Pilot 9","Pilot 9: bigger feedback + text"
32,"SUPPRF24628",98,21,96,24,16,14,80,72,"Pilot 9","Pilot 9: bigger feedback + text"
33,"SUPPRF24628",47,27,29,3,0,27,29,26,"Pilot 9","Pilot 9: bigger feedback + text"
34,"SUPPRF24628",49,27,71,1,0,56,71,70,"Pilot 9","Pilot 9: bigger feedback + text"
35,"SUPPRF24628",40,37,68,-12,-12,65,80,80,"Pilot 9","Pilot 9: bigger feedback + text"
36,"SUPPRF24628",25,34,49,2,12,69,37,47,"Pilot 9","Pilot 9: bigger feedback + text"
37,"SUPPRF24628",1,26,38,-7,-16,30,54,45,"Pilot 9","Pilot 9: bigger feedback + text"
38,"SUPPRF24628",4,15,62,19,-1,9,63,43,"Pilot 9","Pilot 9: bigger feedback + text"
39,"SUPPRF24628",1,30,46,12,0,66,46,34,"Pilot 9","Pilot 9: bigger feedback + text"
40,"SUPPRF24628",2,23,61,5,24,60,37,56,"Pilot 9","Pilot 9: bigger feedback + text"
41,"SUPPRF24628",8,18,41,-18,-13,63,54,59,"Pilot 9","Pilot 9: bigger feedback + text"
42,"SUPPRF24628",15,24,58,32,29,65,29,26,"Pilot 9","Pilot 9: bigger feedback + text"
43,"SUPPRF24628",9,16,37,-18,0,29,37,55,"Pilot 9","Pilot 9: bigger feedback + text"
44,"SUPPRF24628",2,22,8,-8,-12,59,20,16,"Pilot 9","Pilot 9: bigger feedback + text"
45,"SUPPRF24628",27,17,35,22,15,65,20,13,"Pilot 9","Pilot 9: bigger feedback + text"
46,"SUPPRF24628",23,17,45,-9,-1,31,46,54,"Pilot 9","Pilot 9: bigger feedback + text"
47,"SUPPRF24628",59,25,77,22,14,26,63,55,"Pilot 9","Pilot 9: bigger feedback + text"
48,"SUPPRF24628",1,21,55,4,1,23,54,51,"Pilot 9","Pilot 9: bigger feedback + text"
1,"SUPPRF95341",79,16,6,-13,-14,78,20,19,"Pilot 9","Pilot 9: bigger feedback + text"
2,"SUPPRF95341",86,8,63,0,0,40,63,63,"Pilot 9","Pilot 9: bigger feedback + text"
3,"SUPPRF95341",76,5,55,-12,1,89,54,67,"Pilot 9","Pilot 9: bigger feedback + text"
4,"SUPPRF95341",94,2,15,-4,-14,74,29,19,"Pilot 9","Pilot 9: bigger feedback + text"
5,"SUPPRF95341",95,4,62,-1,-1,81,63,63,"Pilot 9","Pilot 9: bigger feedback + text"
6,"SUPPRF95341",98,5,58,7,12,89,46,51,"Pilot 9","Pilot 9: bigger feedback + text"
7,"SUPPRF95341",95,3,50,-11,-13,77,63,61,"Pilot 9","Pilot 9: bigger feedback + text"
8,"SUPPRF95341",98,2,94,10,23,2,71,84,"Pilot 9","Pilot 9: bigger feedback + text"
9,"SUPPRF95341",87,7,47,-9,-16,77,63,56,"Pilot 9","Pilot 9: bigger feedback + text"
10,"SUPPRF95341",99,2,71,2,0,12,71,69,"Pilot 9","Pilot 9: bigger feedback + text"
11,"SUPPRF95341",84,8,41,-13,-13,91,54,54,"Pilot 9","Pilot 9: bigger feedback + text"
12,"SUPPRF95341",83,18,22,-24,-15,79,37,46,"Pilot 9","Pilot 9: bigger feedback + text"
13,"SUPPRF95341",96,18,78,29,24,28,54,49,"Pilot 9","Pilot 9: bigger feedback + text"
14,"SUPPRF95341",96,5,66,8,12,78,54,58,"Pilot 9","Pilot 9: bigger feedback + text"
15,"SUPPRF95341",99,0,100,19,20,64,80,81,"Pilot 9","Pilot 9: bigger feedback + text"
16,"SUPPRF95341",98,1,68,-12,-12,57,80,80,"Pilot 9","Pilot 9: bigger feedback + text"
17,"SUPPRF95341",90,7,54,-3,0,76,54,57,"Pilot 9","Pilot 9: bigger feedback + text"
18,"SUPPRF95341",98,16,46,20,0,33,46,26,"Pilot 9","Pilot 9: bigger feedback + text"
19,"SUPPRF95341",99,3,81,2,1,80,80,79,"Pilot 9","Pilot 9: bigger feedback + text"
20,"SUPPRF95341",72,10,8,-41,-12,7,20,49,"Pilot 9","Pilot 9: bigger feedback + text"
21,"SUPPRF95341",88,4,38,-2,1,32,37,40,"Pilot 9","Pilot 9: bigger feedback + text"
22,"SUPPRF95341",78,10,49,19,12,71,37,30,"Pilot 9","Pilot 9: bigger feedback + text"
23,"SUPPRF95341",98,3,28,8,-1,97,29,20,"Pilot 9","Pilot 9: bigger feedback + text"
24,"SUPPRF95341",98,6,35,-19,15,5,20,54,"Pilot 9","Pilot 9: bigger feedback + text"
25,"SUPPRF95341",92,3,67,-5,-13,11,80,72,"Pilot 9","Pilot 9: bigger feedback + text"
26,"SUPPRF95341",91,8,16,-1,-13,86,29,17,"Pilot 9","Pilot 9: bigger feedback + text"
27,"SUPPRF95341",98,8,45,15,-1,63,46,30,"Pilot 9","Pilot 9: bigger feedback + text"
28,"SUPPRF95341",89,5,83,8,12,88,71,75,"Pilot 9","Pilot 9: bigger feedback + text"
29,"SUPPRF95341",97,1,38,-41,-16,87,54,79,"Pilot 9","Pilot 9: bigger feedback + text"
30,"SUPPRF95341",99,7,96,59,16,23,80,37,"Pilot 9","Pilot 9: bigger feedback + text"
31,"SUPPRF95341",100,4,58,35,29,75,29,23,"Pilot 9","Pilot 9: bigger feedback + text"
32,"SUPPRF95341",98,3,56,-38,-15,4,71,94,"Pilot 9","Pilot 9: bigger feedback + text"
33,"SUPPRF95341",92,11,34,-10,-12,58,46,44,"Pilot 9","Pilot 9: bigger feedback + text"
34,"SUPPRF95341",92,5,55,6,-16,9,71,49,"Pilot 9","Pilot 9: bigger feedback + text"
35,"SUPPRF95341",98,6,33,5,-13,7,46,28,"Pilot 9","Pilot 9: bigger feedback + text"
36,"SUPPRF95341",89,10,70,23,-1,9,71,47,"Pilot 9","Pilot 9: bigger feedback + text"
37,"SUPPRF95341",97,4,19,-60,-1,44,20,79,"Pilot 9","Pilot 9: bigger feedback + text"
38,"SUPPRF95341",98,1,29,8,0,95,29,21,"Pilot 9","Pilot 9: bigger feedback + text"
39,"SUPPRF95341",89,2,24,-43,-13,11,37,67,"Pilot 9","Pilot 9: bigger feedback + text"
40,"SUPPRF95341",99,0,88,48,25,82,63,40,"Pilot 9","Pilot 9: bigger feedback + text"
41,"SUPPRF95341",99,0,80,62,0,87,80,18,"Pilot 9","Pilot 9: bigger feedback + text"
42,"SUPPRF95341",87,11,20,13,0,87,20,7,"Pilot 9","Pilot 9: bigger feedback + text"
43,"SUPPRF95341",100,1,47,35,27,81,20,12,"Pilot 9","Pilot 9: bigger feedback + text"
44,"SUPPRF95341",99,4,46,31,17,89,29,15,"Pilot 9","Pilot 9: bigger feedback + text"
45,"SUPPRF95341",98,9,77,-2,14,90,63,79,"Pilot 9","Pilot 9: bigger feedback + text"
46,"SUPPRF95341",99,2,61,40,24,26,37,21,"Pilot 9","Pilot 9: bigger feedback + text"
47,"SUPPRF95341",98,10,37,0,0,45,37,37,"Pilot 9","Pilot 9: bigger feedback + text"
48,"SUPPRF95341",91,5,75,47,29,92,46,28,"Pilot 9","Pilot 9: bigger feedback + text"
1,"SUPPRF54475",40,57,62,-11,-1,79,63,73,"Pilot 9","Pilot 9: bigger feedback + text"
2,"SUPPRF54475",22,70,68,-18,-12,68,80,86,"Pilot 9","Pilot 9: bigger feedback + text"
3,"SUPPRF54475",12,78,6,-10,-14,67,20,16,"Pilot 9","Pilot 9: bigger feedback + text"
4,"SUPPRF54475",6,75,16,-18,-13,63,29,34,"Pilot 9","Pilot 9: bigger feedback + text"
5,"SUPPRF54475",85,38,94,27,23,69,71,67,"Pilot 9","Pilot 9: bigger feedback + text"
6,"SUPPRF54475",58,64,49,27,12,71,37,22,"Pilot 9","Pilot 9: bigger feedback + text"
7,"SUPPRF54475",41,52,50,-7,-13,47,63,57,"Pilot 9","Pilot 9: bigger feedback + text"
8,"SUPPRF54475",58,30,71,13,0,60,71,58,"Pilot 9","Pilot 9: bigger feedback + text"
9,"SUPPRF54475",49,56,55,14,1,63,54,41,"Pilot 9","Pilot 9: bigger feedback + text"
10,"SUPPRF54475",43,51,54,20,0,49,54,34,"Pilot 9","Pilot 9: bigger feedback + text"
11,"SUPPRF54475",31,60,38,-1,1,41,37,39,"Pilot 9","Pilot 9: bigger feedback + text"
12,"SUPPRF54475",18,59,28,-9,-1,37,29,37,"Pilot 9","Pilot 9: bigger feedback + text"
13,"SUPPRF54475",80,4,100,28,20,78,80,72,"Pilot 9","Pilot 9: bigger feedback + text"
14,"SUPPRF54475",39,40,35,11,15,52,20,24,"Pilot 9","Pilot 9: bigger feedback + text"
15,"SUPPRF54475",57,38,70,19,-1,54,71,51,"Pilot 9","Pilot 9: bigger feedback + text"
16,"SUPPRF54475",66,44,61,32,24,57,37,29,"Pilot 9","Pilot 9: bigger feedback + text"
17,"SUPPRF54475",49,45,45,-4,-1,46,46,49,"Pilot 9","Pilot 9: bigger feedback + text"
18,"SUPPRF54475",64,33,47,36,27,65,20,11,"Pilot 9","Pilot 9: bigger feedback + text"
19,"SUPPRF54475",45,40,20,3,0,63,20,17,"Pilot 9","Pilot 9: bigger feedback + text"
20,"SUPPRF54475",22,60,56,-20,-15,79,71,76,"Pilot 9","Pilot 9: bigger feedback + text"
21,"SUPPRF54475",41,53,29,7,0,63,29,22,"Pilot 9","Pilot 9: bigger feedback + text"
22,"SUPPRF54475",53,29,33,13,-13,52,46,20,"Pilot 9","Pilot 9: bigger feedback + text"
23,"SUPPRF54475",46,42,66,24,12,58,54,42,"Pilot 9","Pilot 9: bigger feedback + text"
24,"SUPPRF54475",21,57,67,-19,-13,64,80,86,"Pilot 9","Pilot 9: bigger feedback + text"
25,"SUPPRF54475",54,42,80,26,0,39,80,54,"Pilot 9","Pilot 9: bigger feedback + text"
26,"SUPPRF54475",74,34,88,43,25,49,63,45,"Pilot 9","Pilot 9: bigger feedback + text"
27,"SUPPRF54475",45,53,41,-5,-13,38,54,46,"Pilot 9","Pilot 9: bigger feedback + text"
28,"SUPPRF54475",58,42,81,10,1,74,80,71,"Pilot 9","Pilot 9: bigger feedback + text"
29,"SUPPRF54475",58,28,83,27,12,54,71,56,"Pilot 9","Pilot 9: bigger feedback + text"
30,"SUPPRF54475",60,33,46,12,0,35,46,34,"Pilot 9","Pilot 9: bigger feedback + text"
31,"SUPPRF54475",60,14,8,-13,-12,39,20,21,"Pilot 9","Pilot 9: bigger feedback + text"
32,"SUPPRF54475",65,25,37,23,0,28,37,14,"Pilot 9","Pilot 9: bigger feedback + text"
33,"SUPPRF54475",51,31,46,20,17,57,29,26,"Pilot 9","Pilot 9: bigger feedback + text"
34,"SUPPRF54475",25,28,15,-44,-14,36,29,59,"Pilot 9","Pilot 9: bigger feedback + text"
35,"SUPPRF54475",82,30,58,48,29,61,29,10,"Pilot 9","Pilot 9: bigger feedback + text"
36,"SUPPRF54475",70,4,63,-1,0,59,63,64,"Pilot 9","Pilot 9: bigger feedback + text"
37,"SUPPRF54475",60,20,75,41,29,48,46,34,"Pilot 9","Pilot 9: bigger feedback + text"
38,"SUPPRF54475",41,31,38,-12,-16,62,54,50,"Pilot 9","Pilot 9: bigger feedback + text"
39,"SUPPRF54475",36,63,22,-19,-15,56,37,41,"Pilot 9","Pilot 9: bigger feedback + text"
40,"SUPPRF54475",63,15,78,26,24,48,54,52,"Pilot 9","Pilot 9: bigger feedback + text"
41,"SUPPRF54475",67,39,55,-6,-16,43,71,61,"Pilot 9","Pilot 9: bigger feedback + text"
42,"SUPPRF54475",69,24,24,-10,-13,58,37,34,"Pilot 9","Pilot 9: bigger feedback + text"
43,"SUPPRF54475",41,47,47,-8,-16,63,63,55,"Pilot 9","Pilot 9: bigger feedback + text"
44,"SUPPRF54475",70,23,96,30,16,70,80,66,"Pilot 9","Pilot 9: bigger feedback + text"
45,"SUPPRF54475",51,48,58,-2,12,51,46,60,"Pilot 9","Pilot 9: bigger feedback + text"
46,"SUPPRF54475",60,27,77,13,14,56,63,64,"Pilot 9","Pilot 9: bigger feedback + text"
47,"SUPPRF54475",46,48,19,8,-1,53,20,11,"Pilot 9","Pilot 9: bigger feedback + text"
48,"SUPPRF54475",36,64,34,-16,-12,43,46,50,"Pilot 9","Pilot 9: bigger feedback + text"
1,"SUPPRF06342",39,73,24,-29,-13,59,37,53,"Pilot 9","Pilot 9: bigger feedback + text"
2,"SUPPRF06342",50,59,61,40,24,72,37,21,"Pilot 9","Pilot 9: bigger feedback + text"
3,"SUPPRF06342",28,66,16,7,-13,73,29,9,"Pilot 9","Pilot 9: bigger feedback + text"
4,"SUPPRF06342",58,69,100,30,20,66,80,70,"Pilot 9","Pilot 9: bigger feedback + text"
5,"SUPPRF06342",55,60,63,9,0,41,63,54,"Pilot 9","Pilot 9: bigger feedback + text"
6,"SUPPRF06342",49,56,56,-14,-15,61,71,70,"Pilot 9","Pilot 9: bigger feedback + text"
7,"SUPPRF06342",49,51,68,25,-12,63,80,43,"Pilot 9","Pilot 9: bigger feedback + text"
8,"SUPPRF06342",48,40,71,6,0,63,71,65,"Pilot 9","Pilot 9: bigger feedback + text"
9,"SUPPRF06342",45,46,54,-5,0,59,54,59,"Pilot 9","Pilot 9: bigger feedback + text"
10,"SUPPRF06342",49,47,62,13,-1,72,63,49,"Pilot 9","Pilot 9: bigger feedback + text"
11,"SUPPRF06342",41,55,45,6,-1,71,46,39,"Pilot 9","Pilot 9: bigger feedback + text"
12,"SUPPRF06342",51,54,58,27,12,59,46,31,"Pilot 9","Pilot 9: bigger feedback + text"
13,"SUPPRF06342",37,58,58,29,29,75,29,29,"Pilot 9","Pilot 9: bigger feedback + text"
14,"SUPPRF06342",43,49,83,23,12,62,71,60,"Pilot 9","Pilot 9: bigger feedback + text"
15,"SUPPRF06342",28,67,28,-25,-1,36,29,53,"Pilot 9","Pilot 9: bigger feedback + text"
16,"SUPPRF06342",33,66,38,-37,-16,61,54,75,"Pilot 9","Pilot 9: bigger feedback + text"
17,"SUPPRF06342",60,40,81,19,1,47,80,62,"Pilot 9","Pilot 9: bigger feedback + text"
18,"SUPPRF06342",41,56,41,-19,-13,56,54,60,"Pilot 9","Pilot 9: bigger feedback + text"
19,"SUPPRF06342",40,59,34,6,-12,66,46,28,"Pilot 9","Pilot 9: bigger feedback + text"
20,"SUPPRF06342",45,56,67,29,-13,37,80,38,"Pilot 9","Pilot 9: bigger feedback + text"
21,"SUPPRF06342",25,63,6,-19,-14,58,20,25,"Pilot 9","Pilot 9: bigger feedback + text"
22,"SUPPRF06342",46,70,80,51,0,71,80,29,"Pilot 9","Pilot 9: bigger feedback + text"
23,"SUPPRF06342",29,65,55,24,-16,61,71,31,"Pilot 9","Pilot 9: bigger feedback + text"
24,"SUPPRF06342",52,37,78,24,24,54,54,54,"Pilot 9","Pilot 9: bigger feedback + text"
25,"SUPPRF06342",57,30,46,11,0,55,46,35,"Pilot 9","Pilot 9: bigger feedback + text"
26,"SUPPRF06342",27,68,22,-53,-15,60,37,75,"Pilot 9","Pilot 9: bigger feedback + text"
27,"SUPPRF06342",36,65,33,21,-13,70,46,12,"Pilot 9","Pilot 9: bigger feedback + text"
28,"SUPPRF06342",17,37,8,-37,-12,36,20,45,"Pilot 9","Pilot 9: bigger feedback + text"
29,"SUPPRF06342",39,66,29,-7,0,67,29,36,"Pilot 9","Pilot 9: bigger feedback + text"
30,"SUPPRF06342",32,65,38,-7,1,40,37,45,"Pilot 9","Pilot 9: bigger feedback + text"
31,"SUPPRF06342",36,53,55,21,1,30,54,34,"Pilot 9","Pilot 9: bigger feedback + text"
32,"SUPPRF06342",48,61,47,-11,-16,41,63,58,"Pilot 9","Pilot 9: bigger feedback + text"
33,"SUPPRF06342",44,42,46,3,17,42,29,43,"Pilot 9","Pilot 9: bigger feedback + text"
34,"SUPPRF06342",43,46,20,0,0,62,20,20,"Pilot 9","Pilot 9: bigger feedback + text"
35,"SUPPRF06342",56,41,66,21,12,68,54,45,"Pilot 9","Pilot 9: bigger feedback + text"
36,"SUPPRF06342",55,41,88,67,25,58,63,21,"Pilot 9","Pilot 9: bigger feedback + text"
37,"SUPPRF06342",58,36,47,29,27,70,20,18,"Pilot 9","Pilot 9: bigger feedback + text"
38,"SUPPRF06342",64,27,96,64,16,66,80,32,"Pilot 9","Pilot 9: bigger feedback + text"
39,"SUPPRF06342",52,26,37,3,0,80,37,34,"Pilot 9","Pilot 9: bigger feedback + text"
40,"SUPPRF06342",55,25,77,13,14,80,63,64,"Pilot 9","Pilot 9: bigger feedback + text"
41,"SUPPRF06342",51,19,50,-22,-13,82,63,72,"Pilot 9","Pilot 9: bigger feedback + text"
42,"SUPPRF06342",45,35,19,-13,-1,67,20,32,"Pilot 9","Pilot 9: bigger feedback + text"
43,"SUPPRF06342",45,50,15,-13,-14,67,29,28,"Pilot 9","Pilot 9: bigger feedback + text"
44,"SUPPRF06342",51,63,49,30,12,52,37,19,"Pilot 9","Pilot 9: bigger feedback + text"
45,"SUPPRF06342",52,61,94,69,23,40,71,25,"Pilot 9","Pilot 9: bigger feedback + text"
46,"SUPPRF06342",49,55,35,-10,15,38,20,45,"Pilot 9","Pilot 9: bigger feedback + text"
47,"SUPPRF06342",52,56,70,34,-1,59,71,36,"Pilot 9","Pilot 9: bigger feedback + text"
48,"SUPPRF06342",48,46,75,22,29,58,46,53,"Pilot 9","Pilot 9: bigger feedback + text"
1,"SUPPRF73117",49,11,62,27,-1,65,63,35,"Pilot 9","Pilot 9: bigger feedback + text"
2,"SUPPRF73117",55,11,83,13,12,49,71,70,"Pilot 9","Pilot 9: bigger feedback + text"
3,"SUPPRF73117",60,7,50,-15,-13,56,63,65,"Pilot 9","Pilot 9: bigger feedback + text"
4,"SUPPRF73117",60,12,61,16,24,66,37,45,"Pilot 9","Pilot 9: bigger feedback + text"
5,"SUPPRF73117",66,20,46,-14,0,57,46,60,"Pilot 9","Pilot 9: bigger feedback + text"
6,"SUPPRF73117",74,9,20,0,0,56,20,20,"Pilot 9","Pilot 9: bigger feedback + text"
7,"SUPPRF73117",70,11,47,-13,-16,51,63,60,"Pilot 9","Pilot 9: bigger feedback + text"
8,"SUPPRF73117",44,6,47,17,27,55,20,30,"Pilot 9","Pilot 9: bigger feedback + text"
9,"SUPPRF73117",57,11,96,15,16,58,80,81,"Pilot 9","Pilot 9: bigger feedback + text"
10,"SUPPRF73117",73,14,81,-14,1,64,80,95,"Pilot 9","Pilot 9: bigger feedback + text"
11,"SUPPRF73117",48,9,71,-9,0,70,71,80,"Pilot 9","Pilot 9: bigger feedback + text"
12,"SUPPRF73117",62,15,22,-11,-15,61,37,33,"Pilot 9","Pilot 9: bigger feedback + text"
13,"SUPPRF73117",43,15,88,50,25,58,63,38,"Pilot 9","Pilot 9: bigger feedback + text"
14,"SUPPRF73117",50,11,56,-14,-15,69,71,70,"Pilot 9","Pilot 9: bigger feedback + text"
15,"SUPPRF73117",52,17,45,-30,-1,68,46,75,"Pilot 9","Pilot 9: bigger feedback + text"
16,"SUPPRF73117",39,14,58,28,29,64,29,30,"Pilot 9","Pilot 9: bigger feedback + text"
17,"SUPPRF73117",53,13,16,-30,-13,33,29,46,"Pilot 9","Pilot 9: bigger feedback + text"
18,"SUPPRF73117",54,8,8,-4,-12,37,20,12,"Pilot 9","Pilot 9: bigger feedback + text"
19,"SUPPRF73117",41,11,55,6,1,35,54,49,"Pilot 9","Pilot 9: bigger feedback + text"
20,"SUPPRF73117",34,17,78,22,24,31,54,56,"Pilot 9","Pilot 9: bigger feedback + text"
21,"SUPPRF73117",10,14,100,11,20,27,80,89,"Pilot 9","Pilot 9: bigger feedback + text"
22,"SUPPRF73117",100,11,80,0,0,17,80,80,"Pilot 9","Pilot 9: bigger feedback + text"
23,"SUPPRF73117",55,9,75,44,29,16,46,31,"Pilot 9","Pilot 9: bigger feedback + text"
24,"SUPPRF73117",49,12,37,6,0,21,37,31,"Pilot 9","Pilot 9: bigger feedback + text"
25,"SUPPRF73117",46,6,15,-31,-14,7,29,46,"Pilot 9","Pilot 9: bigger feedback + text"
26,"SUPPRF73117",51,9,77,45,14,8,63,32,"Pilot 9","Pilot 9: bigger feedback + text"
27,"SUPPRF73117",35,9,94,19,23,9,71,75,"Pilot 9","Pilot 9: bigger feedback + text"
28,"SUPPRF73117",13,8,29,-55,0,8,29,84,"Pilot 9","Pilot 9: bigger feedback + text"
29,"SUPPRF73117",10,12,33,10,-13,54,46,23,"Pilot 9","Pilot 9: bigger feedback + text"
30,"SUPPRF73117",11,9,55,-40,-16,33,71,95,"Pilot 9","Pilot 9: bigger feedback + text"
31,"SUPPRF73117",0,11,54,22,0,8,54,32,"Pilot 9","Pilot 9: bigger feedback + text"
32,"SUPPRF73117",0,20,19,-25,-1,0,20,44,"Pilot 9","Pilot 9: bigger feedback + text"
33,"SUPPRF73117",0,27,24,-14,-13,0,37,38,"Pilot 9","Pilot 9: bigger feedback + text"
34,"SUPPRF73117",0,10,41,-27,-13,0,54,68,"Pilot 9","Pilot 9: bigger feedback + text"
35,"SUPPRF73117",30,23,68,5,-12,28,80,63,"Pilot 9","Pilot 9: bigger feedback + text"
36,"SUPPRF73117",0,30,6,-94,-14,0,20,100,"Pilot 9","Pilot 9: bigger feedback + text"
37,"SUPPRF73117",0,40,38,2,-16,4,54,36,"Pilot 9","Pilot 9: bigger feedback + text"
38,"SUPPRF73117",0,44,46,32,17,0,29,14,"Pilot 9","Pilot 9: bigger feedback + text"
39,"SUPPRF73117",0,46,67,67,-13,0,80,0,"Pilot 9","Pilot 9: bigger feedback + text"
40,"SUPPRF73117",0,53,38,38,1,0,37,0,"Pilot 9","Pilot 9: bigger feedback + text"
41,"SUPPRF73117",0,49,35,24,15,0,20,11,"Pilot 9","Pilot 9: bigger feedback + text"
42,"SUPPRF73117",0,82,63,63,0,0,63,0,"Pilot 9","Pilot 9: bigger feedback + text"
43,"SUPPRF73117",0,100,28,-22,-1,0,29,50,"Pilot 9","Pilot 9: bigger feedback + text"
44,"SUPPRF73117",0,100,34,-11,-12,14,46,45,"Pilot 9","Pilot 9: bigger feedback + text"
45,"SUPPRF73117",0,100,70,0,-1,0,71,70,"Pilot 9","Pilot 9: bigger feedback + text"
46,"SUPPRF73117",0,100,66,64,12,0,54,2,"Pilot 9","Pilot 9: bigger feedback + text"
47,"SUPPRF73117",0,100,49,-2,12,0,37,51,"Pilot 9","Pilot 9: bigger feedback + text"
48,"SUPPRF73117",0,100,58,-21,12,0,46,79,"Pilot 9","Pilot 9: bigger feedback + text"
1,"SUPPRF91978",53,53,38,-6,-16,53,54,44,"Pilot 9","Pilot 9: bigger feedback + text"
2,"SUPPRF91978",68,28,63,-9,0,70,63,72,"Pilot 9","Pilot 9: bigger feedback + text"
3,"SUPPRF91978",50,48,6,-20,-14,29,20,26,"Pilot 9","Pilot 9: bigger feedback + text"
4,"SUPPRF91978",77,65,61,26,24,96,37,35,"Pilot 9","Pilot 9: bigger feedback + text"
5,"SUPPRF91978",97,8,75,15,29,97,46,60,"Pilot 9","Pilot 9: bigger feedback + text"
6,"SUPPRF91978",50,49,55,-25,-16,100,71,80,"Pilot 9","Pilot 9: bigger feedback + text"
7,"SUPPRF91978",52,52,33,-19,-13,1,46,52,"Pilot 9","Pilot 9: bigger feedback + text"
8,"SUPPRF91978",48,66,29,-12,0,74,29,41,"Pilot 9","Pilot 9: bigger feedback + text"
9,"SUPPRF91978",59,56,41,-4,-13,87,54,45,"Pilot 9","Pilot 9: bigger feedback + text"
10,"SUPPRF91978",73,27,88,-9,25,94,63,97,"Pilot 9","Pilot 9: bigger feedback + text"
11,"SUPPRF91978",53,57,16,-21,-13,98,29,37,"Pilot 9","Pilot 9: bigger feedback + text"
12,"SUPPRF91978",74,11,54,3,0,2,54,51,"Pilot 9","Pilot 9: bigger feedback + text"
13,"SUPPRF91978",73,49,70,26,-1,1,71,44,"Pilot 9","Pilot 9: bigger feedback + text"
14,"SUPPRF91978",68,8,71,-7,0,91,71,78,"Pilot 9","Pilot 9: bigger feedback + text"
15,"SUPPRF91978",69,25,46,1,0,47,46,45,"Pilot 9","Pilot 9: bigger feedback + text"
16,"SUPPRF91978",48,57,77,27,14,1,63,50,"Pilot 9","Pilot 9: bigger feedback + text"
17,"SUPPRF91978",31,37,24,-57,-13,78,37,81,"Pilot 9","Pilot 9: bigger feedback + text"
18,"SUPPRF91978",68,61,68,-5,-12,86,80,73,"Pilot 9","Pilot 9: bigger feedback + text"
19,"SUPPRF91978",50,48,37,0,0,66,37,37,"Pilot 9","Pilot 9: bigger feedback + text"
20,"SUPPRF91978",53,51,47,27,27,70,20,20,"Pilot 9","Pilot 9: bigger feedback + text"
21,"SUPPRF91978",50,50,47,12,-16,3,63,35,"Pilot 9","Pilot 9: bigger feedback + text"
22,"SUPPRF91978",35,37,15,-72,-14,18,29,87,"Pilot 9","Pilot 9: bigger feedback + text"
23,"SUPPRF91978",47,1,38,-16,1,2,37,54,"Pilot 9","Pilot 9: bigger feedback + text"
24,"SUPPRF91978",31,38,62,9,-1,2,63,53,"Pilot 9","Pilot 9: bigger feedback + text"
25,"SUPPRF91978",45,50,22,-23,-15,0,37,45,"Pilot 9","Pilot 9: bigger feedback + text"
26,"SUPPRF91978",49,47,55,5,1,1,54,50,"Pilot 9","Pilot 9: bigger feedback + text"
27,"SUPPRF91978",51,55,45,-25,-1,0,46,70,"Pilot 9","Pilot 9: bigger feedback + text"
28,"SUPPRF91978",49,51,46,-14,17,48,29,60,"Pilot 9","Pilot 9: bigger feedback + text"
29,"SUPPRF91978",47,49,56,1,-15,2,71,55,"Pilot 9","Pilot 9: bigger feedback + text"
30,"SUPPRF91978",57,29,35,18,15,83,20,17,"Pilot 9","Pilot 9: bigger feedback + text"
31,"SUPPRF91978",56,51,66,15,12,48,54,51,"Pilot 9","Pilot 9: bigger feedback + text"
32,"SUPPRF91978",17,94,34,2,-12,23,46,32,"Pilot 9","Pilot 9: bigger feedback + text"
33,"SUPPRF91978",21,72,19,7,-1,9,20,12,"Pilot 9","Pilot 9: bigger feedback + text"
34,"SUPPRF91978",1,99,58,19,12,14,46,39,"Pilot 9","Pilot 9: bigger feedback + text"
35,"SUPPRF91978",0,100,96,7,16,10,80,89,"Pilot 9","Pilot 9: bigger feedback + text"
36,"SUPPRF91978",1,99,58,3,29,8,29,55,"Pilot 9","Pilot 9: bigger feedback + text"
37,"SUPPRF91978",12,47,94,61,23,3,71,33,"Pilot 9","Pilot 9: bigger feedback + text"
38,"SUPPRF91978",24,73,8,-23,-12,69,20,31,"Pilot 9","Pilot 9: bigger feedback + text"
39,"SUPPRF91978",16,84,80,-1,0,41,80,81,"Pilot 9","Pilot 9: bigger feedback + text"
40,"SUPPRF91978",25,77,81,8,1,9,80,73,"Pilot 9","Pilot 9: bigger feedback + text"
41,"SUPPRF91978",52,65,49,-9,12,2,37,58,"Pilot 9","Pilot 9: bigger feedback + text"
42,"SUPPRF91978",19,72,67,-17,-13,75,80,84,"Pilot 9","Pilot 9: bigger feedback + text"
43,"SUPPRF91978",30,79,100,28,20,2,80,72,"Pilot 9","Pilot 9: bigger feedback + text"
44,"SUPPRF91978",51,49,28,-14,-1,2,29,42,"Pilot 9","Pilot 9: bigger feedback + text"
45,"SUPPRF91978",53,55,50,-46,-13,80,63,96,"Pilot 9","Pilot 9: bigger feedback + text"
46,"SUPPRF91978",51,55,78,13,24,71,54,65,"Pilot 9","Pilot 9: bigger feedback + text"
47,"SUPPRF91978",47,47,83,33,12,0,71,50,"Pilot 9","Pilot 9: bigger feedback + text"
48,"SUPPRF91978",49,49,20,7,0,76,20,13,"Pilot 9","Pilot 9: bigger feedback + text"
1,"SUPPRF75922",87,8,46,-19,0,81,46,65,"Pilot 9","Pilot 9: bigger feedback + text"
2,"SUPPRF75922",89,7,50,-19,-13,78,63,69,"Pilot 9","Pilot 9: bigger feedback + text"
3,"SUPPRF75922",88,10,24,-31,-13,85,37,55,"Pilot 9","Pilot 9: bigger feedback + text"
4,"SUPPRF75922",94,8,71,11,0,90,71,60,"Pilot 9","Pilot 9: bigger feedback + text"
5,"SUPPRF75922",94,8,67,-18,-13,99,80,85,"Pilot 9","Pilot 9: bigger feedback + text"
6,"SUPPRF75922",93,7,96,37,16,78,80,59,"Pilot 9","Pilot 9: bigger feedback + text"
7,"SUPPRF75922",92,3,55,-25,-16,80,71,80,"Pilot 9","Pilot 9: bigger feedback + text"
8,"SUPPRF75922",91,6,47,22,27,50,20,25,"Pilot 9","Pilot 9: bigger feedback + text"
9,"SUPPRF75922",92,6,80,0,0,94,80,80,"Pilot 9","Pilot 9: bigger feedback + text"
10,"SUPPRF75922",94,6,55,-4,1,83,54,59,"Pilot 9","Pilot 9: bigger feedback + text"
11,"SUPPRF75922",96,7,45,-25,-1,76,46,70,"Pilot 9","Pilot 9: bigger feedback + text"
12,"SUPPRF75922",90,7,8,-32,-12,47,20,40,"Pilot 9","Pilot 9: bigger feedback + text"
13,"SUPPRF75922",88,4,46,1,17,71,29,45,"Pilot 9","Pilot 9: bigger feedback + text"
14,"SUPPRF75922",92,14,75,5,29,86,46,70,"Pilot 9","Pilot 9: bigger feedback + text"
15,"SUPPRF75922",95,18,6,-33,-14,100,20,39,"Pilot 9","Pilot 9: bigger feedback + text"
16,"SUPPRF75922",89,26,16,-59,-13,25,29,75,"Pilot 9","Pilot 9: bigger feedback + text"
17,"SUPPRF75922",94,9,77,13,14,75,63,64,"Pilot 9","Pilot 9: bigger feedback + text"
18,"SUPPRF75922",94,4,41,8,-13,82,54,33,"Pilot 9","Pilot 9: bigger feedback + text"
19,"SUPPRF75922",89,15,37,-17,0,92,37,54,"Pilot 9","Pilot 9: bigger feedback + text"
20,"SUPPRF75922",92,10,56,-12,-15,94,71,68,"Pilot 9","Pilot 9: bigger feedback + text"
21,"SUPPRF75922",95,5,38,-32,-16,76,54,70,"Pilot 9","Pilot 9: bigger feedback + text"
22,"SUPPRF75922",93,6,29,2,0,85,29,27,"Pilot 9","Pilot 9: bigger feedback + text"
23,"SUPPRF75922",86,7,70,21,-1,90,71,49,"Pilot 9","Pilot 9: bigger feedback + text"
24,"SUPPRF75922",97,11,66,16,12,98,54,50,"Pilot 9","Pilot 9: bigger feedback + text"
25,"SUPPRF75922",92,16,68,-27,-12,100,80,95,"Pilot 9","Pilot 9: bigger feedback + text"
26,"SUPPRF75922",91,10,22,-4,-15,95,37,26,"Pilot 9","Pilot 9: bigger feedback + text"
27,"SUPPRF75922",96,5,19,-17,-1,98,20,36,"Pilot 9","Pilot 9: bigger feedback + text"
28,"SUPPRF75922",91,7,34,0,-12,94,46,34,"Pilot 9","Pilot 9: bigger feedback + text"
29,"SUPPRF75922",93,6,94,14,23,99,71,80,"Pilot 9","Pilot 9: bigger feedback + text"
30,"SUPPRF75922",89,8,33,-27,-13,89,46,60,"Pilot 9","Pilot 9: bigger feedback + text"
31,"SUPPRF75922",94,6,83,-5,12,100,71,88,"Pilot 9","Pilot 9: bigger feedback + text"
32,"SUPPRF75922",91,15,63,-12,0,91,63,75,"Pilot 9","Pilot 9: bigger feedback + text"
33,"SUPPRF75922",92,9,58,18,29,51,29,40,"Pilot 9","Pilot 9: bigger feedback + text"
34,"SUPPRF75922",92,9,81,5,1,93,80,76,"Pilot 9","Pilot 9: bigger feedback + text"
35,"SUPPRF75922",93,8,100,10,20,85,80,90,"Pilot 9","Pilot 9: bigger feedback + text"
36,"SUPPRF75922",91,8,61,11,24,88,37,50,"Pilot 9","Pilot 9: bigger feedback + text"
37,"SUPPRF75922",89,8,28,-45,-1,88,29,73,"Pilot 9","Pilot 9: bigger feedback + text"
38,"SUPPRF75922",90,9,62,-18,-1,87,63,80,"Pilot 9","Pilot 9: bigger feedback + text"
39,"SUPPRF75922",98,6,58,-7,12,100,46,65,"Pilot 9","Pilot 9: bigger feedback + text"
40,"SUPPRF75922",88,18,47,-38,-16,92,63,85,"Pilot 9","Pilot 9: bigger feedback + text"
41,"SUPPRF75922",97,4,78,8,24,88,54,70,"Pilot 9","Pilot 9: bigger feedback + text"
42,"SUPPRF75922",92,13,49,-4,12,100,37,53,"Pilot 9","Pilot 9: bigger feedback + text"
43,"SUPPRF75922",80,28,15,-10,-14,85,29,25,"Pilot 9","Pilot 9: bigger feedback + text"
44,"SUPPRF75922",77,8,35,5,15,44,20,30,"Pilot 9","Pilot 9: bigger feedback + text"
45,"SUPPRF75922",84,17,54,-6,0,87,54,60,"Pilot 9","Pilot 9: bigger feedback + text"
46,"SUPPRF75922",95,12,88,33,25,99,63,55,"Pilot 9","Pilot 9: bigger feedback + text"
47,"SUPPRF75922",76,23,20,-5,0,92,20,25,"Pilot 9","Pilot 9: bigger feedback + text"
48,"SUPPRF75922",88,11,38,-3,1,60,37,41,"Pilot 9","Pilot 9: bigger feedback + text"
1,"SUPPRF94497",69,17,55,-5,1,86,54,60,"Pilot 9","Pilot 9: bigger feedback + text"
2,"SUPPRF94497",59,21,67,-13,-13,95,80,80,"Pilot 9","Pilot 9: bigger feedback + text"
3,"SUPPRF94497",70,17,19,-1,-1,86,20,20,"Pilot 9","Pilot 9: bigger feedback + text"
4,"SUPPRF94497",71,21,56,-24,-15,75,71,80,"Pilot 9","Pilot 9: bigger feedback + text"
5,"SUPPRF94497",60,14,47,-18,-16,90,63,65,"Pilot 9","Pilot 9: bigger feedback + text"
6,"SUPPRF94497",62,11,68,-2,-12,60,80,70,"Pilot 9","Pilot 9: bigger feedback + text"
7,"SUPPRF94497",68,19,38,-7,-16,62,54,45,"Pilot 9","Pilot 9: bigger feedback + text"
8,"SUPPRF94497",61,10,20,7,0,81,20,13,"Pilot 9","Pilot 9: bigger feedback + text"
9,"SUPPRF94497",59,10,88,28,25,87,63,60,"Pilot 9","Pilot 9: bigger feedback + text"
10,"SUPPRF94497",59,13,58,-2,29,28,29,60,"Pilot 9","Pilot 9: bigger feedback + text"
11,"SUPPRF94497",62,14,8,-2,-12,82,20,10,"Pilot 9","Pilot 9: bigger feedback + text"
12,"SUPPRF94497",66,8,78,30,24,26,54,48,"Pilot 9","Pilot 9: bigger feedback + text"
13,"SUPPRF94497",64,11,46,16,0,80,46,30,"Pilot 9","Pilot 9: bigger feedback + text"
14,"SUPPRF94497",64,7,77,20,14,71,63,57,"Pilot 9","Pilot 9: bigger feedback + text"
15,"SUPPRF94497",66,5,80,11,0,80,80,69,"Pilot 9","Pilot 9: bigger feedback + text"
16,"SUPPRF94497",87,0,96,29,16,59,80,67,"Pilot 9","Pilot 9: bigger feedback + text"
17,"SUPPRF94497",83,3,34,-17,-12,70,46,51,"Pilot 9","Pilot 9: bigger feedback + text"
18,"SUPPRF94497",76,7,54,4,0,79,54,50,"Pilot 9","Pilot 9: bigger feedback + text"
19,"SUPPRF94497",80,3,49,-1,12,85,37,50,"Pilot 9","Pilot 9: bigger feedback + text"
20,"SUPPRF94497",59,4,16,-19,-13,81,29,35,"Pilot 9","Pilot 9: bigger feedback + text"
21,"SUPPRF94497",74,4,58,8,12,79,46,50,"Pilot 9","Pilot 9: bigger feedback + text"
22,"SUPPRF94497",73,6,41,1,-13,73,54,40,"Pilot 9","Pilot 9: bigger feedback + text"
23,"SUPPRF94497",72,4,70,12,-1,62,71,58,"Pilot 9","Pilot 9: bigger feedback + text"
24,"SUPPRF94497",72,0,46,-9,17,73,29,55,"Pilot 9","Pilot 9: bigger feedback + text"
25,"SUPPRF94497",76,0,63,5,0,18,63,58,"Pilot 9","Pilot 9: bigger feedback + text"
26,"SUPPRF94497",89,0,94,24,23,91,71,70,"Pilot 9","Pilot 9: bigger feedback + text"
27,"SUPPRF94497",75,0,50,-2,-13,83,63,52,"Pilot 9","Pilot 9: bigger feedback + text"
28,"SUPPRF94497",74,0,45,-3,-1,79,46,48,"Pilot 9","Pilot 9: bigger feedback + text"
29,"SUPPRF94497",80,0,83,29,12,65,71,54,"Pilot 9","Pilot 9: bigger feedback + text"
30,"SUPPRF94497",77,0,22,-8,-15,83,37,30,"Pilot 9","Pilot 9: bigger feedback + text"
31,"SUPPRF94497",78,1,33,-8,-13,80,46,41,"Pilot 9","Pilot 9: bigger feedback + text"
32,"SUPPRF94497",81,0,24,-24,-13,32,37,48,"Pilot 9","Pilot 9: bigger feedback + text"
33,"SUPPRF94497",53,8,81,-19,1,100,80,100,"Pilot 9","Pilot 9: bigger feedback + text"
34,"SUPPRF94497",65,0,71,-3,0,61,71,74,"Pilot 9","Pilot 9: bigger feedback + text"
35,"SUPPRF94497",68,0,37,-5,0,60,37,42,"Pilot 9","Pilot 9: bigger feedback + text"
36,"SUPPRF94497",81,6,66,4,12,82,54,62,"Pilot 9","Pilot 9: bigger feedback + text"
37,"SUPPRF94497",76,0,55,-8,-16,54,71,63,"Pilot 9","Pilot 9: bigger feedback + text"
38,"SUPPRF94497",81,0,75,32,29,91,46,43,"Pilot 9","Pilot 9: bigger feedback + text"
39,"SUPPRF94497",13,0,6,-19,-14,84,20,25,"Pilot 9","Pilot 9: bigger feedback + text"
40,"SUPPRF94497",91,2,47,27,27,90,20,20,"Pilot 9","Pilot 9: bigger feedback + text"
41,"SUPPRF94497",100,0,100,27,20,59,80,73,"Pilot 9","Pilot 9: bigger feedback + text"
42,"SUPPRF94497",84,0,35,16,15,89,20,19,"Pilot 9","Pilot 9: bigger feedback + text"
43,"SUPPRF94497",100,0,38,-7,1,88,37,45,"Pilot 9","Pilot 9: bigger feedback + text"
44,"SUPPRF94497",81,0,62,13,-1,81,63,49,"Pilot 9","Pilot 9: bigger feedback + text"
45,"SUPPRF94497",90,0,61,28,24,63,37,33,"Pilot 9","Pilot 9: bigger feedback + text"
46,"SUPPRF94497",57,0,15,-20,-14,84,29,35,"Pilot 9","Pilot 9: bigger feedback + text"
47,"SUPPRF94497",75,0,28,4,-1,85,29,24,"Pilot 9","Pilot 9: bigger feedback + text"
48,"SUPPRF94497",80,0,29,5,0,84,29,24,"Pilot 9","Pilot 9: bigger feedback + text"
1,"SUPPRF15709",51,42,68,31,-12,16,80,37,"Pilot 9","Pilot 9: bigger feedback + text"
2,"SUPPRF15709",28,35,63,31,0,17,63,32,"Pilot 9","Pilot 9: bigger feedback + text"
3,"SUPPRF15709",44,63,46,19,0,13,46,27,"Pilot 9","Pilot 9: bigger feedback + text"
4,"SUPPRF15709",44,24,80,62,0,16,80,18,"Pilot 9","Pilot 9: bigger feedback + text"
5,"SUPPRF15709",43,36,47,22,-16,32,63,25,"Pilot 9","Pilot 9: bigger feedback + text"
6,"SUPPRF15709",45,46,22,7,-15,55,37,15,"Pilot 9","Pilot 9: bigger feedback + text"
7,"SUPPRF15709",42,36,55,33,1,19,54,22,"Pilot 9","Pilot 9: bigger feedback + text"
8,"SUPPRF15709",33,34,49,20,12,13,37,29,"Pilot 9","Pilot 9: bigger feedback + text"
9,"SUPPRF15709",39,41,50,23,-13,12,63,27,"Pilot 9","Pilot 9: bigger feedback + text"
10,"SUPPRF15709",46,44,100,64,20,14,80,36,"Pilot 9","Pilot 9: bigger feedback + text"
11,"SUPPRF15709",41,46,34,13,-12,74,46,21,"Pilot 9","Pilot 9: bigger feedback + text"
12,"SUPPRF15709",45,41,77,48,14,67,63,29,"Pilot 9","Pilot 9: bigger feedback + text"
13,"SUPPRF15709",35,46,24,-8,-13,42,37,32,"Pilot 9","Pilot 9: bigger feedback + text"
14,"SUPPRF15709",46,37,71,45,0,70,71,26,"Pilot 9","Pilot 9: bigger feedback + text"
15,"SUPPRF15709",28,29,67,45,-13,26,80,22,"Pilot 9","Pilot 9: bigger feedback + text"
16,"SUPPRF15709",36,36,16,-12,-13,22,29,28,"Pilot 9","Pilot 9: bigger feedback + text"
17,"SUPPRF15709",27,28,46,14,17,27,29,32,"Pilot 9","Pilot 9: bigger feedback + text"
18,"SUPPRF15709",39,30,55,31,-16,37,71,24,"Pilot 9","Pilot 9: bigger feedback + text"
19,"SUPPRF15709",30,40,33,3,-13,45,46,30,"Pilot 9","Pilot 9: bigger feedback + text"
20,"SUPPRF15709",20,53,47,14,27,7,20,33,"Pilot 9","Pilot 9: bigger feedback + text"
21,"SUPPRF15709",20,34,88,69,25,77,63,19,"Pilot 9","Pilot 9: bigger feedback + text"
22,"SUPPRF15709",17,46,38,11,1,9,37,27,"Pilot 9","Pilot 9: bigger feedback + text"
23,"SUPPRF15709",17,44,38,15,-16,55,54,23,"Pilot 9","Pilot 9: bigger feedback + text"
24,"SUPPRF15709",34,43,66,39,12,4,54,27,"Pilot 9","Pilot 9: bigger feedback + text"
25,"SUPPRF15709",33,43,41,6,-13,20,54,35,"Pilot 9","Pilot 9: bigger feedback + text"
26,"SUPPRF15709",41,28,94,77,23,7,71,17,"Pilot 9","Pilot 9: bigger feedback + text"
27,"SUPPRF15709",11,33,56,34,-15,7,71,22,"Pilot 9","Pilot 9: bigger feedback + text"
28,"SUPPRF15709",15,20,20,5,0,54,20,15,"Pilot 9","Pilot 9: bigger feedback + text"
29,"SUPPRF15709",18,66,81,41,1,65,80,40,"Pilot 9","Pilot 9: bigger feedback + text"
30,"SUPPRF15709",25,46,58,23,29,9,29,35,"Pilot 9","Pilot 9: bigger feedback + text"
31,"SUPPRF15709",34,22,28,-9,-1,16,29,37,"Pilot 9","Pilot 9: bigger feedback + text"
32,"SUPPRF15709",23,60,61,27,24,19,37,34,"Pilot 9","Pilot 9: bigger feedback + text"
33,"SUPPRF15709",23,56,8,-12,-12,55,20,20,"Pilot 9","Pilot 9: bigger feedback + text"
34,"SUPPRF15709",33,33,70,29,-1,14,71,41,"Pilot 9","Pilot 9: bigger feedback + text"
35,"SUPPRF15709",26,56,45,17,-1,11,46,28,"Pilot 9","Pilot 9: bigger feedback + text"
36,"SUPPRF15709",25,28,29,-4,0,14,29,33,"Pilot 9","Pilot 9: bigger feedback + text"
37,"SUPPRF15709",46,27,58,40,12,80,46,18,"Pilot 9","Pilot 9: bigger feedback + text"
38,"SUPPRF15709",33,29,54,28,0,42,54,26,"Pilot 9","Pilot 9: bigger feedback + text"
39,"SUPPRF15709",35,31,83,59,12,14,71,24,"Pilot 9","Pilot 9: bigger feedback + text"
40,"SUPPRF15709",24,22,15,-7,-14,15,29,22,"Pilot 9","Pilot 9: bigger feedback + text"
41,"SUPPRF15709",46,38,35,20,15,75,20,15,"Pilot 9","Pilot 9: bigger feedback + text"
42,"SUPPRF15709",27,26,6,-32,-14,35,20,38,"Pilot 9","Pilot 9: bigger feedback + text"
43,"SUPPRF15709",35,37,75,44,29,9,46,31,"Pilot 9","Pilot 9: bigger feedback + text"
44,"SUPPRF15709",32,33,96,74,16,11,80,22,"Pilot 9","Pilot 9: bigger feedback + text"
45,"SUPPRF15709",28,31,37,11,0,12,37,26,"Pilot 9","Pilot 9: bigger feedback + text"
46,"SUPPRF15709",45,24,19,-18,-1,36,20,37,"Pilot 9","Pilot 9: bigger feedback + text"
47,"SUPPRF15709",42,30,78,49,24,6,54,29,"Pilot 9","Pilot 9: bigger feedback + text"
48,"SUPPRF15709",34,33,62,32,-1,39,63,30,"Pilot 9","Pilot 9: bigger feedback + text"
1,"SUPPRF43675",75,37,88,65,25,53,63,23,"Pilot 9","Pilot 9: bigger feedback + text"
2,"SUPPRF43675",58,55,6,-9,-14,48,20,15,"Pilot 9","Pilot 9: bigger feedback + text"
3,"SUPPRF43675",59,66,46,-3,17,57,29,49,"Pilot 9","Pilot 9: bigger feedback + text"
4,"SUPPRF43675",48,60,24,-28,-13,72,37,52,"Pilot 9","Pilot 9: bigger feedback + text"
5,"SUPPRF43675",55,57,34,23,-12,55,46,11,"Pilot 9","Pilot 9: bigger feedback + text"
6,"SUPPRF43675",54,67,62,19,-1,26,63,43,"Pilot 9","Pilot 9: bigger feedback + text"
7,"SUPPRF43675",65,59,81,16,1,66,80,65,"Pilot 9","Pilot 9: bigger feedback + text"
8,"SUPPRF43675",67,69,37,-12,0,51,37,49,"Pilot 9","Pilot 9: bigger feedback + text"
9,"SUPPRF43675",65,63,68,-4,-12,63,80,72,"Pilot 9","Pilot 9: bigger feedback + text"
10,"SUPPRF43675",66,69,100,57,20,71,80,43,"Pilot 9","Pilot 9: bigger feedback + text"
11,"SUPPRF43675",60,63,63,12,0,59,63,51,"Pilot 9","Pilot 9: bigger feedback + text"
12,"SUPPRF43675",47,59,15,-26,-14,61,29,41,"Pilot 9","Pilot 9: bigger feedback + text"
13,"SUPPRF43675",55,63,83,76,12,40,71,7,"Pilot 9","Pilot 9: bigger feedback + text"
14,"SUPPRF43675",69,71,78,12,24,53,54,66,"Pilot 9","Pilot 9: bigger feedback + text"
15,"SUPPRF43675",51,58,71,30,0,61,71,41,"Pilot 9","Pilot 9: bigger feedback + text"
16,"SUPPRF43675",70,61,47,37,27,73,20,10,"Pilot 9","Pilot 9: bigger feedback + text"
17,"SUPPRF43675",70,75,38,-6,1,62,37,44,"Pilot 9","Pilot 9: bigger feedback + text"
18,"SUPPRF43675",71,65,38,3,-16,59,54,35,"Pilot 9","Pilot 9: bigger feedback + text"
19,"SUPPRF43675",70,74,54,16,0,68,54,38,"Pilot 9","Pilot 9: bigger feedback + text"
20,"SUPPRF43675",72,70,58,7,29,73,29,51,"Pilot 9","Pilot 9: bigger feedback + text"
21,"SUPPRF43675",70,70,22,-30,-15,67,37,52,"Pilot 9","Pilot 9: bigger feedback + text"
22,"SUPPRF43675",73,63,28,17,-1,76,29,11,"Pilot 9","Pilot 9: bigger feedback + text"
23,"SUPPRF43675",57,69,20,-19,0,55,20,39,"Pilot 9","Pilot 9: bigger feedback + text"
24,"SUPPRF43675",65,69,66,9,12,67,54,57,"Pilot 9","Pilot 9: bigger feedback + text"
25,"SUPPRF43675",64,63,70,52,-1,50,71,18,"Pilot 9","Pilot 9: bigger feedback + text"
26,"SUPPRF43675",68,73,56,-6,-15,34,71,62,"Pilot 9","Pilot 9: bigger feedback + text"
27,"SUPPRF43675",74,67,58,30,12,48,46,28,"Pilot 9","Pilot 9: bigger feedback + text"
28,"SUPPRF43675",69,68,61,22,24,58,37,39,"Pilot 9","Pilot 9: bigger feedback + text"
29,"SUPPRF43675",48,55,8,-15,-12,55,20,23,"Pilot 9","Pilot 9: bigger feedback + text"
30,"SUPPRF43675",74,72,75,64,29,57,46,11,"Pilot 9","Pilot 9: bigger feedback + text"
31,"SUPPRF43675",54,65,94,36,23,58,71,58,"Pilot 9","Pilot 9: bigger feedback + text"
32,"SUPPRF43675",59,72,47,2,-16,61,63,45,"Pilot 9","Pilot 9: bigger feedback + text"
33,"SUPPRF43675",78,74,96,24,16,21,80,72,"Pilot 9","Pilot 9: bigger feedback + text"
34,"SUPPRF43675",69,71,35,29,15,37,20,6,"Pilot 9","Pilot 9: bigger feedback + text"
35,"SUPPRF43675",65,77,77,33,14,53,63,44,"Pilot 9","Pilot 9: bigger feedback + text"
36,"SUPPRF43675",72,64,49,4,12,34,37,45,"Pilot 9","Pilot 9: bigger feedback + text"
37,"SUPPRF43675",75,71,80,16,0,29,80,64,"Pilot 9","Pilot 9: bigger feedback + text"
38,"SUPPRF43675",70,66,55,31,1,69,54,24,"Pilot 9","Pilot 9: bigger feedback + text"
39,"SUPPRF43675",66,77,46,-5,0,57,46,51,"Pilot 9","Pilot 9: bigger feedback + text"
40,"SUPPRF43675",73,52,33,-7,-13,64,46,40,"Pilot 9","Pilot 9: bigger feedback + text"
41,"SUPPRF43675",65,56,19,15,-1,54,20,4,"Pilot 9","Pilot 9: bigger feedback + text"
42,"SUPPRF43675",60,74,16,-20,-13,53,29,36,"Pilot 9","Pilot 9: bigger feedback + text"
43,"SUPPRF43675",53,72,41,17,-13,50,54,24,"Pilot 9","Pilot 9: bigger feedback + text"
44,"SUPPRF43675",74,67,29,-21,0,66,29,50,"Pilot 9","Pilot 9: bigger feedback + text"
45,"SUPPRF43675",78,79,45,3,-1,60,46,42,"Pilot 9","Pilot 9: bigger feedback + text"
46,"SUPPRF43675",72,64,55,25,-16,56,71,30,"Pilot 9","Pilot 9: bigger feedback + text"
47,"SUPPRF43675",74,58,50,0,-13,71,63,50,"Pilot 9","Pilot 9: bigger feedback + text"
48,"SUPPRF43675",78,46,67,31,-13,59,80,36,"Pilot 9","Pilot 9: bigger feedback + text"
1,"SUPPRF43222",48,24,29,-51,0,66,29,80,"Pilot 9","Pilot 9: bigger feedback + text"
2,"SUPPRF43222",47,17,56,-34,-15,69,71,90,"Pilot 9","Pilot 9: bigger feedback + text"
3,"SUPPRF43222",50,30,63,-4,0,57,63,67,"Pilot 9","Pilot 9: bigger feedback + text"
4,"SUPPRF43222",49,26,68,6,-12,41,80,62,"Pilot 9","Pilot 9: bigger feedback + text"
5,"SUPPRF43222",50,20,8,-59,-12,60,20,67,"Pilot 9","Pilot 9: bigger feedback + text"
6,"SUPPRF43222",50,13,46,-30,0,71,46,76,"Pilot 9","Pilot 9: bigger feedback + text"
7,"SUPPRF43222",50,18,47,-26,-16,74,63,73,"Pilot 9","Pilot 9: bigger feedback + text"
8,"SUPPRF43222",48,24,6,-68,-14,67,20,74,"Pilot 9","Pilot 9: bigger feedback + text"
9,"SUPPRF43222",51,14,80,24,0,67,80,56,"Pilot 9","Pilot 9: bigger feedback + text"
10,"SUPPRF43222",50,16,41,-30,-13,82,54,71,"Pilot 9","Pilot 9: bigger feedback + text"
11,"SUPPRF43222",49,22,71,26,0,46,71,45,"Pilot 9","Pilot 9: bigger feedback + text"
12,"SUPPRF43222",51,24,35,2,15,67,20,33,"Pilot 9","Pilot 9: bigger feedback + text"
13,"SUPPRF43222",55,26,81,7,1,65,80,74,"Pilot 9","Pilot 9: bigger feedback + text"
14,"SUPPRF43222",51,22,100,10,20,62,80,90,"Pilot 9","Pilot 9: bigger feedback + text"
15,"SUPPRF43222",47,15,50,-13,-13,41,63,63,"Pilot 9","Pilot 9: bigger feedback + text"
16,"SUPPRF43222",49,18,24,-54,-13,70,37,78,"Pilot 9","Pilot 9: bigger feedback + text"
17,"SUPPRF43222",50,25,77,7,14,69,63,70,"Pilot 9","Pilot 9: bigger feedback + text"
18,"SUPPRF43222",48,30,58,-8,29,63,29,66,"Pilot 9","Pilot 9: bigger feedback + text"
19,"SUPPRF43222",50,13,55,-18,1,64,54,73,"Pilot 9","Pilot 9: bigger feedback + text"
20,"SUPPRF43222",49,13,61,21,24,73,37,40,"Pilot 9","Pilot 9: bigger feedback + text"
21,"SUPPRF43222",50,22,33,-9,-13,72,46,42,"Pilot 9","Pilot 9: bigger feedback + text"
22,"SUPPRF43222",48,21,94,7,23,77,71,87,"Pilot 9","Pilot 9: bigger feedback + text"
23,"SUPPRF43222",49,24,49,-15,12,40,37,64,"Pilot 9","Pilot 9: bigger feedback + text"
24,"SUPPRF43222",47,14,45,-36,-1,71,46,81,"Pilot 9","Pilot 9: bigger feedback + text"
25,"SUPPRF43222",50,25,83,-1,12,58,71,84,"Pilot 9","Pilot 9: bigger feedback + text"
26,"SUPPRF43222",57,31,19,-50,-1,42,20,69,"Pilot 9","Pilot 9: bigger feedback + text"
27,"SUPPRF43222",51,26,78,11,24,46,54,67,"Pilot 9","Pilot 9: bigger feedback + text"
28,"SUPPRF43222",49,21,34,-49,-12,62,46,83,"Pilot 9","Pilot 9: bigger feedback + text"
29,"SUPPRF43222",54,24,46,-23,17,37,29,69,"Pilot 9","Pilot 9: bigger feedback + text"
30,"SUPPRF43222",50,21,67,-10,-13,78,80,77,"Pilot 9","Pilot 9: bigger feedback + text"
31,"SUPPRF43222",49,17,22,-40,-15,43,37,62,"Pilot 9","Pilot 9: bigger feedback + text"
32,"SUPPRF43222",50,26,58,-7,12,40,46,65,"Pilot 9","Pilot 9: bigger feedback + text"
33,"SUPPRF43222",53,19,75,9,29,39,46,66,"Pilot 9","Pilot 9: bigger feedback + text"
34,"SUPPRF43222",53,15,16,-29,-13,67,29,45,"Pilot 9","Pilot 9: bigger feedback + text"
35,"SUPPRF43222",49,22,28,-32,-1,41,29,60,"Pilot 9","Pilot 9: bigger feedback + text"
36,"SUPPRF43222",52,27,66,-11,12,75,54,77,"Pilot 9","Pilot 9: bigger feedback + text"
37,"SUPPRF43222",48,12,37,7,0,81,37,30,"Pilot 9","Pilot 9: bigger feedback + text"
38,"SUPPRF43222",48,21,62,-4,-1,40,63,66,"Pilot 9","Pilot 9: bigger feedback + text"
39,"SUPPRF43222",50,36,38,-9,-16,65,54,47,"Pilot 9","Pilot 9: bigger feedback + text"
40,"SUPPRF43222",48,23,47,1,27,61,20,46,"Pilot 9","Pilot 9: bigger feedback + text"
41,"SUPPRF43222",49,15,15,-54,-14,33,29,69,"Pilot 9","Pilot 9: bigger feedback + text"
42,"SUPPRF43222",50,20,88,26,25,38,63,62,"Pilot 9","Pilot 9: bigger feedback + text"
43,"SUPPRF43222",49,18,38,-42,1,37,37,80,"Pilot 9","Pilot 9: bigger feedback + text"
44,"SUPPRF43222",48,16,20,-47,0,39,20,67,"Pilot 9","Pilot 9: bigger feedback + text"
45,"SUPPRF43222",51,18,96,10,16,62,80,86,"Pilot 9","Pilot 9: bigger feedback + text"
46,"SUPPRF43222",50,14,70,4,-1,40,71,66,"Pilot 9","Pilot 9: bigger feedback + text"
47,"SUPPRF43222",44,20,54,-9,0,41,54,63,"Pilot 9","Pilot 9: bigger feedback + text"
48,"SUPPRF43222",51,16,55,-24,-16,57,71,79,"Pilot 9","Pilot 9: bigger feedback + text"
1,"SUPPRF78720",49,51,58,18,29,59,29,40,"Pilot 9","Pilot 9: bigger feedback + text"
2,"SUPPRF78720",54,49,62,1,-1,49,63,61,"Pilot 9","Pilot 9: bigger feedback + text"
3,"SUPPRF78720",49,50,29,-7,0,50,29,36,"Pilot 9","Pilot 9: bigger feedback + text"
4,"SUPPRF78720",50,30,41,-2,-13,49,54,43,"Pilot 9","Pilot 9: bigger feedback + text"
5,"SUPPRF78720",61,28,80,5,0,69,80,75,"Pilot 9","Pilot 9: bigger feedback + text"
6,"SUPPRF78720",54,26,63,12,0,31,63,51,"Pilot 9","Pilot 9: bigger feedback + text"
7,"SUPPRF78720",54,26,96,59,16,51,80,37,"Pilot 9","Pilot 9: bigger feedback + text"
8,"SUPPRF78720",53,37,33,-28,-13,32,46,61,"Pilot 9","Pilot 9: bigger feedback + text"
9,"SUPPRF78720",51,32,19,6,-1,66,20,13,"Pilot 9","Pilot 9: bigger feedback + text"
10,"SUPPRF78720",55,51,38,-1,1,37,37,39,"Pilot 9","Pilot 9: bigger feedback + text"
11,"SUPPRF78720",50,44,58,-3,12,54,46,61,"Pilot 9","Pilot 9: bigger feedback + text"
12,"SUPPRF78720",52,49,47,20,27,57,20,27,"Pilot 9","Pilot 9: bigger feedback + text"
13,"SUPPRF78720",49,47,94,47,23,45,71,47,"Pilot 9","Pilot 9: bigger feedback + text"
14,"SUPPRF78720",50,50,70,5,-1,65,71,65,"Pilot 9","Pilot 9: bigger feedback + text"
15,"SUPPRF78720",47,51,71,9,0,45,71,62,"Pilot 9","Pilot 9: bigger feedback + text"
16,"SUPPRF78720",57,38,100,29,20,59,80,71,"Pilot 9","Pilot 9: bigger feedback + text"
17,"SUPPRF78720",49,49,77,19,14,44,63,58,"Pilot 9","Pilot 9: bigger feedback + text"
18,"SUPPRF78720",51,51,68,1,-12,50,80,67,"Pilot 9","Pilot 9: bigger feedback + text"
19,"SUPPRF78720",50,48,66,17,12,46,54,49,"Pilot 9","Pilot 9: bigger feedback + text"
20,"SUPPRF78720",49,51,83,31,12,67,71,52,"Pilot 9","Pilot 9: bigger feedback + text"
21,"SUPPRF78720",50,52,22,-2,-15,59,37,24,"Pilot 9","Pilot 9: bigger feedback + text"
22,"SUPPRF78720",50,50,75,38,29,29,46,37,"Pilot 9","Pilot 9: bigger feedback + text"
23,"SUPPRF78720",49,48,38,-2,-16,61,54,40,"Pilot 9","Pilot 9: bigger feedback + text"
24,"SUPPRF78720",49,48,46,-3,17,27,29,49,"Pilot 9","Pilot 9: bigger feedback + text"
25,"SUPPRF78720",49,50,61,10,24,38,37,51,"Pilot 9","Pilot 9: bigger feedback + text"
26,"SUPPRF78720",48,49,24,-20,-13,31,37,44,"Pilot 9","Pilot 9: bigger feedback + text"
27,"SUPPRF78720",51,51,28,5,-1,58,29,23,"Pilot 9","Pilot 9: bigger feedback + text"
28,"SUPPRF78720",50,51,37,-2,0,49,37,39,"Pilot 9","Pilot 9: bigger feedback + text"
29,"SUPPRF78720",49,51,56,12,-15,49,71,44,"Pilot 9","Pilot 9: bigger feedback + text"
30,"SUPPRF78720",49,50,15,-24,-14,66,29,39,"Pilot 9","Pilot 9: bigger feedback + text"
31,"SUPPRF78720",49,51,20,-41,0,47,20,61,"Pilot 9","Pilot 9: bigger feedback + text"
32,"SUPPRF78720",49,50,81,24,1,59,80,57,"Pilot 9","Pilot 9: bigger feedback + text"
33,"SUPPRF78720",51,51,49,-14,12,50,37,63,"Pilot 9","Pilot 9: bigger feedback + text"
34,"SUPPRF78720",49,48,6,-23,-14,31,20,29,"Pilot 9","Pilot 9: bigger feedback + text"
35,"SUPPRF78720",51,50,47,-9,-16,44,63,56,"Pilot 9","Pilot 9: bigger feedback + text"
36,"SUPPRF78720",49,50,50,10,-13,21,63,40,"Pilot 9","Pilot 9: bigger feedback + text"
37,"SUPPRF78720",50,49,67,56,-13,63,80,11,"Pilot 9","Pilot 9: bigger feedback + text"
38,"SUPPRF78720",51,51,88,34,25,60,63,54,"Pilot 9","Pilot 9: bigger feedback + text"
39,"SUPPRF78720",51,51,78,16,24,54,54,62,"Pilot 9","Pilot 9: bigger feedback + text"
40,"SUPPRF78720",52,50,35,-14,15,21,20,49,"Pilot 9","Pilot 9: bigger feedback + text"
41,"SUPPRF78720",50,50,16,-8,-13,68,29,24,"Pilot 9","Pilot 9: bigger feedback + text"
42,"SUPPRF78720",48,48,34,28,-12,99,46,6,"Pilot 9","Pilot 9: bigger feedback + text"
43,"SUPPRF78720",49,50,45,11,-1,42,46,34,"Pilot 9","Pilot 9: bigger feedback + text"
44,"SUPPRF78720",48,49,46,-1,0,64,46,47,"Pilot 9","Pilot 9: bigger feedback + text"
45,"SUPPRF78720",51,51,54,19,0,60,54,35,"Pilot 9","Pilot 9: bigger feedback + text"
46,"SUPPRF78720",49,47,55,18,-16,24,71,37,"Pilot 9","Pilot 9: bigger feedback + text"
47,"SUPPRF78720",49,50,55,6,1,76,54,49,"Pilot 9","Pilot 9: bigger feedback + text"
48,"SUPPRF78720",41,54,8,-35,-12,64,20,43,"Pilot 9","Pilot 9: bigger feedback + text"
1,"SUPPRF28694",68,49,62,50,-1,11,63,12,"Pilot 9","Pilot 9: bigger feedback + text"
2,"SUPPRF28694",63,20,63,43,0,29,63,20,"Pilot 9","Pilot 9: bigger feedback + text"
3,"SUPPRF28694",79,20,54,22,0,25,54,32,"Pilot 9","Pilot 9: bigger feedback + text"
4,"SUPPRF28694",49,29,22,-20,-15,22,37,42,"Pilot 9","Pilot 9: bigger feedback + text"
5,"SUPPRF28694",75,25,83,33,12,52,71,50,"Pilot 9","Pilot 9: bigger feedback + text"
6,"SUPPRF28694",61,15,41,-11,-13,41,54,52,"Pilot 9","Pilot 9: bigger feedback + text"
7,"SUPPRF28694",74,18,81,59,1,56,80,22,"Pilot 9","Pilot 9: bigger feedback + text"
8,"SUPPRF28694",68,15,75,25,29,14,46,50,"Pilot 9","Pilot 9: bigger feedback + text"
9,"SUPPRF28694",100,6,100,60,20,15,80,40,"Pilot 9","Pilot 9: bigger feedback + text"
10,"SUPPRF28694",67,20,20,-53,0,65,20,73,"Pilot 9","Pilot 9: bigger feedback + text"
11,"SUPPRF28694",60,15,55,-13,-16,52,71,68,"Pilot 9","Pilot 9: bigger feedback + text"
12,"SUPPRF28694",47,24,33,1,-13,16,46,32,"Pilot 9","Pilot 9: bigger feedback + text"
13,"SUPPRF28694",66,14,24,-1,-13,24,37,25,"Pilot 9","Pilot 9: bigger feedback + text"
14,"SUPPRF28694",56,18,55,32,1,25,54,23,"Pilot 9","Pilot 9: bigger feedback + text"
15,"SUPPRF28694",15,23,8,-7,-12,14,20,15,"Pilot 9","Pilot 9: bigger feedback + text"
16,"SUPPRF28694",54,18,56,-5,-15,45,71,61,"Pilot 9","Pilot 9: bigger feedback + text"
17,"SUPPRF28694",33,32,15,-23,-14,33,29,38,"Pilot 9","Pilot 9: bigger feedback + text"
18,"SUPPRF28694",21,26,58,27,29,28,29,31,"Pilot 9","Pilot 9: bigger feedback + text"
19,"SUPPRF28694",26,22,66,32,12,22,54,34,"Pilot 9","Pilot 9: bigger feedback + text"
20,"SUPPRF28694",39,20,50,-13,-13,19,63,63,"Pilot 9","Pilot 9: bigger feedback + text"
21,"SUPPRF28694",51,13,28,9,-1,54,29,19,"Pilot 9","Pilot 9: bigger feedback + text"
22,"SUPPRF28694",79,20,94,66,23,30,71,28,"Pilot 9","Pilot 9: bigger feedback + text"
23,"SUPPRF28694",28,30,46,13,0,35,46,33,"Pilot 9","Pilot 9: bigger feedback + text"
24,"SUPPRF28694",35,37,77,37,14,7,63,40,"Pilot 9","Pilot 9: bigger feedback + text"
25,"SUPPRF28694",56,34,68,18,-12,20,80,50,"Pilot 9","Pilot 9: bigger feedback + text"
26,"SUPPRF28694",50,22,38,-4,1,24,37,42,"Pilot 9","Pilot 9: bigger feedback + text"
27,"SUPPRF28694",42,27,80,53,0,42,80,27,"Pilot 9","Pilot 9: bigger feedback + text"
28,"SUPPRF28694",38,30,35,-13,15,40,20,48,"Pilot 9","Pilot 9: bigger feedback + text"
29,"SUPPRF28694",44,35,49,-2,12,41,37,51,"Pilot 9","Pilot 9: bigger feedback + text"
30,"SUPPRF28694",39,25,45,0,-1,46,46,45,"Pilot 9","Pilot 9: bigger feedback + text"
31,"SUPPRF28694",45,29,34,-7,-12,30,46,41,"Pilot 9","Pilot 9: bigger feedback + text"
32,"SUPPRF28694",40,24,78,58,24,8,54,20,"Pilot 9","Pilot 9: bigger feedback + text"
33,"SUPPRF28694",36,32,38,8,-16,38,54,30,"Pilot 9","Pilot 9: bigger feedback + text"
34,"SUPPRF28694",44,29,70,26,-1,4,71,44,"Pilot 9","Pilot 9: bigger feedback + text"
35,"SUPPRF28694",34,50,37,15,0,13,37,22,"Pilot 9","Pilot 9: bigger feedback + text"
36,"SUPPRF28694",40,42,47,30,-16,41,63,17,"Pilot 9","Pilot 9: bigger feedback + text"
37,"SUPPRF28694",46,29,19,-16,-1,26,20,35,"Pilot 9","Pilot 9: bigger feedback + text"
38,"SUPPRF28694",57,54,67,31,-13,42,80,36,"Pilot 9","Pilot 9: bigger feedback + text"
39,"SUPPRF28694",27,26,16,-20,-13,24,29,36,"Pilot 9","Pilot 9: bigger feedback + text"
40,"SUPPRF28694",38,34,47,30,27,23,20,17,"Pilot 9","Pilot 9: bigger feedback + text"
41,"SUPPRF28694",28,21,71,44,0,20,71,27,"Pilot 9","Pilot 9: bigger feedback + text"
42,"SUPPRF28694",56,8,46,5,17,22,29,41,"Pilot 9","Pilot 9: bigger feedback + text"
43,"SUPPRF28694",67,24,88,44,25,33,63,44,"Pilot 9","Pilot 9: bigger feedback + text"
44,"SUPPRF28694",20,15,61,24,24,21,37,37,"Pilot 9","Pilot 9: bigger feedback + text"
45,"SUPPRF28694",32,37,6,-21,-14,25,20,27,"Pilot 9","Pilot 9: bigger feedback + text"
46,"SUPPRF28694",43,40,58,26,12,39,46,32,"Pilot 9","Pilot 9: bigger feedback + text"
47,"SUPPRF28694",35,23,29,9,0,28,29,20,"Pilot 9","Pilot 9: bigger feedback + text"
48,"SUPPRF28694",26,23,96,83,16,6,80,13,"Pilot 9","Pilot 9: bigger feedback + text"
1,"SUPPRF90079",71,28,16,-11,-13,88,29,27,"Pilot 9","Pilot 9: bigger feedback + text"
2,"SUPPRF90079",89,6,35,26,15,96,20,9,"Pilot 9","Pilot 9: bigger feedback + text"
3,"SUPPRF90079",79,12,50,-25,-13,71,63,75,"Pilot 9","Pilot 9: bigger feedback + text"
4,"SUPPRF90079",88,12,47,3,27,63,20,44,"Pilot 9","Pilot 9: bigger feedback + text"
5,"SUPPRF90079",90,12,61,10,24,73,37,51,"Pilot 9","Pilot 9: bigger feedback + text"
6,"SUPPRF90079",84,12,19,-46,-1,63,20,65,"Pilot 9","Pilot 9: bigger feedback + text"
7,"SUPPRF90079",80,8,20,-43,0,31,20,63,"Pilot 9","Pilot 9: bigger feedback + text"
8,"SUPPRF90079",89,6,71,9,0,25,71,62,"Pilot 9","Pilot 9: bigger feedback + text"
9,"SUPPRF90079",86,10,46,-4,17,25,29,50,"Pilot 9","Pilot 9: bigger feedback + text"
10,"SUPPRF90079",89,8,8,-71,-12,14,20,79,"Pilot 9","Pilot 9: bigger feedback + text"
11,"SUPPRF90079",94,7,15,-85,-14,22,29,100,"Pilot 9","Pilot 9: bigger feedback + text"
12,"SUPPRF90079",87,7,58,2,12,59,46,56,"Pilot 9","Pilot 9: bigger feedback + text"
13,"SUPPRF90079",88,9,67,8,-13,10,80,59,"Pilot 9","Pilot 9: bigger feedback + text"
14,"SUPPRF90079",87,10,38,-18,1,73,37,56,"Pilot 9","Pilot 9: bigger feedback + text"
15,"SUPPRF90079",87,7,29,-41,0,22,29,70,"Pilot 9","Pilot 9: bigger feedback + text"
16,"SUPPRF90079",87,12,38,-23,-16,12,54,61,"Pilot 9","Pilot 9: bigger feedback + text"
17,"SUPPRF90079",87,5,24,-43,-13,15,37,67,"Pilot 9","Pilot 9: bigger feedback + text"
18,"SUPPRF90079",97,5,63,-17,0,18,63,80,"Pilot 9","Pilot 9: bigger feedback + text"
19,"SUPPRF90079",90,7,100,27,20,19,80,73,"Pilot 9","Pilot 9: bigger feedback + text"
20,"SUPPRF90079",88,7,41,-38,-13,16,54,79,"Pilot 9","Pilot 9: bigger feedback + text"
21,"SUPPRF90079",86,9,33,-9,-13,29,46,42,"Pilot 9","Pilot 9: bigger feedback + text"
22,"SUPPRF90079",85,10,55,-15,-16,14,71,70,"Pilot 9","Pilot 9: bigger feedback + text"
23,"SUPPRF90079",100,0,37,-52,0,60,37,89,"Pilot 9","Pilot 9: bigger feedback + text"
24,"SUPPRF90079",100,2,58,-15,29,22,29,73,"Pilot 9","Pilot 9: bigger feedback + text"
25,"SUPPRF90079",86,10,68,-22,-12,11,80,90,"Pilot 9","Pilot 9: bigger feedback + text"
26,"SUPPRF90079",83,8,34,-32,-12,75,46,66,"Pilot 9","Pilot 9: bigger feedback + text"
27,"SUPPRF90079",83,18,47,-25,-16,16,63,72,"Pilot 9","Pilot 9: bigger feedback + text"
28,"SUPPRF90079",86,11,80,8,0,15,80,72,"Pilot 9","Pilot 9: bigger feedback + text"
29,"SUPPRF90079",91,9,83,14,12,18,71,69,"Pilot 9","Pilot 9: bigger feedback + text"
30,"SUPPRF90079",80,11,49,-17,12,12,37,66,"Pilot 9","Pilot 9: bigger feedback + text"
31,"SUPPRF90079",87,14,94,19,23,18,71,75,"Pilot 9","Pilot 9: bigger feedback + text"
32,"SUPPRF90079",91,5,96,30,16,69,80,66,"Pilot 9","Pilot 9: bigger feedback + text"
33,"SUPPRF90079",91,11,78,7,24,19,54,71,"Pilot 9","Pilot 9: bigger feedback + text"
34,"SUPPRF90079",85,13,45,-30,-1,19,46,75,"Pilot 9","Pilot 9: bigger feedback + text"
35,"SUPPRF90079",81,13,22,-54,-15,11,37,76,"Pilot 9","Pilot 9: bigger feedback + text"
36,"SUPPRF90079",95,9,62,-4,-1,20,63,66,"Pilot 9","Pilot 9: bigger feedback + text"
37,"SUPPRF90079",91,8,75,60,29,12,46,15,"Pilot 9","Pilot 9: bigger feedback + text"
38,"SUPPRF90079",92,7,81,13,1,15,80,68,"Pilot 9","Pilot 9: bigger feedback + text"
39,"SUPPRF90079",89,11,54,2,0,14,54,52,"Pilot 9","Pilot 9: bigger feedback + text"
40,"SUPPRF90079",88,14,88,39,25,20,63,49,"Pilot 9","Pilot 9: bigger feedback + text"
41,"SUPPRF90079",89,12,55,4,1,24,54,51,"Pilot 9","Pilot 9: bigger feedback + text"
42,"SUPPRF90079",84,13,77,46,14,74,63,31,"Pilot 9","Pilot 9: bigger feedback + text"
43,"SUPPRF90079",87,10,70,11,-1,22,71,59,"Pilot 9","Pilot 9: bigger feedback + text"
44,"SUPPRF90079",69,17,66,38,12,22,54,28,"Pilot 9","Pilot 9: bigger feedback + text"
45,"SUPPRF90079",85,13,28,-33,-1,16,29,61,"Pilot 9","Pilot 9: bigger feedback + text"
46,"SUPPRF90079",80,19,46,11,0,20,46,35,"Pilot 9","Pilot 9: bigger feedback + text"
47,"SUPPRF90079",81,11,56,7,-15,76,71,49,"Pilot 9","Pilot 9: bigger feedback + text"
48,"SUPPRF90079",84,11,6,-71,-14,24,20,77,"Pilot 9","Pilot 9: bigger feedback + text"
1,"SUPPRF04190",51,38,75,31,29,72,46,44,"Pilot 9","Pilot 9: bigger feedback + text"
2,"SUPPRF04190",73,25,81,-7,1,85,80,88,"Pilot 9","Pilot 9: bigger feedback + text"
3,"SUPPRF04190",40,41,35,25,15,58,20,10,"Pilot 9","Pilot 9: bigger feedback + text"
4,"SUPPRF04190",58,65,96,3,16,75,80,93,"Pilot 9","Pilot 9: bigger feedback + text"
5,"SUPPRF04190",52,37,50,-19,-13,62,63,69,"Pilot 9","Pilot 9: bigger feedback + text"
6,"SUPPRF04190",53,51,70,-6,-1,74,71,76,"Pilot 9","Pilot 9: bigger feedback + text"
7,"SUPPRF04190",53,50,6,-10,-14,54,20,16,"Pilot 9","Pilot 9: bigger feedback + text"
8,"SUPPRF04190",48,50,19,2,-1,63,20,17,"Pilot 9","Pilot 9: bigger feedback + text"
9,"SUPPRF04190",51,50,56,13,-15,10,71,43,"Pilot 9","Pilot 9: bigger feedback + text"
10,"SUPPRF04190",51,49,29,-25,0,39,29,54,"Pilot 9","Pilot 9: bigger feedback + text"
11,"SUPPRF04190",48,48,16,-11,-13,47,29,27,"Pilot 9","Pilot 9: bigger feedback + text"
12,"SUPPRF04190",47,51,24,-8,-13,50,37,32,"Pilot 9","Pilot 9: bigger feedback + text"
13,"SUPPRF04190",50,48,66,24,12,65,54,42,"Pilot 9","Pilot 9: bigger feedback + text"
14,"SUPPRF04190",38,59,71,50,0,45,71,21,"Pilot 9","Pilot 9: bigger feedback + text"
15,"SUPPRF04190",48,50,46,5,17,56,29,41,"Pilot 9","Pilot 9: bigger feedback + text"
16,"SUPPRF04190",47,49,20,-6,0,36,20,26,"Pilot 9","Pilot 9: bigger feedback + text"
17,"SUPPRF04190",52,50,61,20,24,45,37,41,"Pilot 9","Pilot 9: bigger feedback + text"
18,"SUPPRF04190",48,49,83,29,12,54,71,54,"Pilot 9","Pilot 9: bigger feedback + text"
19,"SUPPRF04190",52,52,41,-20,-13,63,54,61,"Pilot 9","Pilot 9: bigger feedback + text"
20,"SUPPRF04190",61,43,100,36,20,26,80,64,"Pilot 9","Pilot 9: bigger feedback + text"
21,"SUPPRF04190",53,52,67,-33,-13,73,80,100,"Pilot 9","Pilot 9: bigger feedback + text"
22,"SUPPRF04190",52,50,88,39,25,13,63,49,"Pilot 9","Pilot 9: bigger feedback + text"
23,"SUPPRF04190",51,50,55,8,-16,64,71,47,"Pilot 9","Pilot 9: bigger feedback + text"
24,"SUPPRF04190",51,51,38,-10,1,51,37,48,"Pilot 9","Pilot 9: bigger feedback + text"
25,"SUPPRF04190",51,51,58,20,29,62,29,38,"Pilot 9","Pilot 9: bigger feedback + text"
26,"SUPPRF04190",54,49,49,0,12,48,37,49,"Pilot 9","Pilot 9: bigger feedback + text"
27,"SUPPRF04190",51,51,8,-30,-12,38,20,38,"Pilot 9","Pilot 9: bigger feedback + text"
28,"SUPPRF04190",50,51,62,21,-1,5,63,41,"Pilot 9","Pilot 9: bigger feedback + text"
29,"SUPPRF04190",48,51,78,37,24,81,54,41,"Pilot 9","Pilot 9: bigger feedback + text"
30,"SUPPRF04190",52,52,46,3,0,48,46,43,"Pilot 9","Pilot 9: bigger feedback + text"
31,"SUPPRF04190",51,50,58,5,12,74,46,53,"Pilot 9","Pilot 9: bigger feedback + text"
32,"SUPPRF04190",50,50,22,-10,-15,21,37,32,"Pilot 9","Pilot 9: bigger feedback + text"
33,"SUPPRF04190",52,51,94,27,23,67,71,67,"Pilot 9","Pilot 9: bigger feedback + text"
34,"SUPPRF04190",48,48,33,-16,-13,49,46,49,"Pilot 9","Pilot 9: bigger feedback + text"
35,"SUPPRF04190",51,48,54,8,0,11,54,46,"Pilot 9","Pilot 9: bigger feedback + text"
36,"SUPPRF04190",46,48,28,-8,-1,9,29,36,"Pilot 9","Pilot 9: bigger feedback + text"
37,"SUPPRF04190",51,48,55,-3,1,10,54,58,"Pilot 9","Pilot 9: bigger feedback + text"
38,"SUPPRF04190",51,51,37,-10,0,21,37,47,"Pilot 9","Pilot 9: bigger feedback + text"
39,"SUPPRF04190",50,51,63,12,0,51,63,51,"Pilot 9","Pilot 9: bigger feedback + text"
40,"SUPPRF04190",50,47,47,12,-16,49,63,35,"Pilot 9","Pilot 9: bigger feedback + text"
41,"SUPPRF04190",53,51,34,-6,-12,65,46,40,"Pilot 9","Pilot 9: bigger feedback + text"
42,"SUPPRF04190",58,57,80,15,0,35,80,65,"Pilot 9","Pilot 9: bigger feedback + text"
43,"SUPPRF04190",49,48,47,4,27,49,20,43,"Pilot 9","Pilot 9: bigger feedback + text"
44,"SUPPRF04190",48,49,77,70,14,20,63,7,"Pilot 9","Pilot 9: bigger feedback + text"
45,"SUPPRF04190",51,52,38,-32,-16,82,54,70,"Pilot 9","Pilot 9: bigger feedback + text"
46,"SUPPRF04190",50,50,68,16,-12,52,80,52,"Pilot 9","Pilot 9: bigger feedback + text"
47,"SUPPRF04190",51,49,45,-20,-1,77,46,65,"Pilot 9","Pilot 9: bigger feedback + text"
48,"SUPPRF04190",50,50,15,-26,-14,48,29,41,"Pilot 9","Pilot 9: bigger feedback + text"
1,"SUPPRF17949",93,5,33,-11,-13,7,46,44,"Pilot 9","Pilot 9: bigger feedback + text"
2,"SUPPRF17949",89,6,16,-19,-13,21,29,35,"Pilot 9","Pilot 9: bigger feedback + text"
3,"SUPPRF17949",89,7,38,10,1,6,37,28,"Pilot 9","Pilot 9: bigger feedback + text"
4,"SUPPRF17949",94,7,49,16,12,14,37,33,"Pilot 9","Pilot 9: bigger feedback + text"
5,"SUPPRF17949",94,6,28,8,-1,30,29,20,"Pilot 9","Pilot 9: bigger feedback + text"
6,"SUPPRF17949",89,10,55,-20,-16,50,71,75,"Pilot 9","Pilot 9: bigger feedback + text"
7,"SUPPRF17949",96,7,55,0,1,20,54,55,"Pilot 9","Pilot 9: bigger feedback + text"
8,"SUPPRF17949",94,4,34,4,-12,15,46,30,"Pilot 9","Pilot 9: bigger feedback + text"
9,"SUPPRF17949",94,5,58,43,29,21,29,15,"Pilot 9","Pilot 9: bigger feedback + text"
10,"SUPPRF17949",94,7,56,-4,-15,29,71,60,"Pilot 9","Pilot 9: bigger feedback + text"
11,"SUPPRF17949",93,6,45,-5,-1,30,46,50,"Pilot 9","Pilot 9: bigger feedback + text"
12,"SUPPRF17949",95,5,77,13,14,28,63,64,"Pilot 9","Pilot 9: bigger feedback + text"
13,"SUPPRF17949",94,9,15,-35,-14,29,29,50,"Pilot 9","Pilot 9: bigger feedback + text"
14,"SUPPRF17949",90,9,29,4,0,19,29,25,"Pilot 9","Pilot 9: bigger feedback + text"
15,"SUPPRF17949",86,9,67,16,-13,17,80,51,"Pilot 9","Pilot 9: bigger feedback + text"
16,"SUPPRF17949",83,12,38,-8,-16,70,54,46,"Pilot 9","Pilot 9: bigger feedback + text"
17,"SUPPRF17949",84,16,71,22,0,82,71,49,"Pilot 9","Pilot 9: bigger feedback + text"
18,"SUPPRF17949",67,22,88,40,25,33,63,48,"Pilot 9","Pilot 9: bigger feedback + text"
19,"SUPPRF17949",72,22,35,-15,15,25,20,50,"Pilot 9","Pilot 9: bigger feedback + text"
20,"SUPPRF17949",65,33,83,26,12,33,71,57,"Pilot 9","Pilot 9: bigger feedback + text"
21,"SUPPRF17949",62,34,63,2,0,25,63,61,"Pilot 9","Pilot 9: bigger feedback + text"
22,"SUPPRF17949",77,38,66,30,12,23,54,36,"Pilot 9","Pilot 9: bigger feedback + text"
23,"SUPPRF17949",60,38,96,48,16,43,80,48,"Pilot 9","Pilot 9: bigger feedback + text"
24,"SUPPRF17949",68,28,81,6,1,64,80,75,"Pilot 9","Pilot 9: bigger feedback + text"
25,"SUPPRF17949",71,34,22,-33,-15,47,37,55,"Pilot 9","Pilot 9: bigger feedback + text"
26,"SUPPRF17949",59,40,8,-7,-12,81,20,15,"Pilot 9","Pilot 9: bigger feedback + text"
27,"SUPPRF17949",53,40,80,57,0,57,80,23,"Pilot 9","Pilot 9: bigger feedback + text"
28,"SUPPRF17949",64,30,54,12,0,34,54,42,"Pilot 9","Pilot 9: bigger feedback + text"
29,"SUPPRF17949",54,47,47,5,-16,49,63,42,"Pilot 9","Pilot 9: bigger feedback + text"
30,"SUPPRF17949",62,44,50,-4,-13,35,63,54,"Pilot 9","Pilot 9: bigger feedback + text"
31,"SUPPRF17949",51,51,61,29,24,16,37,32,"Pilot 9","Pilot 9: bigger feedback + text"
32,"SUPPRF17949",52,46,62,13,-1,17,63,49,"Pilot 9","Pilot 9: bigger feedback + text"
33,"SUPPRF17949",50,50,47,1,27,35,20,46,"Pilot 9","Pilot 9: bigger feedback + text"
34,"SUPPRF17949",56,41,78,31,24,17,54,47,"Pilot 9","Pilot 9: bigger feedback + text"
35,"SUPPRF17949",48,53,100,48,20,34,80,52,"Pilot 9","Pilot 9: bigger feedback + text"
36,"SUPPRF17949",45,51,41,-13,-13,60,54,54,"Pilot 9","Pilot 9: bigger feedback + text"
37,"SUPPRF17949",45,60,20,-18,0,23,20,38,"Pilot 9","Pilot 9: bigger feedback + text"
38,"SUPPRF17949",39,56,24,-8,-13,26,37,32,"Pilot 9","Pilot 9: bigger feedback + text"
39,"SUPPRF17949",44,47,46,-28,0,78,46,74,"Pilot 9","Pilot 9: bigger feedback + text"
40,"SUPPRF17949",82,48,37,2,0,66,37,35,"Pilot 9","Pilot 9: bigger feedback + text"
41,"SUPPRF17949",100,30,94,26,23,69,71,68,"Pilot 9","Pilot 9: bigger feedback + text"
42,"SUPPRF17949",49,30,58,32,12,57,46,26,"Pilot 9","Pilot 9: bigger feedback + text"
43,"SUPPRF17949",51,48,46,-14,17,30,29,60,"Pilot 9","Pilot 9: bigger feedback + text"
44,"SUPPRF17949",33,79,75,40,29,86,46,35,"Pilot 9","Pilot 9: bigger feedback + text"
45,"SUPPRF17949",46,51,70,-8,-1,57,71,78,"Pilot 9","Pilot 9: bigger feedback + text"
46,"SUPPRF17949",52,31,6,-20,-14,7,20,26,"Pilot 9","Pilot 9: bigger feedback + text"
47,"SUPPRF17949",52,50,19,5,-1,94,20,14,"Pilot 9","Pilot 9: bigger feedback + text"
48,"SUPPRF17949",57,49,68,-21,-12,70,80,89,"Pilot 9","Pilot 9: bigger feedback + text"
1,"SUPPRF66080",49,20,29,-5,0,100,29,34,"Pilot 9","Pilot 9: bigger feedback + text"
2,"SUPPRF66080",51,0,80,4,0,81,80,76,"Pilot 9","Pilot 9: bigger feedback + text"
3,"SUPPRF66080",51,0,68,-18,-12,99,80,86,"Pilot 9","Pilot 9: bigger feedback + text"
4,"SUPPRF66080",51,0,62,20,-1,67,63,42,"Pilot 9","Pilot 9: bigger feedback + text"
5,"SUPPRF66080",50,0,63,-1,0,98,63,64,"Pilot 9","Pilot 9: bigger feedback + text"
6,"SUPPRF66080",50,0,38,4,1,100,37,34,"Pilot 9","Pilot 9: bigger feedback + text"
7,"SUPPRF66080",51,0,55,22,1,73,54,33,"Pilot 9","Pilot 9: bigger feedback + text"
8,"SUPPRF66080",51,0,46,25,17,72,29,21,"Pilot 9","Pilot 9: bigger feedback + text"
9,"SUPPRF66080",50,2,61,61,24,52,37,0,"Pilot 9","Pilot 9: bigger feedback + text"
10,"SUPPRF66080",51,0,6,-17,-14,86,20,23,"Pilot 9","Pilot 9: bigger feedback + text"
11,"SUPPRF66080",48,1,54,35,0,68,54,19,"Pilot 9","Pilot 9: bigger feedback + text"
12,"SUPPRF66080",50,0,78,39,24,60,54,39,"Pilot 9","Pilot 9: bigger feedback + text"
13,"SUPPRF66080",52,0,33,1,-13,74,46,32,"Pilot 9","Pilot 9: bigger feedback + text"
14,"SUPPRF66080",51,1,46,16,0,76,46,30,"Pilot 9","Pilot 9: bigger feedback + text"
15,"SUPPRF66080",51,2,58,15,12,72,46,43,"Pilot 9","Pilot 9: bigger feedback + text"
16,"SUPPRF66080",51,1,8,-38,-12,64,20,46,"Pilot 9","Pilot 9: bigger feedback + text"
17,"SUPPRF66080",50,2,24,-9,-13,64,37,33,"Pilot 9","Pilot 9: bigger feedback + text"
18,"SUPPRF66080",51,0,47,18,27,70,20,29,"Pilot 9","Pilot 9: bigger feedback + text"
1,"SUPPRF62253",62,31,54,-1,0,45,54,55,"Pilot 9","Pilot 9: bigger feedback + text"
2,"SUPPRF62253",57,34,61,2,24,60,37,59,"Pilot 9","Pilot 9: bigger feedback + text"
3,"SUPPRF62253",46,54,38,-31,1,54,37,69,"Pilot 9","Pilot 9: bigger feedback + text"
4,"SUPPRF62253",68,28,66,6,12,56,54,60,"Pilot 9","Pilot 9: bigger feedback + text"
5,"SUPPRF62253",57,35,19,-29,-1,60,20,48,"Pilot 9","Pilot 9: bigger feedback + text"
6,"SUPPRF62253",28,56,55,-14,-16,56,71,69,"Pilot 9","Pilot 9: bigger feedback + text"
7,"SUPPRF62253",65,31,45,-16,-1,28,46,61,"Pilot 9","Pilot 9: bigger feedback + text"
8,"SUPPRF62253",31,67,47,-1,27,53,20,48,"Pilot 9","Pilot 9: bigger feedback + text"
9,"SUPPRF62253",67,57,80,17,0,61,80,63,"Pilot 9","Pilot 9: bigger feedback + text"
10,"SUPPRF62253",55,33,49,-11,12,49,37,60,"Pilot 9","Pilot 9: bigger feedback + text"
11,"SUPPRF62253",63,64,83,24,12,52,71,59,"Pilot 9","Pilot 9: bigger feedback + text"
12,"SUPPRF62253",57,36,62,-9,-1,45,63,71,"Pilot 9","Pilot 9: bigger feedback + text"
13,"SUPPRF62253",62,40,41,-13,-13,54,54,54,"Pilot 9","Pilot 9: bigger feedback + text"
14,"SUPPRF62253",62,41,81,9,1,60,80,72,"Pilot 9","Pilot 9: bigger feedback + text"
15,"SUPPRF62253",36,49,16,-49,-13,54,29,65,"Pilot 9","Pilot 9: bigger feedback + text"
16,"SUPPRF62253",70,19,100,44,20,52,80,56,"Pilot 9","Pilot 9: bigger feedback + text"
17,"SUPPRF62253",53,55,28,-32,-1,50,29,60,"Pilot 9","Pilot 9: bigger feedback + text"
18,"SUPPRF62253",58,47,94,29,23,55,71,65,"Pilot 9","Pilot 9: bigger feedback + text"
19,"SUPPRF62253",49,49,8,-51,-12,51,20,59,"Pilot 9","Pilot 9: bigger feedback + text"
20,"SUPPRF62253",60,37,68,9,-12,48,80,59,"Pilot 9","Pilot 9: bigger feedback + text"
21,"SUPPRF62253",52,52,29,-30,0,54,29,59,"Pilot 9","Pilot 9: bigger feedback + text"
22,"SUPPRF62253",49,49,58,-1,12,49,46,59,"Pilot 9","Pilot 9: bigger feedback + text"
23,"SUPPRF62253",48,47,20,-26,0,49,20,46,"Pilot 9","Pilot 9: bigger feedback + text"
24,"SUPPRF62253",45,40,67,14,-13,57,80,53,"Pilot 9","Pilot 9: bigger feedback + text"
25,"SUPPRF62253",51,48,47,-11,-16,57,63,58,"Pilot 9","Pilot 9: bigger feedback + text"
26,"SUPPRF62253",48,48,33,-20,-13,52,46,53,"Pilot 9","Pilot 9: bigger feedback + text"
27,"SUPPRF62253",48,49,6,-54,-14,51,20,60,"Pilot 9","Pilot 9: bigger feedback + text"
28,"SUPPRF62253",53,50,15,-39,-14,51,29,54,"Pilot 9","Pilot 9: bigger feedback + text"
29,"SUPPRF62253",48,49,22,-26,-15,49,37,48,"Pilot 9","Pilot 9: bigger feedback + text"
30,"SUPPRF62253",54,49,58,11,29,52,29,47,"Pilot 9","Pilot 9: bigger feedback + text"
31,"SUPPRF62253",49,52,38,-26,-16,65,54,64,"Pilot 9","Pilot 9: bigger feedback + text"
32,"SUPPRF62253",49,48,37,-13,0,48,37,50,"Pilot 9","Pilot 9: bigger feedback + text"
33,"SUPPRF62253",47,56,63,13,0,48,63,50,"Pilot 9","Pilot 9: bigger feedback + text"
34,"SUPPRF62253",46,50,77,28,14,50,63,49,"Pilot 9","Pilot 9: bigger feedback + text"
35,"SUPPRF62253",58,57,78,28,24,49,54,50,"Pilot 9","Pilot 9: bigger feedback + text"
36,"SUPPRF62253",52,53,75,25,29,51,46,50,"Pilot 9","Pilot 9: bigger feedback + text"
37,"SUPPRF62253",79,30,96,44,16,51,80,52,"Pilot 9","Pilot 9: bigger feedback + text"
38,"SUPPRF62253",51,50,24,-23,-13,44,37,47,"Pilot 9","Pilot 9: bigger feedback + text"
39,"SUPPRF62253",51,48,56,6,-15,49,71,50,"Pilot 9","Pilot 9: bigger feedback + text"
40,"SUPPRF62253",49,50,34,-17,-12,51,46,51,"Pilot 9","Pilot 9: bigger feedback + text"
41,"SUPPRF62253",59,58,71,21,0,52,71,50,"Pilot 9","Pilot 9: bigger feedback + text"
42,"SUPPRF62253",50,55,50,-3,-13,50,63,53,"Pilot 9","Pilot 9: bigger feedback + text"
43,"SUPPRF62253",50,52,35,-16,15,51,20,51,"Pilot 9","Pilot 9: bigger feedback + text"
44,"SUPPRF62253",57,53,46,-9,17,57,29,55,"Pilot 9","Pilot 9: bigger feedback + text"
45,"SUPPRF62253",56,60,55,-13,1,55,54,68,"Pilot 9","Pilot 9: bigger feedback + text"
46,"SUPPRF62253",53,50,46,-6,0,53,46,52,"Pilot 9","Pilot 9: bigger feedback + text"
47,"SUPPRF62253",51,60,70,19,-1,49,71,51,"Pilot 9","Pilot 9: bigger feedback + text"
48,"SUPPRF62253",56,56,88,39,25,49,63,49,"Pilot 9","Pilot 9: bigger feedback + text"
1,"SUPPRF61804",41,58,24,-15,-13,39,37,39,"Pilot 9","Pilot 9: bigger feedback + text"
2,"SUPPRF61804",21,59,20,-27,0,51,20,47,"Pilot 9","Pilot 9: bigger feedback + text"
3,"SUPPRF61804",54,39,61,32,24,45,37,29,"Pilot 9","Pilot 9: bigger feedback + text"
4,"SUPPRF61804",74,38,58,20,12,43,46,38,"Pilot 9","Pilot 9: bigger feedback + text"
5,"SUPPRF61804",80,20,70,49,-1,47,71,21,"Pilot 9","Pilot 9: bigger feedback + text"
6,"SUPPRF61804",80,35,81,14,1,69,80,67,"Pilot 9","Pilot 9: bigger feedback + text"
7,"SUPPRF61804",0,67,6,-21,-14,60,20,27,"Pilot 9","Pilot 9: bigger feedback + text"
8,"SUPPRF61804",83,32,67,2,-13,65,80,65,"Pilot 9","Pilot 9: bigger feedback + text"
9,"SUPPRF61804",76,30,96,29,16,73,80,67,"Pilot 9","Pilot 9: bigger feedback + text"
10,"SUPPRF61804",75,20,68,6,-12,72,80,62,"Pilot 9","Pilot 9: bigger feedback + text"
11,"SUPPRF61804",36,66,41,-28,-13,34,54,69,"Pilot 9","Pilot 9: bigger feedback + text"
12,"SUPPRF61804",0,49,16,-40,-13,44,29,56,"Pilot 9","Pilot 9: bigger feedback + text"
13,"SUPPRF61804",67,50,47,23,27,63,20,24,"Pilot 9","Pilot 9: bigger feedback + text"
14,"SUPPRF61804",0,64,19,-43,-1,45,20,62,"Pilot 9","Pilot 9: bigger feedback + text"
15,"SUPPRF61804",61,21,63,2,0,75,63,61,"Pilot 9","Pilot 9: bigger feedback + text"
16,"SUPPRF61804",35,38,15,-9,-14,73,29,24,"Pilot 9","Pilot 9: bigger feedback + text"
17,"SUPPRF61804",64,13,45,-1,-1,51,46,46,"Pilot 9","Pilot 9: bigger feedback + text"
18,"SUPPRF61804",79,22,47,0,-16,57,63,47,"Pilot 9","Pilot 9: bigger feedback + text"
19,"SUPPRF61804",83,18,88,27,25,67,63,61,"Pilot 9","Pilot 9: bigger feedback + text"
20,"SUPPRF61804",85,13,100,32,20,65,80,68,"Pilot 9","Pilot 9: bigger feedback + text"
21,"SUPPRF61804",55,39,29,6,0,68,29,23,"Pilot 9","Pilot 9: bigger feedback + text"
22,"SUPPRF61804",81,38,71,24,0,53,71,47,"Pilot 9","Pilot 9: bigger feedback + text"
23,"SUPPRF61804",60,10,46,-9,17,37,29,55,"Pilot 9","Pilot 9: bigger feedback + text"
24,"SUPPRF61804",66,30,66,16,12,55,54,50,"Pilot 9","Pilot 9: bigger feedback + text"
25,"SUPPRF61804",36,21,49,-7,12,68,37,56,"Pilot 9","Pilot 9: bigger feedback + text"
26,"SUPPRF61804",30,34,55,-8,1,79,54,63,"Pilot 9","Pilot 9: bigger feedback + text"
27,"SUPPRF61804",24,45,37,5,0,44,37,32,"Pilot 9","Pilot 9: bigger feedback + text"
28,"SUPPRF61804",76,29,78,28,24,51,54,50,"Pilot 9","Pilot 9: bigger feedback + text"
29,"SUPPRF61804",0,34,8,-8,-12,61,20,16,"Pilot 9","Pilot 9: bigger feedback + text"
30,"SUPPRF61804",72,18,58,4,29,28,29,54,"Pilot 9","Pilot 9: bigger feedback + text"
31,"SUPPRF61804",86,17,77,31,14,49,63,46,"Pilot 9","Pilot 9: bigger feedback + text"
32,"SUPPRF61804",47,21,35,26,15,78,20,9,"Pilot 9","Pilot 9: bigger feedback + text"
33,"SUPPRF61804",68,8,56,2,-15,11,71,54,"Pilot 9","Pilot 9: bigger feedback + text"
34,"SUPPRF61804",79,4,54,5,0,62,54,49,"Pilot 9","Pilot 9: bigger feedback + text"
35,"SUPPRF61804",75,35,94,33,23,49,71,61,"Pilot 9","Pilot 9: bigger feedback + text"
36,"SUPPRF61804",21,76,22,-28,-15,49,37,50,"Pilot 9","Pilot 9: bigger feedback + text"
37,"SUPPRF61804",61,28,50,7,-13,15,63,43,"Pilot 9","Pilot 9: bigger feedback + text"
38,"SUPPRF61804",30,46,38,-21,-16,65,54,59,"Pilot 9","Pilot 9: bigger feedback + text"
39,"SUPPRF61804",33,51,28,12,-1,66,29,16,"Pilot 9","Pilot 9: bigger feedback + text"
40,"SUPPRF61804",86,18,83,31,12,42,71,52,"Pilot 9","Pilot 9: bigger feedback + text"
41,"SUPPRF61804",49,18,62,10,-1,34,63,52,"Pilot 9","Pilot 9: bigger feedback + text"
42,"SUPPRF61804",81,29,80,8,0,79,80,72,"Pilot 9","Pilot 9: bigger feedback + text"
43,"SUPPRF61804",61,37,46,-7,0,53,46,53,"Pilot 9","Pilot 9: bigger feedback + text"
44,"SUPPRF61804",71,43,38,-24,1,67,37,62,"Pilot 9","Pilot 9: bigger feedback + text"
45,"SUPPRF61804",75,26,75,36,29,59,46,39,"Pilot 9","Pilot 9: bigger feedback + text"
46,"SUPPRF61804",23,77,33,-32,-13,71,46,65,"Pilot 9","Pilot 9: bigger feedback + text"
47,"SUPPRF61804",50,46,55,-5,-16,62,71,60,"Pilot 9","Pilot 9: bigger feedback + text"
48,"SUPPRF61804",22,56,34,-12,-12,67,46,46,"Pilot 9","Pilot 9: bigger feedback + text"
1,"SUPPRF67813",99,0,24,-9,-13,86,37,33,"Pilot 9","Pilot 9: bigger feedback + text"
2,"SUPPRF67813",99,0,80,-3,0,97,80,83,"Pilot 9","Pilot 9: bigger feedback + text"
3,"SUPPRF67813",100,0,46,16,17,100,29,30,"Pilot 9","Pilot 9: bigger feedback + text"
4,"SUPPRF67813",100,0,70,-5,-1,100,71,75,"Pilot 9","Pilot 9: bigger feedback + text"
5,"SUPPRF67813",100,0,38,-20,-16,100,54,58,"Pilot 9","Pilot 9: bigger feedback + text"
6,"SUPPRF67813",100,0,29,0,0,100,29,29,"Pilot 9","Pilot 9: bigger feedback + text"
7,"SUPPRF67813",100,0,61,26,24,100,37,35,"Pilot 9","Pilot 9: bigger feedback + text"
8,"SUPPRF67813",49,49,19,-4,-1,68,20,23,"Pilot 9","Pilot 9: bigger feedback + text"
9,"SUPPRF67813",50,49,55,-18,-16,50,71,73,"Pilot 9","Pilot 9: bigger feedback + text"
10,"SUPPRF67813",48,50,94,23,23,50,71,71,"Pilot 9","Pilot 9: bigger feedback + text"
11,"SUPPRF67813",50,49,81,0,1,48,80,81,"Pilot 9","Pilot 9: bigger feedback + text"
12,"SUPPRF67813",50,50,83,10,12,48,71,73,"Pilot 9","Pilot 9: bigger feedback + text"
13,"SUPPRF67813",49,49,47,20,27,49,20,27,"Pilot 9","Pilot 9: bigger feedback + text"
14,"SUPPRF67813",49,50,63,11,0,49,63,52,"Pilot 9","Pilot 9: bigger feedback + text"
15,"SUPPRF67813",50,50,88,38,25,49,63,50,"Pilot 9","Pilot 9: bigger feedback + text"
16,"SUPPRF67813",50,49,20,-30,0,48,20,50,"Pilot 9","Pilot 9: bigger feedback + text"
17,"SUPPRF67813",49,48,75,22,29,50,46,53,"Pilot 9","Pilot 9: bigger feedback + text"
18,"SUPPRF67813",49,49,66,15,12,48,54,51,"Pilot 9","Pilot 9: bigger feedback + text"
19,"SUPPRF67813",50,50,62,12,-1,50,63,50,"Pilot 9","Pilot 9: bigger feedback + text"
20,"SUPPRF67813",49,47,45,-5,-1,51,46,50,"Pilot 9","Pilot 9: bigger feedback + text"
21,"SUPPRF67813",51,50,37,-15,0,50,37,52,"Pilot 9","Pilot 9: bigger feedback + text"
22,"SUPPRF67813",52,52,68,18,-12,47,80,50,"Pilot 9","Pilot 9: bigger feedback + text"
23,"SUPPRF67813",49,50,6,-44,-14,51,20,50,"Pilot 9","Pilot 9: bigger feedback + text"
24,"SUPPRF67813",49,50,38,-12,1,50,37,50,"Pilot 9","Pilot 9: bigger feedback + text"
25,"SUPPRF67813",49,51,54,4,0,49,54,50,"Pilot 9","Pilot 9: bigger feedback + text"
26,"SUPPRF67813",52,50,58,9,12,48,46,49,"Pilot 9","Pilot 9: bigger feedback + text"
27,"SUPPRF67813",48,48,46,-4,0,50,46,50,"Pilot 9","Pilot 9: bigger feedback + text"
28,"SUPPRF67813",49,51,56,4,-15,51,71,52,"Pilot 9","Pilot 9: bigger feedback + text"
29,"SUPPRF67813",47,49,22,-28,-15,50,37,50,"Pilot 9","Pilot 9: bigger feedback + text"
30,"SUPPRF67813",49,49,35,-13,15,49,20,48,"Pilot 9","Pilot 9: bigger feedback + text"
31,"SUPPRF67813",51,49,96,46,16,50,80,50,"Pilot 9","Pilot 9: bigger feedback + text"
32,"SUPPRF67813",48,51,34,-11,-12,50,46,45,"Pilot 9","Pilot 9: bigger feedback + text"
33,"SUPPRF67813",51,50,50,0,-13,52,63,50,"Pilot 9","Pilot 9: bigger feedback + text"
34,"SUPPRF67813",48,49,8,-41,-12,50,20,49,"Pilot 9","Pilot 9: bigger feedback + text"
35,"SUPPRF67813",50,49,58,9,29,49,29,49,"Pilot 9","Pilot 9: bigger feedback + text"
36,"SUPPRF67813",50,49,78,29,24,51,54,49,"Pilot 9","Pilot 9: bigger feedback + text"
37,"SUPPRF67813",53,54,67,20,-13,55,80,47,"Pilot 9","Pilot 9: bigger feedback + text"
38,"SUPPRF67813",51,50,47,-6,-16,50,63,53,"Pilot 9","Pilot 9: bigger feedback + text"
39,"SUPPRF67813",49,50,15,-40,-14,50,29,55,"Pilot 9","Pilot 9: bigger feedback + text"
40,"SUPPRF67813",51,47,55,4,1,50,54,51,"Pilot 9","Pilot 9: bigger feedback + text"
41,"SUPPRF67813",49,51,33,-17,-13,51,46,50,"Pilot 9","Pilot 9: bigger feedback + text"
42,"SUPPRF67813",49,49,100,51,20,50,80,49,"Pilot 9","Pilot 9: bigger feedback + text"
43,"SUPPRF67813",51,50,16,-35,-13,50,29,51,"Pilot 9","Pilot 9: bigger feedback + text"
44,"SUPPRF67813",51,50,71,20,0,50,71,51,"Pilot 9","Pilot 9: bigger feedback + text"
45,"SUPPRF67813",49,48,49,-1,12,49,37,50,"Pilot 9","Pilot 9: bigger feedback + text"
46,"SUPPRF67813",48,49,28,-22,-1,49,29,50,"Pilot 9","Pilot 9: bigger feedback + text"
47,"SUPPRF67813",50,50,77,26,14,50,63,51,"Pilot 9","Pilot 9: bigger feedback + text"
48,"SUPPRF67813",49,50,41,-10,-13,51,54,51,"Pilot 9","Pilot 9: bigger feedback + text"
1,"SUPPRF87016",21,92,19,-2,-1,78,20,21,"Pilot 9","Pilot 9: bigger feedback + text"
2,"SUPPRF87016",68,75,61,18,24,76,37,43,"Pilot 9","Pilot 9: bigger feedback + text"
3,"SUPPRF87016",22,66,56,-14,-15,72,71,70,"Pilot 9","Pilot 9: bigger feedback + text"
4,"SUPPRF87016",25,68,22,-18,-15,68,37,40,"Pilot 9","Pilot 9: bigger feedback + text"
5,"SUPPRF87016",88,70,88,38,25,34,63,50,"Pilot 9","Pilot 9: bigger feedback + text"
6,"SUPPRF87016",56,63,28,3,-1,50,29,25,"Pilot 9","Pilot 9: bigger feedback + text"
7,"SUPPRF87016",89,35,58,34,29,67,29,24,"Pilot 9","Pilot 9: bigger feedback + text"
8,"SUPPRF87016",94,22,96,26,16,63,80,70,"Pilot 9","Pilot 9: bigger feedback + text"
9,"SUPPRF87016",81,27,83,21,12,75,71,62,"Pilot 9","Pilot 9: bigger feedback + text"
10,"SUPPRF87016",82,32,100,30,20,67,80,70,"Pilot 9","Pilot 9: bigger feedback + text"
11,"SUPPRF87016",89,26,34,9,-12,76,46,25,"Pilot 9","Pilot 9: bigger feedback + text"
12,"SUPPRF87016",70,15,54,-6,0,64,54,60,"Pilot 9","Pilot 9: bigger feedback + text"
13,"SUPPRF87016",78,22,29,5,0,67,29,24,"Pilot 9","Pilot 9: bigger feedback + text"
14,"SUPPRF87016",78,19,66,0,12,78,54,66,"Pilot 9","Pilot 9: bigger feedback + text"
15,"SUPPRF87016",82,13,38,0,1,75,37,38,"Pilot 9","Pilot 9: bigger feedback + text"
16,"SUPPRF87016",71,16,55,-7,1,77,54,62,"Pilot 9","Pilot 9: bigger feedback + text"
17,"SUPPRF87016",84,18,70,-2,-1,76,71,72,"Pilot 9","Pilot 9: bigger feedback + text"
18,"SUPPRF87016",75,13,71,2,0,67,71,69,"Pilot 9","Pilot 9: bigger feedback + text"
19,"SUPPRF87016",82,18,68,30,-12,39,80,38,"Pilot 9","Pilot 9: bigger feedback + text"
20,"SUPPRF87016",73,18,67,0,-13,69,80,67,"Pilot 9","Pilot 9: bigger feedback + text"
21,"SUPPRF87016",81,19,58,16,12,81,46,42,"Pilot 9","Pilot 9: bigger feedback + text"
22,"SUPPRF87016",71,20,35,5,15,74,20,30,"Pilot 9","Pilot 9: bigger feedback + text"
23,"SUPPRF87016",77,23,50,9,-13,75,63,41,"Pilot 9","Pilot 9: bigger feedback + text"
24,"SUPPRF87016",86,17,75,48,29,71,46,27,"Pilot 9","Pilot 9: bigger feedback + text"
25,"SUPPRF87016",85,14,80,-2,0,81,80,82,"Pilot 9","Pilot 9: bigger feedback + text"
26,"SUPPRF87016",71,21,45,2,-1,86,46,43,"Pilot 9","Pilot 9: bigger feedback + text"
27,"SUPPRF87016",83,24,94,19,23,81,71,75,"Pilot 9","Pilot 9: bigger feedback + text"
28,"SUPPRF87016",67,23,38,-37,-16,76,54,75,"Pilot 9","Pilot 9: bigger feedback + text"
29,"SUPPRF87016",79,21,62,25,-1,73,63,37,"Pilot 9","Pilot 9: bigger feedback + text"
30,"SUPPRF87016",80,27,46,16,17,76,29,30,"Pilot 9","Pilot 9: bigger feedback + text"
31,"SUPPRF87016",56,24,8,-23,-12,75,20,31,"Pilot 9","Pilot 9: bigger feedback + text"
32,"SUPPRF87016",59,35,15,-1,-14,79,29,16,"Pilot 9","Pilot 9: bigger feedback + text"
33,"SUPPRF87016",69,28,20,-2,0,79,20,22,"Pilot 9","Pilot 9: bigger feedback + text"
34,"SUPPRF87016",78,26,46,8,0,67,46,38,"Pilot 9","Pilot 9: bigger feedback + text"
35,"SUPPRF87016",61,27,77,13,14,72,63,64,"Pilot 9","Pilot 9: bigger feedback + text"
36,"SUPPRF87016",64,36,47,-5,-16,36,63,52,"Pilot 9","Pilot 9: bigger feedback + text"
37,"SUPPRF87016",65,31,33,-16,-13,30,46,49,"Pilot 9","Pilot 9: bigger feedback + text"
38,"SUPPRF87016",61,36,81,3,1,76,80,78,"Pilot 9","Pilot 9: bigger feedback + text"
39,"SUPPRF87016",61,33,63,-4,0,71,63,67,"Pilot 9","Pilot 9: bigger feedback + text"
40,"SUPPRF87016",53,42,16,-16,-13,58,29,32,"Pilot 9","Pilot 9: bigger feedback + text"
41,"SUPPRF87016",46,42,37,-21,0,38,37,58,"Pilot 9","Pilot 9: bigger feedback + text"
42,"SUPPRF87016",55,42,24,-3,-13,68,37,27,"Pilot 9","Pilot 9: bigger feedback + text"
43,"SUPPRF87016",55,43,78,33,24,65,54,45,"Pilot 9","Pilot 9: bigger feedback + text"
44,"SUPPRF87016",58,46,41,-31,-13,72,54,72,"Pilot 9","Pilot 9: bigger feedback + text"
45,"SUPPRF87016",44,38,47,25,27,38,20,22,"Pilot 9","Pilot 9: bigger feedback + text"
46,"SUPPRF87016",42,53,49,9,12,39,37,40,"Pilot 9","Pilot 9: bigger feedback + text"
47,"SUPPRF87016",45,53,6,-23,-14,36,20,29,"Pilot 9","Pilot 9: bigger feedback + text"
48,"SUPPRF87016",50,55,55,-22,-16,80,71,77,"Pilot 9","Pilot 9: bigger feedback + text"
1,"SUPPRF93511",71,31,55,-2,-16,65,71,57,"Pilot 9","Pilot 9: bigger feedback + text"
2,"SUPPRF93511",72,25,56,-7,-15,72,71,63,"Pilot 9","Pilot 9: bigger feedback + text"
3,"SUPPRF93511",2,11,8,-58,-12,69,20,66,"Pilot 9","Pilot 9: bigger feedback + text"
4,"SUPPRF93511",32,27,22,-21,-15,43,37,43,"Pilot 9","Pilot 9: bigger feedback + text"
5,"SUPPRF93511",66,24,66,15,12,52,54,51,"Pilot 9","Pilot 9: bigger feedback + text"
6,"SUPPRF93511",62,14,58,41,29,61,29,17,"Pilot 9","Pilot 9: bigger feedback + text"
7,"SUPPRF93511",72,21,88,37,25,68,63,51,"Pilot 9","Pilot 9: bigger feedback + text"
8,"SUPPRF93511",86,29,75,7,29,75,46,68,"Pilot 9","Pilot 9: bigger feedback + text"
9,"SUPPRF93511",74,20,46,-26,0,65,46,72,"Pilot 9","Pilot 9: bigger feedback + text"
10,"SUPPRF93511",70,17,68,-6,-12,33,80,74,"Pilot 9","Pilot 9: bigger feedback + text"
11,"SUPPRF93511",19,74,70,-14,-1,42,71,84,"Pilot 9","Pilot 9: bigger feedback + text"
12,"SUPPRF93511",39,8,29,-32,0,30,29,61,"Pilot 9","Pilot 9: bigger feedback + text"
13,"SUPPRF93511",78,13,58,10,12,19,46,48,"Pilot 9","Pilot 9: bigger feedback + text"
14,"SUPPRF93511",64,16,83,6,12,29,71,77,"Pilot 9","Pilot 9: bigger feedback + text"
15,"SUPPRF93511",0,0,28,-54,-1,70,29,82,"Pilot 9","Pilot 9: bigger feedback + text"
16,"SUPPRF93511",0,0,45,-43,-1,23,46,88,"Pilot 9","Pilot 9: bigger feedback + text"
17,"SUPPRF93511",75,11,6,-36,-14,16,20,42,"Pilot 9","Pilot 9: bigger feedback + text"
18,"SUPPRF93511",71,6,49,-14,12,7,37,63,"Pilot 9","Pilot 9: bigger feedback + text"
19,"SUPPRF93511",71,1,67,15,-13,16,80,52,"Pilot 9","Pilot 9: bigger feedback + text"
20,"SUPPRF93511",68,4,38,-12,1,10,37,50,"Pilot 9","Pilot 9: bigger feedback + text"
21,"SUPPRF93511",70,2,38,-35,-16,11,54,73,"Pilot 9","Pilot 9: bigger feedback + text"
22,"SUPPRF93511",74,0,62,-11,-1,0,63,73,"Pilot 9","Pilot 9: bigger feedback + text"
23,"SUPPRF93511",73,0,47,-19,-16,12,63,66,"Pilot 9","Pilot 9: bigger feedback + text"
24,"SUPPRF93511",73,0,37,-20,0,9,37,57,"Pilot 9","Pilot 9: bigger feedback + text"
25,"SUPPRF93511",50,0,94,47,23,15,71,47,"Pilot 9","Pilot 9: bigger feedback + text"
26,"SUPPRF93511",50,1,78,18,24,4,54,60,"Pilot 9","Pilot 9: bigger feedback + text"
27,"SUPPRF93511",50,0,61,7,24,0,37,54,"Pilot 9","Pilot 9: bigger feedback + text"
28,"SUPPRF93511",51,16,50,-7,-13,0,63,57,"Pilot 9","Pilot 9: bigger feedback + text"
29,"SUPPRF93511",51,18,77,7,14,8,63,70,"Pilot 9","Pilot 9: bigger feedback + text"
30,"SUPPRF93511",51,12,41,-20,-13,5,54,61,"Pilot 9","Pilot 9: bigger feedback + text"
31,"SUPPRF93511",51,13,35,-2,15,5,20,37,"Pilot 9","Pilot 9: bigger feedback + text"
32,"SUPPRF93511",50,15,71,18,0,17,71,53,"Pilot 9","Pilot 9: bigger feedback + text"
33,"SUPPRF93511",36,28,34,-17,-12,10,46,51,"Pilot 9","Pilot 9: bigger feedback + text"
34,"SUPPRF93511",38,25,20,-36,0,17,20,56,"Pilot 9","Pilot 9: bigger feedback + text"
35,"SUPPRF93511",39,35,81,31,1,14,80,50,"Pilot 9","Pilot 9: bigger feedback + text"
36,"SUPPRF93511",38,35,24,-40,-13,18,37,64,"Pilot 9","Pilot 9: bigger feedback + text"
37,"SUPPRF93511",35,35,15,-47,-14,21,29,62,"Pilot 9","Pilot 9: bigger feedback + text"
38,"SUPPRF93511",17,30,46,21,17,0,29,25,"Pilot 9","Pilot 9: bigger feedback + text"
39,"SUPPRF93511",14,26,55,0,1,0,54,55,"Pilot 9","Pilot 9: bigger feedback + text"
40,"SUPPRF93511",16,22,80,30,0,0,80,50,"Pilot 9","Pilot 9: bigger feedback + text"
41,"SUPPRF93511",16,31,33,-4,-13,0,46,37,"Pilot 9","Pilot 9: bigger feedback + text"
42,"SUPPRF93511",22,16,19,-40,-1,0,20,59,"Pilot 9","Pilot 9: bigger feedback + text"
43,"SUPPRF93511",10,51,16,-39,-13,6,29,55,"Pilot 9","Pilot 9: bigger feedback + text"
44,"SUPPRF93511",23,15,47,-8,27,0,20,55,"Pilot 9","Pilot 9: bigger feedback + text"
45,"SUPPRF93511",7,43,100,56,20,4,80,44,"Pilot 9","Pilot 9: bigger feedback + text"
46,"SUPPRF93511",11,40,54,-8,0,6,54,62,"Pilot 9","Pilot 9: bigger feedback + text"
47,"SUPPRF93511",13,19,96,47,16,7,80,49,"Pilot 9","Pilot 9: bigger feedback + text"
48,"SUPPRF93511",10,29,63,20,0,3,63,43,"Pilot 9","Pilot 9: bigger feedback + text"
1,"SUPPRF45424",76,20,8,-16,-12,83,20,24,"Pilot 10","Pilot 10: bigger feedback + video"
2,"SUPPRF45424",83,14,70,-14,-1,89,71,84,"Pilot 10","Pilot 10: bigger feedback + video"
3,"SUPPRF45424",86,15,19,-4,-1,89,20,23,"Pilot 10","Pilot 10: bigger feedback + video"
4,"SUPPRF45424",90,6,58,16,12,85,46,42,"Pilot 10","Pilot 10: bigger feedback + video"
5,"SUPPRF45424",87,16,47,24,27,88,20,23,"Pilot 10","Pilot 10: bigger feedback + video"
6,"SUPPRF45424",80,11,62,-15,-1,71,63,77,"Pilot 10","Pilot 10: bigger feedback + video"
7,"SUPPRF45424",87,8,71,-10,0,69,71,81,"Pilot 10","Pilot 10: bigger feedback + video"
8,"SUPPRF45424",90,7,20,4,0,91,20,16,"Pilot 10","Pilot 10: bigger feedback + video"
9,"SUPPRF45424",38,6,16,-19,-13,85,29,35,"Pilot 10","Pilot 10: bigger feedback + video"
10,"SUPPRF45424",74,18,46,14,17,28,29,32,"Pilot 10","Pilot 10: bigger feedback + video"
11,"SUPPRF45424",81,11,88,12,25,86,63,76,"Pilot 10","Pilot 10: bigger feedback + video"
12,"SUPPRF45424",75,18,34,-43,-12,68,46,77,"Pilot 10","Pilot 10: bigger feedback + video"
13,"SUPPRF45424",79,16,56,-28,-15,16,71,84,"Pilot 10","Pilot 10: bigger feedback + video"
14,"SUPPRF45424",41,30,75,33,29,84,46,42,"Pilot 10","Pilot 10: bigger feedback + video"
15,"SUPPRF45424",82,15,55,-25,-16,76,71,80,"Pilot 10","Pilot 10: bigger feedback + video"
16,"SUPPRF45424",73,17,63,10,0,64,63,53,"Pilot 10","Pilot 10: bigger feedback + video"
17,"SUPPRF45424",85,9,38,-2,-16,69,54,40,"Pilot 10","Pilot 10: bigger feedback + video"
18,"SUPPRF45424",72,26,66,23,12,62,54,43,"Pilot 10","Pilot 10: bigger feedback + video"
19,"SUPPRF45424",69,27,83,-2,12,41,71,85,"Pilot 10","Pilot 10: bigger feedback + video"
20,"SUPPRF45424",77,16,100,9,20,62,80,91,"Pilot 10","Pilot 10: bigger feedback + video"
21,"SUPPRF45424",75,18,58,39,29,56,29,19,"Pilot 10","Pilot 10: bigger feedback + video"
22,"SUPPRF45424",89,8,80,-10,0,79,80,90,"Pilot 10","Pilot 10: bigger feedback + video"
23,"SUPPRF45424",77,15,45,-40,-1,16,46,85,"Pilot 10","Pilot 10: bigger feedback + video"
24,"SUPPRF45424",89,10,38,-1,1,77,37,39,"Pilot 10","Pilot 10: bigger feedback + video"
25,"SUPPRF45424",75,27,41,0,-13,67,54,41,"Pilot 10","Pilot 10: bigger feedback + video"
26,"SUPPRF45424",73,24,68,36,-12,70,80,32,"Pilot 10","Pilot 10: bigger feedback + video"
27,"SUPPRF45424",82,14,81,-7,1,82,80,88,"Pilot 10","Pilot 10: bigger feedback + video"
28,"SUPPRF45424",77,20,24,7,-13,79,37,17,"Pilot 10","Pilot 10: bigger feedback + video"
29,"SUPPRF45424",73,17,15,-26,-14,73,29,41,"Pilot 10","Pilot 10: bigger feedback + video"
30,"SUPPRF45424",61,26,55,16,1,56,54,39,"Pilot 10","Pilot 10: bigger feedback + video"
31,"SUPPRF45424",80,22,46,10,0,68,46,36,"Pilot 10","Pilot 10: bigger feedback + video"
32,"SUPPRF45424",68,17,96,15,16,81,80,81,"Pilot 10","Pilot 10: bigger feedback + video"
33,"SUPPRF45424",76,28,37,-9,0,60,37,46,"Pilot 10","Pilot 10: bigger feedback + video"
34,"SUPPRF45424",70,32,54,22,0,50,54,32,"Pilot 10","Pilot 10: bigger feedback + video"
35,"SUPPRF45424",77,21,47,-7,-16,73,63,54,"Pilot 10","Pilot 10: bigger feedback + video"
36,"SUPPRF45424",81,18,49,9,12,78,37,40,"Pilot 10","Pilot 10: bigger feedback + video"
37,"SUPPRF45424",78,23,78,29,24,80,54,49,"Pilot 10","Pilot 10: bigger feedback + video"
38,"SUPPRF45424",69,32,50,-21,-13,77,63,71,"Pilot 10","Pilot 10: bigger feedback + video"
39,"SUPPRF45424",82,13,67,-12,-13,83,80,79,"Pilot 10","Pilot 10: bigger feedback + video"
40,"SUPPRF45424",27,25,29,-48,0,84,29,77,"Pilot 10","Pilot 10: bigger feedback + video"
41,"SUPPRF45424",77,23,22,-22,-15,45,37,44,"Pilot 10","Pilot 10: bigger feedback + video"
42,"SUPPRF45424",87,17,77,16,14,48,63,61,"Pilot 10","Pilot 10: bigger feedback + video"
43,"SUPPRF45424",74,29,35,-28,15,39,20,63,"Pilot 10","Pilot 10: bigger feedback + video"
44,"SUPPRF45424",91,11,6,-4,-14,76,20,10,"Pilot 10","Pilot 10: bigger feedback + video"
45,"SUPPRF45424",86,12,28,-6,-1,93,29,34,"Pilot 10","Pilot 10: bigger feedback + video"
46,"SUPPRF45424",74,28,61,22,24,80,37,39,"Pilot 10","Pilot 10: bigger feedback + video"
47,"SUPPRF45424",80,8,94,11,23,86,71,83,"Pilot 10","Pilot 10: bigger feedback + video"
48,"SUPPRF45424",67,17,33,-23,-13,43,46,56,"Pilot 10","Pilot 10: bigger feedback + video"
1,"SUPPRF89348",60,39,55,-6,-16,76,71,61,"Pilot 10","Pilot 10: bigger feedback + video"
2,"SUPPRF89348",27,14,47,-35,27,80,20,82,"Pilot 10","Pilot 10: bigger feedback + video"
3,"SUPPRF89348",16,26,29,-3,0,62,29,32,"Pilot 10","Pilot 10: bigger feedback + video"
4,"SUPPRF89348",34,23,94,54,23,19,71,40,"Pilot 10","Pilot 10: bigger feedback + video"
5,"SUPPRF89348",47,16,78,-12,24,7,54,90,"Pilot 10","Pilot 10: bigger feedback + video"
6,"SUPPRF89348",49,11,50,-40,-13,2,63,90,"Pilot 10","Pilot 10: bigger feedback + video"
7,"SUPPRF89348",57,21,70,-8,-1,3,71,78,"Pilot 10","Pilot 10: bigger feedback + video"
8,"SUPPRF89348",43,13,67,22,-13,1,80,45,"Pilot 10","Pilot 10: bigger feedback + video"
9,"SUPPRF89348",42,26,55,-35,1,4,54,90,"Pilot 10","Pilot 10: bigger feedback + video"
10,"SUPPRF89348",33,18,37,-50,0,1,37,87,"Pilot 10","Pilot 10: bigger feedback + video"
11,"SUPPRF89348",14,19,38,-37,1,13,37,75,"Pilot 10","Pilot 10: bigger feedback + video"
12,"SUPPRF89348",34,11,34,-30,-12,5,46,64,"Pilot 10","Pilot 10: bigger feedback + video"
13,"SUPPRF89348",39,41,62,18,-1,9,63,44,"Pilot 10","Pilot 10: bigger feedback + video"
14,"SUPPRF89348",26,9,20,-28,0,5,20,48,"Pilot 10","Pilot 10: bigger feedback + video"
15,"SUPPRF89348",54,22,81,64,1,4,80,17,"Pilot 10","Pilot 10: bigger feedback + video"
16,"SUPPRF89348",28,13,22,-21,-15,7,37,43,"Pilot 10","Pilot 10: bigger feedback + video"
17,"SUPPRF89348",46,8,58,6,12,1,46,52,"Pilot 10","Pilot 10: bigger feedback + video"
18,"SUPPRF89348",66,30,88,27,25,2,63,61,"Pilot 10","Pilot 10: bigger feedback + video"
19,"SUPPRF89348",6,10,6,-41,-14,11,20,47,"Pilot 10","Pilot 10: bigger feedback + video"
20,"SUPPRF89348",48,8,66,-12,12,3,54,78,"Pilot 10","Pilot 10: bigger feedback + video"
21,"SUPPRF89348",45,16,46,-32,0,6,46,78,"Pilot 10","Pilot 10: bigger feedback + video"
22,"SUPPRF89348",54,18,83,51,12,9,71,32,"Pilot 10","Pilot 10: bigger feedback + video"
23,"SUPPRF89348",39,12,15,-1,-14,15,29,16,"Pilot 10","Pilot 10: bigger feedback + video"
24,"SUPPRF89348",48,13,75,68,29,5,46,7,"Pilot 10","Pilot 10: bigger feedback + video"
25,"SUPPRF89348",47,11,35,-56,15,5,20,91,"Pilot 10","Pilot 10: bigger feedback + video"
26,"SUPPRF89348",46,9,33,-8,-13,6,46,41,"Pilot 10","Pilot 10: bigger feedback + video"
27,"SUPPRF89348",46,47,46,-1,17,4,29,47,"Pilot 10","Pilot 10: bigger feedback + video"
28,"SUPPRF89348",21,16,16,-54,-13,6,29,70,"Pilot 10","Pilot 10: bigger feedback + video"
29,"SUPPRF89348",37,70,54,-26,0,12,54,80,"Pilot 10","Pilot 10: bigger feedback + video"
30,"SUPPRF89348",44,8,45,-42,-1,8,46,87,"Pilot 10","Pilot 10: bigger feedback + video"
31,"SUPPRF89348",13,12,24,-65,-13,7,37,89,"Pilot 10","Pilot 10: bigger feedback + video"
32,"SUPPRF89348",6,10,8,-54,-12,10,20,62,"Pilot 10","Pilot 10: bigger feedback + video"
33,"SUPPRF89348",66,28,100,29,20,16,80,71,"Pilot 10","Pilot 10: bigger feedback + video"
34,"SUPPRF89348",54,17,47,-10,-16,7,63,57,"Pilot 10","Pilot 10: bigger feedback + video"
35,"SUPPRF89348",61,18,71,-6,0,10,71,77,"Pilot 10","Pilot 10: bigger feedback + video"
36,"SUPPRF89348",47,28,56,9,-15,4,71,47,"Pilot 10","Pilot 10: bigger feedback + video"
37,"SUPPRF89348",70,25,77,55,14,4,63,22,"Pilot 10","Pilot 10: bigger feedback + video"
38,"SUPPRF89348",44,15,19,-26,-1,8,20,45,"Pilot 10","Pilot 10: bigger feedback + video"
39,"SUPPRF89348",80,14,80,25,0,3,80,55,"Pilot 10","Pilot 10: bigger feedback + video"
40,"SUPPRF89348",41,16,68,-10,-12,3,80,78,"Pilot 10","Pilot 10: bigger feedback + video"
41,"SUPPRF89348",25,34,61,41,24,6,37,20,"Pilot 10","Pilot 10: bigger feedback + video"
42,"SUPPRF89348",20,21,28,-14,-1,4,29,42,"Pilot 10","Pilot 10: bigger feedback + video"
43,"SUPPRF89348",45,39,38,-16,-16,2,54,54,"Pilot 10","Pilot 10: bigger feedback + video"
44,"SUPPRF89348",39,22,58,35,29,4,29,23,"Pilot 10","Pilot 10: bigger feedback + video"
45,"SUPPRF89348",47,46,49,-14,12,2,37,63,"Pilot 10","Pilot 10: bigger feedback + video"
46,"SUPPRF89348",87,18,96,8,16,3,80,88,"Pilot 10","Pilot 10: bigger feedback + video"
47,"SUPPRF89348",41,46,41,-6,-13,6,54,47,"Pilot 10","Pilot 10: bigger feedback + video"
48,"SUPPRF89348",55,25,63,19,0,3,63,44,"Pilot 10","Pilot 10: bigger feedback + video"
1,"SUPPRF45704",51,55,22,-14,-15,51,37,36,"Pilot 10","Pilot 10: bigger feedback + video"
2,"SUPPRF45704",47,51,47,-15,-16,50,63,62,"Pilot 10","Pilot 10: bigger feedback + video"
3,"SUPPRF45704",48,47,19,1,-1,47,20,18,"Pilot 10","Pilot 10: bigger feedback + video"
4,"SUPPRF45704",52,37,62,29,-1,45,63,33,"Pilot 10","Pilot 10: bigger feedback + video"
5,"SUPPRF45704",56,36,46,-8,17,49,29,54,"Pilot 10","Pilot 10: bigger feedback + video"
6,"SUPPRF45704",60,31,58,31,29,48,29,27,"Pilot 10","Pilot 10: bigger feedback + video"
7,"SUPPRF45704",59,31,41,-18,-13,52,54,59,"Pilot 10","Pilot 10: bigger feedback + video"
8,"SUPPRF45704",62,34,49,0,12,48,37,49,"Pilot 10","Pilot 10: bigger feedback + video"
9,"SUPPRF45704",57,40,20,-43,0,13,20,63,"Pilot 10","Pilot 10: bigger feedback + video"
10,"SUPPRF45704",48,48,67,18,-13,51,80,49,"Pilot 10","Pilot 10: bigger feedback + video"
11,"SUPPRF45704",48,52,78,27,24,49,54,51,"Pilot 10","Pilot 10: bigger feedback + video"
12,"SUPPRF45704",99,0,70,15,-1,52,71,55,"Pilot 10","Pilot 10: bigger feedback + video"
13,"SUPPRF45704",60,32,54,3,0,55,54,51,"Pilot 10","Pilot 10: bigger feedback + video"
14,"SUPPRF45704",80,17,38,-9,-16,72,54,47,"Pilot 10","Pilot 10: bigger feedback + video"
15,"SUPPRF45704",73,26,55,0,1,66,54,55,"Pilot 10","Pilot 10: bigger feedback + video"
16,"SUPPRF45704",69,22,77,22,14,52,63,55,"Pilot 10","Pilot 10: bigger feedback + video"
17,"SUPPRF45704",67,21,71,45,0,75,71,26,"Pilot 10","Pilot 10: bigger feedback + video"
18,"SUPPRF45704",77,0,75,34,29,81,46,41,"Pilot 10","Pilot 10: bigger feedback + video"
19,"SUPPRF45704",70,3,50,9,-13,83,63,41,"Pilot 10","Pilot 10: bigger feedback + video"
20,"SUPPRF45704",51,2,33,-12,-13,86,46,45,"Pilot 10","Pilot 10: bigger feedback + video"
21,"SUPPRF45704",53,11,24,-1,-13,47,37,25,"Pilot 10","Pilot 10: bigger feedback + video"
22,"SUPPRF45704",44,3,15,9,-14,79,29,6,"Pilot 10","Pilot 10: bigger feedback + video"
23,"SUPPRF45704",73,22,81,3,1,80,80,78,"Pilot 10","Pilot 10: bigger feedback + video"
24,"SUPPRF45704",47,7,37,-1,0,70,37,38,"Pilot 10","Pilot 10: bigger feedback + video"
25,"SUPPRF45704",49,2,29,-21,0,45,29,50,"Pilot 10","Pilot 10: bigger feedback + video"
26,"SUPPRF45704",57,34,66,18,12,48,54,48,"Pilot 10","Pilot 10: bigger feedback + video"
27,"SUPPRF45704",51,49,38,4,1,45,37,34,"Pilot 10","Pilot 10: bigger feedback + video"
28,"SUPPRF45704",48,14,83,17,12,68,71,66,"Pilot 10","Pilot 10: bigger feedback + video"
29,"SUPPRF45704",60,23,34,-3,-12,48,46,37,"Pilot 10","Pilot 10: bigger feedback + video"
30,"SUPPRF45704",58,30,94,24,23,74,71,70,"Pilot 10","Pilot 10: bigger feedback + video"
31,"SUPPRF45704",65,29,68,1,-12,65,80,67,"Pilot 10","Pilot 10: bigger feedback + video"
32,"SUPPRF45704",52,23,45,-24,-1,56,46,69,"Pilot 10","Pilot 10: bigger feedback + video"
33,"SUPPRF45704",52,25,55,-20,-16,80,71,75,"Pilot 10","Pilot 10: bigger feedback + video"
34,"SUPPRF45704",63,28,100,30,20,77,80,70,"Pilot 10","Pilot 10: bigger feedback + video"
35,"SUPPRF45704",51,44,46,-18,0,62,46,64,"Pilot 10","Pilot 10: bigger feedback + video"
36,"SUPPRF45704",27,37,6,-31,-14,54,20,37,"Pilot 10","Pilot 10: bigger feedback + video"
37,"SUPPRF45704",5,32,58,43,12,52,46,15,"Pilot 10","Pilot 10: bigger feedback + video"
38,"SUPPRF45704",2,45,96,50,16,45,80,46,"Pilot 10","Pilot 10: bigger feedback + video"
39,"SUPPRF45704",69,37,35,-16,15,51,20,51,"Pilot 10","Pilot 10: bigger feedback + video"
40,"SUPPRF45704",50,49,88,37,25,49,63,51,"Pilot 10","Pilot 10: bigger feedback + video"
41,"SUPPRF45704",49,51,61,-4,24,53,37,65,"Pilot 10","Pilot 10: bigger feedback + video"
42,"SUPPRF45704",51,52,47,-6,27,48,20,53,"Pilot 10","Pilot 10: bigger feedback + video"
43,"SUPPRF45704",47,38,28,-21,-1,48,29,49,"Pilot 10","Pilot 10: bigger feedback + video"
44,"SUPPRF45704",43,33,16,-13,-13,29,29,29,"Pilot 10","Pilot 10: bigger feedback + video"
45,"SUPPRF45704",50,47,8,-37,-12,44,20,45,"Pilot 10","Pilot 10: bigger feedback + video"
46,"SUPPRF45704",41,53,56,4,-15,49,71,52,"Pilot 10","Pilot 10: bigger feedback + video"
47,"SUPPRF45704",50,49,63,12,0,48,63,51,"Pilot 10","Pilot 10: bigger feedback + video"
48,"SUPPRF45704",44,41,80,36,0,51,80,44,"Pilot 10","Pilot 10: bigger feedback + video"
1,"SUPPRF70595",39,45,16,-13,-13,57,29,29,"Pilot 10","Pilot 10: bigger feedback + video"
2,"SUPPRF70595",51,36,78,18,24,57,54,60,"Pilot 10","Pilot 10: bigger feedback + video"
3,"SUPPRF70595",52,34,70,1,-1,65,71,69,"Pilot 10","Pilot 10: bigger feedback + video"
4,"SUPPRF70595",49,46,20,3,0,81,20,17,"Pilot 10","Pilot 10: bigger feedback + video"
5,"SUPPRF70595",54,48,83,16,12,66,71,67,"Pilot 10","Pilot 10: bigger feedback + video"
6,"SUPPRF70595",59,35,80,3,0,41,80,77,"Pilot 10","Pilot 10: bigger feedback + video"
7,"SUPPRF70595",51,40,58,44,29,68,29,14,"Pilot 10","Pilot 10: bigger feedback + video"
8,"SUPPRF70595",56,36,62,3,-1,49,63,59,"Pilot 10","Pilot 10: bigger feedback + video"
9,"SUPPRF70595",53,40,67,9,-13,37,80,58,"Pilot 10","Pilot 10: bigger feedback + video"
10,"SUPPRF70595",39,54,8,-11,-12,75,20,19,"Pilot 10","Pilot 10: bigger feedback + video"
11,"SUPPRF70595",46,44,33,-29,-13,42,46,62,"Pilot 10","Pilot 10: bigger feedback + video"
12,"SUPPRF70595",43,51,35,28,15,69,20,7,"Pilot 10","Pilot 10: bigger feedback + video"
13,"SUPPRF70595",43,57,46,4,0,45,46,42,"Pilot 10","Pilot 10: bigger feedback + video"
14,"SUPPRF70595",52,54,56,-4,-15,53,71,60,"Pilot 10","Pilot 10: bigger feedback + video"
15,"SUPPRF70595",47,62,50,0,-13,36,63,50,"Pilot 10","Pilot 10: bigger feedback + video"
16,"SUPPRF70595",49,53,61,42,24,65,37,19,"Pilot 10","Pilot 10: bigger feedback + video"
17,"SUPPRF70595",49,64,63,9,0,50,63,54,"Pilot 10","Pilot 10: bigger feedback + video"
18,"SUPPRF70595",56,38,71,-2,0,76,71,73,"Pilot 10","Pilot 10: bigger feedback + video"
19,"SUPPRF70595",47,67,54,1,0,64,54,53,"Pilot 10","Pilot 10: bigger feedback + video"
20,"SUPPRF70595",52,65,68,-1,-12,35,80,69,"Pilot 10","Pilot 10: bigger feedback + video"
21,"SUPPRF70595",37,71,38,-16,-16,46,54,54,"Pilot 10","Pilot 10: bigger feedback + video"
22,"SUPPRF70595",45,64,19,6,-1,76,20,13,"Pilot 10","Pilot 10: bigger feedback + video"
23,"SUPPRF70595",31,56,37,-9,0,31,37,46,"Pilot 10","Pilot 10: bigger feedback + video"
24,"SUPPRF70595",33,67,66,19,12,28,54,47,"Pilot 10","Pilot 10: bigger feedback + video"
25,"SUPPRF70595",56,49,77,36,14,45,63,41,"Pilot 10","Pilot 10: bigger feedback + video"
26,"SUPPRF70595",42,57,15,-9,-14,51,29,24,"Pilot 10","Pilot 10: bigger feedback + video"
27,"SUPPRF70595",42,64,22,-32,-15,40,37,54,"Pilot 10","Pilot 10: bigger feedback + video"
28,"SUPPRF70595",49,53,58,16,12,54,46,42,"Pilot 10","Pilot 10: bigger feedback + video"
29,"SUPPRF70595",58,52,81,42,1,41,80,39,"Pilot 10","Pilot 10: bigger feedback + video"
30,"SUPPRF70595",57,48,100,29,20,84,80,71,"Pilot 10","Pilot 10: bigger feedback + video"
31,"SUPPRF70595",51,54,75,24,29,59,46,51,"Pilot 10","Pilot 10: bigger feedback + video"
32,"SUPPRF70595",51,56,49,-7,12,41,37,56,"Pilot 10","Pilot 10: bigger feedback + video"
33,"SUPPRF70595",52,54,38,-11,1,45,37,49,"Pilot 10","Pilot 10: bigger feedback + video"
34,"SUPPRF70595",43,56,46,40,17,73,29,6,"Pilot 10","Pilot 10: bigger feedback + video"
35,"SUPPRF70595",43,53,41,-10,-13,54,54,51,"Pilot 10","Pilot 10: bigger feedback + video"
36,"SUPPRF70595",38,60,45,0,-1,60,46,45,"Pilot 10","Pilot 10: bigger feedback + video"
37,"SUPPRF70595",34,64,88,46,25,41,63,42,"Pilot 10","Pilot 10: bigger feedback + video"
38,"SUPPRF70595",34,62,6,-38,-14,28,20,44,"Pilot 10","Pilot 10: bigger feedback + video"
39,"SUPPRF70595",34,57,47,41,27,81,20,6,"Pilot 10","Pilot 10: bigger feedback + video"
40,"SUPPRF70595",30,56,29,9,0,34,29,20,"Pilot 10","Pilot 10: bigger feedback + video"
41,"SUPPRF70595",52,55,94,29,23,34,71,65,"Pilot 10","Pilot 10: bigger feedback + video"
42,"SUPPRF70595",39,71,47,9,-16,14,63,38,"Pilot 10","Pilot 10: bigger feedback + video"
43,"SUPPRF70595",42,67,34,-12,-12,58,46,46,"Pilot 10","Pilot 10: bigger feedback + video"
44,"SUPPRF70595",46,63,96,29,16,55,80,67,"Pilot 10","Pilot 10: bigger feedback + video"
45,"SUPPRF70595",35,64,55,-19,-16,62,71,74,"Pilot 10","Pilot 10: bigger feedback + video"
46,"SUPPRF70595",42,58,55,1,1,43,54,54,"Pilot 10","Pilot 10: bigger feedback + video"
47,"SUPPRF70595",29,72,28,-27,-1,43,29,55,"Pilot 10","Pilot 10: bigger feedback + video"
48,"SUPPRF70595",27,71,24,-19,-13,62,37,43,"Pilot 10","Pilot 10: bigger feedback + video"
1,"SUPPRF54185",69,11,58,24,29,68,29,34,"Pilot 10","Pilot 10: bigger feedback + video"
2,"SUPPRF54185",70,10,46,-17,0,64,46,63,"Pilot 10","Pilot 10: bigger feedback + video"
3,"SUPPRF54185",68,5,83,17,12,58,71,66,"Pilot 10","Pilot 10: bigger feedback + video"
4,"SUPPRF54185",69,9,41,-21,-13,55,54,62,"Pilot 10","Pilot 10: bigger feedback + video"
5,"SUPPRF54185",70,5,67,2,-13,49,80,65,"Pilot 10","Pilot 10: bigger feedback + video"
6,"SUPPRF54185",71,7,16,-44,-13,49,29,60,"Pilot 10","Pilot 10: bigger feedback + video"
7,"SUPPRF54185",69,6,88,33,25,47,63,55,"Pilot 10","Pilot 10: bigger feedback + video"
8,"SUPPRF54185",67,3,71,4,0,49,71,67,"Pilot 10","Pilot 10: bigger feedback + video"
9,"SUPPRF54185",70,7,22,-40,-15,56,37,62,"Pilot 10","Pilot 10: bigger feedback + video"
10,"SUPPRF54185",75,8,56,-14,-15,62,71,70,"Pilot 10","Pilot 10: bigger feedback + video"
11,"SUPPRF54185",74,6,38,-28,1,61,37,66,"Pilot 10","Pilot 10: bigger feedback + video"
12,"SUPPRF54185",72,5,80,33,0,60,80,47,"Pilot 10","Pilot 10: bigger feedback + video"
13,"SUPPRF54185",67,6,28,-24,-1,67,29,52,"Pilot 10","Pilot 10: bigger feedback + video"
14,"SUPPRF54185",68,4,29,-1,0,68,29,30,"Pilot 10","Pilot 10: bigger feedback + video"
15,"SUPPRF54185",68,6,94,42,23,54,71,52,"Pilot 10","Pilot 10: bigger feedback + video"
16,"SUPPRF54185",70,6,77,18,14,66,63,59,"Pilot 10","Pilot 10: bigger feedback + video"
17,"SUPPRF54185",69,6,37,-25,0,49,37,62,"Pilot 10","Pilot 10: bigger feedback + video"
18,"SUPPRF54185",70,6,61,8,24,64,37,53,"Pilot 10","Pilot 10: bigger feedback + video"
19,"SUPPRF54185",72,4,24,-22,-13,62,37,46,"Pilot 10","Pilot 10: bigger feedback + video"
20,"SUPPRF54185",70,8,70,16,-1,62,71,54,"Pilot 10","Pilot 10: bigger feedback + video"
21,"SUPPRF54185",71,4,46,-20,17,68,29,66,"Pilot 10","Pilot 10: bigger feedback + video"
22,"SUPPRF54185",73,8,8,-56,-12,16,20,64,"Pilot 10","Pilot 10: bigger feedback + video"
23,"SUPPRF54185",75,9,55,-4,1,63,54,59,"Pilot 10","Pilot 10: bigger feedback + video"
24,"SUPPRF54185",84,6,47,-11,-16,5,63,58,"Pilot 10","Pilot 10: bigger feedback + video"
25,"SUPPRF54185",74,5,62,9,-1,63,63,53,"Pilot 10","Pilot 10: bigger feedback + video"
26,"SUPPRF54185",73,5,63,5,0,57,63,58,"Pilot 10","Pilot 10: bigger feedback + video"
27,"SUPPRF54185",84,5,33,-21,-13,64,46,54,"Pilot 10","Pilot 10: bigger feedback + video"
28,"SUPPRF54185",71,6,45,-19,-1,67,46,64,"Pilot 10","Pilot 10: bigger feedback + video"
29,"SUPPRF54185",82,6,81,-1,1,81,80,82,"Pilot 10","Pilot 10: bigger feedback + video"
30,"SUPPRF54185",79,6,6,-61,-14,19,20,67,"Pilot 10","Pilot 10: bigger feedback + video"
31,"SUPPRF54185",78,10,15,-8,-14,59,29,23,"Pilot 10","Pilot 10: bigger feedback + video"
32,"SUPPRF54185",77,4,35,-28,15,60,20,63,"Pilot 10","Pilot 10: bigger feedback + video"
33,"SUPPRF54185",69,4,100,24,20,70,80,76,"Pilot 10","Pilot 10: bigger feedback + video"
34,"SUPPRF54185",73,7,96,17,16,74,80,79,"Pilot 10","Pilot 10: bigger feedback + video"
35,"SUPPRF54185",72,1,34,-18,-12,62,46,52,"Pilot 10","Pilot 10: bigger feedback + video"
36,"SUPPRF54185",74,6,50,-16,-13,56,63,66,"Pilot 10","Pilot 10: bigger feedback + video"
37,"SUPPRF54185",4,5,54,0,0,62,54,54,"Pilot 10","Pilot 10: bigger feedback + video"
38,"SUPPRF54185",59,9,58,3,12,55,46,55,"Pilot 10","Pilot 10: bigger feedback + video"
39,"SUPPRF54185",63,9,75,20,29,53,46,55,"Pilot 10","Pilot 10: bigger feedback + video"
40,"SUPPRF54185",61,5,38,-18,-16,60,54,56,"Pilot 10","Pilot 10: bigger feedback + video"
41,"SUPPRF54185",59,5,47,33,27,59,20,14,"Pilot 10","Pilot 10: bigger feedback + video"
42,"SUPPRF54185",61,2,20,5,0,61,20,15,"Pilot 10","Pilot 10: bigger feedback + video"
43,"SUPPRF54185",4,4,68,-5,-12,78,80,73,"Pilot 10","Pilot 10: bigger feedback + video"
44,"SUPPRF54185",53,5,78,24,24,53,54,54,"Pilot 10","Pilot 10: bigger feedback + video"
45,"SUPPRF54185",61,6,66,13,12,54,54,53,"Pilot 10","Pilot 10: bigger feedback + video"
46,"SUPPRF54185",47,5,49,-9,12,53,37,58,"Pilot 10","Pilot 10: bigger feedback + video"
47,"SUPPRF54185",10,7,19,-11,-1,52,20,30,"Pilot 10","Pilot 10: bigger feedback + video"
48,"SUPPRF54185",15,5,55,-7,-16,58,71,62,"Pilot 10","Pilot 10: bigger feedback + video"
1,"SUPPRF14173",53,53,54,0,0,77,54,54,"Pilot 10","Pilot 10: bigger feedback + video"
2,"SUPPRF14173",54,50,71,-2,0,52,71,73,"Pilot 10","Pilot 10: bigger feedback + video"
3,"SUPPRF14173",52,53,94,14,23,73,71,80,"Pilot 10","Pilot 10: bigger feedback + video"
4,"SUPPRF14173",52,53,66,-9,12,64,54,75,"Pilot 10","Pilot 10: bigger feedback + video"
5,"SUPPRF14173",51,52,15,-15,-14,78,29,30,"Pilot 10","Pilot 10: bigger feedback + video"
6,"SUPPRF14173",51,51,62,14,-1,59,63,48,"Pilot 10","Pilot 10: bigger feedback + video"
7,"SUPPRF14173",52,51,46,23,17,56,29,23,"Pilot 10","Pilot 10: bigger feedback + video"
8,"SUPPRF14173",50,53,41,-17,-13,58,54,58,"Pilot 10","Pilot 10: bigger feedback + video"
9,"SUPPRF14173",50,43,63,8,0,74,63,55,"Pilot 10","Pilot 10: bigger feedback + video"
10,"SUPPRF14173",61,49,61,-12,24,21,37,73,"Pilot 10","Pilot 10: bigger feedback + video"
11,"SUPPRF14173",59,45,47,-2,27,36,20,49,"Pilot 10","Pilot 10: bigger feedback + video"
12,"SUPPRF14173",58,41,56,1,-15,46,71,55,"Pilot 10","Pilot 10: bigger feedback + video"
13,"SUPPRF14173",65,41,70,7,-1,47,71,63,"Pilot 10","Pilot 10: bigger feedback + video"
14,"SUPPRF14173",66,43,58,4,12,66,46,54,"Pilot 10","Pilot 10: bigger feedback + video"
15,"SUPPRF14173",58,37,28,2,-1,74,29,26,"Pilot 10","Pilot 10: bigger feedback + video"
16,"SUPPRF14173",51,52,45,-40,-1,74,46,85,"Pilot 10","Pilot 10: bigger feedback + video"
17,"SUPPRF14173",67,35,83,30,12,63,71,53,"Pilot 10","Pilot 10: bigger feedback + video"
18,"SUPPRF14173",53,49,67,0,-13,77,80,67,"Pilot 10","Pilot 10: bigger feedback + video"
19,"SUPPRF14173",36,60,22,-42,-15,37,37,64,"Pilot 10","Pilot 10: bigger feedback + video"
20,"SUPPRF14173",65,40,81,-1,1,79,80,82,"Pilot 10","Pilot 10: bigger feedback + video"
21,"SUPPRF14173",50,63,24,-47,-13,75,37,71,"Pilot 10","Pilot 10: bigger feedback + video"
22,"SUPPRF14173",51,50,46,-27,0,69,46,73,"Pilot 10","Pilot 10: bigger feedback + video"
23,"SUPPRF14173",33,47,38,-37,-16,63,54,75,"Pilot 10","Pilot 10: bigger feedback + video"
24,"SUPPRF14173",44,54,8,-12,-12,85,20,20,"Pilot 10","Pilot 10: bigger feedback + video"
25,"SUPPRF14173",47,51,20,3,0,75,20,17,"Pilot 10","Pilot 10: bigger feedback + video"
26,"SUPPRF14173",42,62,16,-33,-13,52,29,49,"Pilot 10","Pilot 10: bigger feedback + video"
27,"SUPPRF14173",67,52,77,3,14,69,63,74,"Pilot 10","Pilot 10: bigger feedback + video"
28,"SUPPRF14173",61,41,78,17,24,59,54,61,"Pilot 10","Pilot 10: bigger feedback + video"
29,"SUPPRF14173",59,41,49,12,12,57,37,37,"Pilot 10","Pilot 10: bigger feedback + video"
30,"SUPPRF14173",44,40,33,-16,-13,46,46,49,"Pilot 10","Pilot 10: bigger feedback + video"
31,"SUPPRF14173",64,43,75,7,29,53,46,68,"Pilot 10","Pilot 10: bigger feedback + video"
32,"SUPPRF14173",52,62,68,0,-12,74,80,68,"Pilot 10","Pilot 10: bigger feedback + video"
33,"SUPPRF14173",53,47,47,-13,-16,68,63,60,"Pilot 10","Pilot 10: bigger feedback + video"
34,"SUPPRF14173",44,53,34,-28,-12,62,46,62,"Pilot 10","Pilot 10: bigger feedback + video"
35,"SUPPRF14173",47,67,6,-9,-14,49,20,15,"Pilot 10","Pilot 10: bigger feedback + video"
36,"SUPPRF14173",50,55,58,-5,29,65,29,63,"Pilot 10","Pilot 10: bigger feedback + video"
37,"SUPPRF14173",51,39,35,10,15,49,20,25,"Pilot 10","Pilot 10: bigger feedback + video"
38,"SUPPRF14173",71,42,96,34,16,72,80,62,"Pilot 10","Pilot 10: bigger feedback + video"
39,"SUPPRF14173",63,40,55,-15,1,61,54,70,"Pilot 10","Pilot 10: bigger feedback + video"
40,"SUPPRF14173",53,51,37,-19,0,61,37,56,"Pilot 10","Pilot 10: bigger feedback + video"
41,"SUPPRF14173",51,52,55,0,-16,30,71,55,"Pilot 10","Pilot 10: bigger feedback + video"
42,"SUPPRF14173",53,56,50,8,-13,38,63,42,"Pilot 10","Pilot 10: bigger feedback + video"
43,"SUPPRF14173",43,65,38,16,1,66,37,22,"Pilot 10","Pilot 10: bigger feedback + video"
44,"SUPPRF14173",31,63,19,-4,-1,53,20,23,"Pilot 10","Pilot 10: bigger feedback + video"
45,"SUPPRF14173",52,51,29,-23,0,69,29,52,"Pilot 10","Pilot 10: bigger feedback + video"
46,"SUPPRF14173",36,48,100,42,20,68,80,58,"Pilot 10","Pilot 10: bigger feedback + video"
47,"SUPPRF14173",57,51,80,5,0,61,80,75,"Pilot 10","Pilot 10: bigger feedback + video"
48,"SUPPRF14173",52,48,88,35,25,32,63,53,"Pilot 10","Pilot 10: bigger feedback + video"
1,"SUPPRF70880",45,47,68,45,-12,2,80,23,"Pilot 10","Pilot 10: bigger feedback + video"
2,"SUPPRF70880",37,43,63,5,0,38,63,58,"Pilot 10","Pilot 10: bigger feedback + video"
3,"SUPPRF70880",26,71,15,-25,-14,0,29,40,"Pilot 10","Pilot 10: bigger feedback + video"
4,"SUPPRF70880",46,61,77,31,14,28,63,46,"Pilot 10","Pilot 10: bigger feedback + video"
5,"SUPPRF70880",65,60,46,5,17,52,29,41,"Pilot 10","Pilot 10: bigger feedback + video"
6,"SUPPRF70880",53,39,83,47,12,11,71,36,"Pilot 10","Pilot 10: bigger feedback + video"
7,"SUPPRF70880",59,54,58,15,29,50,29,43,"Pilot 10","Pilot 10: bigger feedback + video"
8,"SUPPRF70880",63,21,75,42,29,62,46,33,"Pilot 10","Pilot 10: bigger feedback + video"
9,"SUPPRF70880",62,15,33,-1,-13,59,46,34,"Pilot 10","Pilot 10: bigger feedback + video"
10,"SUPPRF70880",17,58,16,-24,-13,64,29,40,"Pilot 10","Pilot 10: bigger feedback + video"
11,"SUPPRF70880",17,64,61,19,24,70,37,42,"Pilot 10","Pilot 10: bigger feedback + video"
12,"SUPPRF70880",34,44,54,14,0,51,54,40,"Pilot 10","Pilot 10: bigger feedback + video"
13,"SUPPRF70880",50,47,46,-8,0,67,46,54,"Pilot 10","Pilot 10: bigger feedback + video"
14,"SUPPRF70880",39,63,88,41,25,24,63,47,"Pilot 10","Pilot 10: bigger feedback + video"
15,"SUPPRF70880",57,57,81,61,1,22,80,20,"Pilot 10","Pilot 10: bigger feedback + video"
16,"SUPPRF70880",67,35,37,-11,0,29,37,48,"Pilot 10","Pilot 10: bigger feedback + video"
17,"SUPPRF70880",45,51,24,-22,-13,0,37,46,"Pilot 10","Pilot 10: bigger feedback + video"
18,"SUPPRF70880",37,47,29,-26,0,29,29,55,"Pilot 10","Pilot 10: bigger feedback + video"
19,"SUPPRF70880",50,1,96,49,16,18,80,47,"Pilot 10","Pilot 10: bigger feedback + video"
20,"SUPPRF70880",74,64,71,29,0,25,71,42,"Pilot 10","Pilot 10: bigger feedback + video"
21,"SUPPRF70880",35,75,62,15,-1,66,63,47,"Pilot 10","Pilot 10: bigger feedback + video"
22,"SUPPRF70880",64,50,34,-12,-12,52,46,46,"Pilot 10","Pilot 10: bigger feedback + video"
23,"SUPPRF70880",98,53,94,34,23,33,71,60,"Pilot 10","Pilot 10: bigger feedback + video"
24,"SUPPRF70880",44,39,66,8,12,34,54,58,"Pilot 10","Pilot 10: bigger feedback + video"
25,"SUPPRF70880",46,82,67,23,-13,0,80,44,"Pilot 10","Pilot 10: bigger feedback + video"
26,"SUPPRF70880",13,84,8,-54,-12,33,20,62,"Pilot 10","Pilot 10: bigger feedback + video"
27,"SUPPRF70880",68,43,70,27,-1,60,71,43,"Pilot 10","Pilot 10: bigger feedback + video"
28,"SUPPRF70880",71,27,38,-2,-16,44,54,40,"Pilot 10","Pilot 10: bigger feedback + video"
29,"SUPPRF70880",30,66,78,26,24,63,54,52,"Pilot 10","Pilot 10: bigger feedback + video"
30,"SUPPRF70880",49,41,80,19,0,58,80,61,"Pilot 10","Pilot 10: bigger feedback + video"
31,"SUPPRF70880",40,66,45,0,-1,65,46,45,"Pilot 10","Pilot 10: bigger feedback + video"
32,"SUPPRF70880",27,56,49,9,12,75,37,40,"Pilot 10","Pilot 10: bigger feedback + video"
33,"SUPPRF70880",55,37,35,-9,15,26,20,44,"Pilot 10","Pilot 10: bigger feedback + video"
34,"SUPPRF70880",52,75,50,9,-13,25,63,41,"Pilot 10","Pilot 10: bigger feedback + video"
35,"SUPPRF70880",82,32,55,13,1,0,54,42,"Pilot 10","Pilot 10: bigger feedback + video"
36,"SUPPRF70880",24,67,55,-1,-16,27,71,56,"Pilot 10","Pilot 10: bigger feedback + video"
37,"SUPPRF70880",47,52,22,-21,-15,0,37,43,"Pilot 10","Pilot 10: bigger feedback + video"
38,"SUPPRF70880",1,49,6,-47,-14,17,20,53,"Pilot 10","Pilot 10: bigger feedback + video"
39,"SUPPRF70880",64,63,38,-9,1,31,37,47,"Pilot 10","Pilot 10: bigger feedback + video"
40,"SUPPRF70880",41,57,20,14,0,90,20,6,"Pilot 10","Pilot 10: bigger feedback + video"
41,"SUPPRF70880",100,7,100,53,20,67,80,47,"Pilot 10","Pilot 10: bigger feedback + video"
42,"SUPPRF70880",78,43,56,11,-15,76,71,45,"Pilot 10","Pilot 10: bigger feedback + video"
43,"SUPPRF70880",60,79,47,37,27,67,20,10,"Pilot 10","Pilot 10: bigger feedback + video"
44,"SUPPRF70880",64,66,41,5,-13,70,54,36,"Pilot 10","Pilot 10: bigger feedback + video"
45,"SUPPRF70880",79,40,47,4,-16,65,63,43,"Pilot 10","Pilot 10: bigger feedback + video"
46,"SUPPRF70880",34,88,19,-18,-1,65,20,37,"Pilot 10","Pilot 10: bigger feedback + video"
47,"SUPPRF70880",69,77,28,-18,-1,15,29,46,"Pilot 10","Pilot 10: bigger feedback + video"
48,"SUPPRF70880",79,34,58,13,12,25,46,45,"Pilot 10","Pilot 10: bigger feedback + video"
1,"SUPPRF18662",67,4,47,27,27,70,20,20,"Pilot 10","Pilot 10: bigger feedback + video"
2,"SUPPRF18662",49,6,68,-12,-12,80,80,80,"Pilot 10","Pilot 10: bigger feedback + video"
3,"SUPPRF18662",52,4,62,7,-1,60,63,55,"Pilot 10","Pilot 10: bigger feedback + video"
4,"SUPPRF18662",49,7,29,9,0,75,29,20,"Pilot 10","Pilot 10: bigger feedback + video"
5,"SUPPRF18662",50,4,34,-21,-12,70,46,55,"Pilot 10","Pilot 10: bigger feedback + video"
6,"SUPPRF18662",36,8,8,-14,-12,90,20,22,"Pilot 10","Pilot 10: bigger feedback + video"
7,"SUPPRF18662",51,4,35,21,15,72,20,14,"Pilot 10","Pilot 10: bigger feedback + video"
8,"SUPPRF18662",43,22,41,-14,-13,68,54,55,"Pilot 10","Pilot 10: bigger feedback + video"
9,"SUPPRF18662",53,11,88,28,25,56,63,60,"Pilot 10","Pilot 10: bigger feedback + video"
10,"SUPPRF18662",49,9,83,3,12,70,71,80,"Pilot 10","Pilot 10: bigger feedback + video"
11,"SUPPRF18662",53,5,67,-3,-13,65,80,70,"Pilot 10","Pilot 10: bigger feedback + video"
12,"SUPPRF18662",49,9,77,17,14,65,63,60,"Pilot 10","Pilot 10: bigger feedback + video"
13,"SUPPRF18662",47,8,46,26,17,75,29,20,"Pilot 10","Pilot 10: bigger feedback + video"
14,"SUPPRF18662",35,7,38,-22,-16,75,54,60,"Pilot 10","Pilot 10: bigger feedback + video"
15,"SUPPRF18662",48,10,45,4,-1,75,46,41,"Pilot 10","Pilot 10: bigger feedback + video"
16,"SUPPRF18662",49,6,61,31,24,69,37,30,"Pilot 10","Pilot 10: bigger feedback + video"
17,"SUPPRF18662",43,6,38,-12,1,60,37,50,"Pilot 10","Pilot 10: bigger feedback + video"
18,"SUPPRF18662",51,6,75,37,29,74,46,38,"Pilot 10","Pilot 10: bigger feedback + video"
19,"SUPPRF18662",49,7,80,0,0,81,80,80,"Pilot 10","Pilot 10: bigger feedback + video"
20,"SUPPRF18662",50,6,47,-3,-16,65,63,50,"Pilot 10","Pilot 10: bigger feedback + video"
21,"SUPPRF18662",33,7,16,-17,-13,54,29,33,"Pilot 10","Pilot 10: bigger feedback + video"
22,"SUPPRF18662",38,5,20,1,0,74,20,19,"Pilot 10","Pilot 10: bigger feedback + video"
23,"SUPPRF18662",44,6,33,-2,-13,50,46,35,"Pilot 10","Pilot 10: bigger feedback + video"
24,"SUPPRF18662",50,6,78,28,24,72,54,50,"Pilot 10","Pilot 10: bigger feedback + video"
25,"SUPPRF18662",49,7,56,-14,-15,70,71,70,"Pilot 10","Pilot 10: bigger feedback + video"
26,"SUPPRF18662",33,5,6,-12,-14,80,20,18,"Pilot 10","Pilot 10: bigger feedback + video"
27,"SUPPRF18662",46,6,46,-2,0,73,46,48,"Pilot 10","Pilot 10: bigger feedback + video"
28,"SUPPRF18662",50,6,49,-3,12,69,37,52,"Pilot 10","Pilot 10: bigger feedback + video"
29,"SUPPRF18662",51,7,66,11,12,70,54,55,"Pilot 10","Pilot 10: bigger feedback + video"
30,"SUPPRF18662",45,9,22,-23,-15,76,37,45,"Pilot 10","Pilot 10: bigger feedback + video"
31,"SUPPRF18662",42,9,15,-20,-14,79,29,35,"Pilot 10","Pilot 10: bigger feedback + video"
32,"SUPPRF18662",53,7,70,-9,-1,81,71,79,"Pilot 10","Pilot 10: bigger feedback + video"
33,"SUPPRF18662",50,6,54,-2,0,73,54,56,"Pilot 10","Pilot 10: bigger feedback + video"
34,"SUPPRF18662",51,6,81,2,1,80,80,79,"Pilot 10","Pilot 10: bigger feedback + video"
35,"SUPPRF18662",50,9,63,11,0,75,63,52,"Pilot 10","Pilot 10: bigger feedback + video"
36,"SUPPRF18662",33,5,28,-31,-1,70,29,59,"Pilot 10","Pilot 10: bigger feedback + video"
37,"SUPPRF18662",52,6,50,9,-13,80,63,41,"Pilot 10","Pilot 10: bigger feedback + video"
38,"SUPPRF18662",50,5,37,2,0,81,37,35,"Pilot 10","Pilot 10: bigger feedback + video"
39,"SUPPRF18662",39,9,55,-15,-16,48,71,70,"Pilot 10","Pilot 10: bigger feedback + video"
40,"SUPPRF18662",64,9,96,21,16,75,80,75,"Pilot 10","Pilot 10: bigger feedback + video"
41,"SUPPRF18662",51,8,55,0,1,80,54,55,"Pilot 10","Pilot 10: bigger feedback + video"
42,"SUPPRF18662",59,5,94,14,23,83,71,80,"Pilot 10","Pilot 10: bigger feedback + video"
43,"SUPPRF18662",45,9,19,-3,-1,76,20,22,"Pilot 10","Pilot 10: bigger feedback + video"
44,"SUPPRF18662",47,5,24,-1,-13,84,37,25,"Pilot 10","Pilot 10: bigger feedback + video"
45,"SUPPRF18662",48,9,58,37,29,85,29,21,"Pilot 10","Pilot 10: bigger feedback + video"
46,"SUPPRF18662",46,6,71,-9,0,80,71,80,"Pilot 10","Pilot 10: bigger feedback + video"
47,"SUPPRF18662",53,8,58,14,12,81,46,44,"Pilot 10","Pilot 10: bigger feedback + video"
48,"SUPPRF18662",62,6,100,15,20,85,80,85,"Pilot 10","Pilot 10: bigger feedback + video"
1,"SUPPRF78305",10,91,63,0,0,73,63,63,"Pilot 10","Pilot 10: bigger feedback + video"
2,"SUPPRF78305",31,73,47,29,27,89,20,18,"Pilot 10","Pilot 10: bigger feedback + video"
3,"SUPPRF78305",38,64,80,4,0,89,80,76,"Pilot 10","Pilot 10: bigger feedback + video"
4,"SUPPRF78305",36,68,78,53,24,19,54,25,"Pilot 10","Pilot 10: bigger feedback + video"
5,"SUPPRF78305",30,79,49,-21,12,11,37,70,"Pilot 10","Pilot 10: bigger feedback + video"
6,"SUPPRF78305",17,78,55,-19,-16,98,71,74,"Pilot 10","Pilot 10: bigger feedback + video"
7,"SUPPRF78305",74,42,46,6,17,86,29,40,"Pilot 10","Pilot 10: bigger feedback + video"
8,"SUPPRF78305",31,69,66,16,12,56,54,50,"Pilot 10","Pilot 10: bigger feedback + video"
9,"SUPPRF78305",31,67,38,-2,1,93,37,40,"Pilot 10","Pilot 10: bigger feedback + video"
10,"SUPPRF78305",11,81,33,-9,-13,92,46,42,"Pilot 10","Pilot 10: bigger feedback + video"
11,"SUPPRF78305",12,80,38,-24,-16,85,54,62,"Pilot 10","Pilot 10: bigger feedback + video"
12,"SUPPRF78305",6,88,24,-6,-13,91,37,30,"Pilot 10","Pilot 10: bigger feedback + video"
13,"SUPPRF78305",36,63,77,15,14,80,63,62,"Pilot 10","Pilot 10: bigger feedback + video"
14,"SUPPRF78305",29,77,62,-1,-1,93,63,63,"Pilot 10","Pilot 10: bigger feedback + video"
15,"SUPPRF78305",29,71,46,-5,0,96,46,51,"Pilot 10","Pilot 10: bigger feedback + video"
16,"SUPPRF78305",34,81,68,-5,-12,84,80,73,"Pilot 10","Pilot 10: bigger feedback + video"
17,"SUPPRF78305",21,74,58,4,12,95,46,54,"Pilot 10","Pilot 10: bigger feedback + video"
18,"SUPPRF78305",8,83,34,-18,-12,93,46,52,"Pilot 10","Pilot 10: bigger feedback + video"
19,"SUPPRF78305",28,67,100,25,20,84,80,75,"Pilot 10","Pilot 10: bigger feedback + video"
20,"SUPPRF78305",4,83,19,-1,-1,87,20,20,"Pilot 10","Pilot 10: bigger feedback + video"
21,"SUPPRF78305",4,88,28,-7,-1,39,29,35,"Pilot 10","Pilot 10: bigger feedback + video"
22,"SUPPRF78305",7,44,61,26,24,82,37,35,"Pilot 10","Pilot 10: bigger feedback + video"
23,"SUPPRF78305",5,46,45,2,-1,89,46,43,"Pilot 10","Pilot 10: bigger feedback + video"
24,"SUPPRF78305",1,39,15,-36,-14,35,29,51,"Pilot 10","Pilot 10: bigger feedback + video"
25,"SUPPRF78305",0,41,71,2,0,82,71,69,"Pilot 10","Pilot 10: bigger feedback + video"
26,"SUPPRF78305",4,37,50,0,-13,76,63,50,"Pilot 10","Pilot 10: bigger feedback + video"
27,"SUPPRF78305",1,41,22,-17,-15,77,37,39,"Pilot 10","Pilot 10: bigger feedback + video"
28,"SUPPRF78305",2,34,8,-14,-12,89,20,22,"Pilot 10","Pilot 10: bigger feedback + video"
29,"SUPPRF78305",0,27,88,26,25,35,63,62,"Pilot 10","Pilot 10: bigger feedback + video"
30,"SUPPRF78305",4,31,54,-6,0,89,54,60,"Pilot 10","Pilot 10: bigger feedback + video"
31,"SUPPRF78305",3,28,55,2,1,89,54,53,"Pilot 10","Pilot 10: bigger feedback + video"
32,"SUPPRF78305",2,16,75,25,29,61,46,50,"Pilot 10","Pilot 10: bigger feedback + video"
33,"SUPPRF78305",11,32,96,27,16,89,80,69,"Pilot 10","Pilot 10: bigger feedback + video"
34,"SUPPRF78305",2,26,35,13,15,97,20,22,"Pilot 10","Pilot 10: bigger feedback + video"
35,"SUPPRF78305",8,33,81,-5,1,95,80,86,"Pilot 10","Pilot 10: bigger feedback + video"
36,"SUPPRF78305",1,24,67,-23,-13,90,80,90,"Pilot 10","Pilot 10: bigger feedback + video"
37,"SUPPRF78305",2,30,58,35,29,92,29,23,"Pilot 10","Pilot 10: bigger feedback + video"
38,"SUPPRF78305",1,24,70,8,-1,95,71,62,"Pilot 10","Pilot 10: bigger feedback + video"
39,"SUPPRF78305",0,30,41,-13,-13,82,54,54,"Pilot 10","Pilot 10: bigger feedback + video"
40,"SUPPRF78305",1,22,83,13,12,95,71,70,"Pilot 10","Pilot 10: bigger feedback + video"
41,"SUPPRF78305",0,23,16,-11,-13,77,29,27,"Pilot 10","Pilot 10: bigger feedback + video"
42,"SUPPRF78305",0,22,6,-10,-14,89,20,16,"Pilot 10","Pilot 10: bigger feedback + video"
43,"SUPPRF78305",7,26,94,26,23,87,71,68,"Pilot 10","Pilot 10: bigger feedback + video"
44,"SUPPRF78305",2,20,37,4,0,75,37,33,"Pilot 10","Pilot 10: bigger feedback + video"
45,"SUPPRF78305",0,24,56,-18,-15,93,71,74,"Pilot 10","Pilot 10: bigger feedback + video"
46,"SUPPRF78305",0,24,29,-8,0,82,29,37,"Pilot 10","Pilot 10: bigger feedback + video"
47,"SUPPRF78305",0,24,20,0,0,88,20,20,"Pilot 10","Pilot 10: bigger feedback + video"
48,"SUPPRF78305",0,22,47,15,-16,82,63,32,"Pilot 10","Pilot 10: bigger feedback + video"
1,"SUPPRF71639",49,76,49,-7,12,58,37,56,"Pilot 10","Pilot 10: bigger feedback + video"
2,"SUPPRF71639",61,70,77,0,14,65,63,77,"Pilot 10","Pilot 10: bigger feedback + video"
3,"SUPPRF71639",52,78,56,20,-15,69,71,36,"Pilot 10","Pilot 10: bigger feedback + video"
4,"SUPPRF71639",38,63,58,-28,29,74,29,86,"Pilot 10","Pilot 10: bigger feedback + video"
5,"SUPPRF71639",79,51,81,-8,1,64,80,89,"Pilot 10","Pilot 10: bigger feedback + video"
6,"SUPPRF71639",84,46,96,9,16,74,80,87,"Pilot 10","Pilot 10: bigger feedback + video"
7,"SUPPRF71639",87,43,80,-12,0,77,80,92,"Pilot 10","Pilot 10: bigger feedback + video"
8,"SUPPRF71639",69,50,24,-43,-13,62,37,67,"Pilot 10","Pilot 10: bigger feedback + video"
9,"SUPPRF71639",95,22,94,-1,23,91,71,95,"Pilot 10","Pilot 10: bigger feedback + video"
10,"SUPPRF71639",69,27,50,-35,-13,90,63,85,"Pilot 10","Pilot 10: bigger feedback + video"
11,"SUPPRF71639",58,22,58,-13,12,79,46,71,"Pilot 10","Pilot 10: bigger feedback + video"
12,"SUPPRF71639",62,14,62,-32,-1,49,63,94,"Pilot 10","Pilot 10: bigger feedback + video"
13,"SUPPRF71639",51,24,68,16,-12,39,80,52,"Pilot 10","Pilot 10: bigger feedback + video"
14,"SUPPRF71639",51,10,35,-39,15,64,20,74,"Pilot 10","Pilot 10: bigger feedback + video"
15,"SUPPRF71639",73,7,71,-3,0,39,71,74,"Pilot 10","Pilot 10: bigger feedback + video"
16,"SUPPRF71639",74,15,88,14,25,54,63,74,"Pilot 10","Pilot 10: bigger feedback + video"
17,"SUPPRF71639",58,21,63,-29,0,80,63,92,"Pilot 10","Pilot 10: bigger feedback + video"
18,"SUPPRF71639",72,3,78,34,24,27,54,44,"Pilot 10","Pilot 10: bigger feedback + video"
19,"SUPPRF71639",86,2,16,-54,-13,53,29,70,"Pilot 10","Pilot 10: bigger feedback + video"
20,"SUPPRF71639",94,7,75,-6,29,50,46,81,"Pilot 10","Pilot 10: bigger feedback + video"
21,"SUPPRF71639",77,5,29,-2,0,41,29,31,"Pilot 10","Pilot 10: bigger feedback + video"
22,"SUPPRF71639",60,10,41,-42,-13,51,54,83,"Pilot 10","Pilot 10: bigger feedback + video"
23,"SUPPRF71639",86,5,100,27,20,48,80,73,"Pilot 10","Pilot 10: bigger feedback + video"
24,"SUPPRF71639",99,8,6,-89,-14,55,20,95,"Pilot 10","Pilot 10: bigger feedback + video"
25,"SUPPRF71639",89,13,61,25,24,13,37,36,"Pilot 10","Pilot 10: bigger feedback + video"
26,"SUPPRF71639",74,6,33,21,-13,5,46,12,"Pilot 10","Pilot 10: bigger feedback + video"
27,"SUPPRF71639",88,1,8,-67,-12,28,20,75,"Pilot 10","Pilot 10: bigger feedback + video"
28,"SUPPRF71639",59,8,15,-63,-14,59,29,78,"Pilot 10","Pilot 10: bigger feedback + video"
29,"SUPPRF71639",52,10,38,-21,-16,17,54,59,"Pilot 10","Pilot 10: bigger feedback + video"
30,"SUPPRF71639",53,14,67,-12,-13,47,80,79,"Pilot 10","Pilot 10: bigger feedback + video"
31,"SUPPRF71639",54,9,45,-16,-1,14,46,61,"Pilot 10","Pilot 10: bigger feedback + video"
32,"SUPPRF71639",50,12,19,-49,-1,40,20,68,"Pilot 10","Pilot 10: bigger feedback + video"
33,"SUPPRF71639",50,10,34,-42,-12,65,46,76,"Pilot 10","Pilot 10: bigger feedback + video"
34,"SUPPRF71639",60,11,55,-2,1,69,54,57,"Pilot 10","Pilot 10: bigger feedback + video"
35,"SUPPRF71639",69,9,38,-7,1,57,37,45,"Pilot 10","Pilot 10: bigger feedback + video"
36,"SUPPRF71639",50,4,46,-8,0,38,46,54,"Pilot 10","Pilot 10: bigger feedback + video"
37,"SUPPRF71639",58,7,70,31,-1,60,71,39,"Pilot 10","Pilot 10: bigger feedback + video"
38,"SUPPRF71639",58,9,22,-15,-15,81,37,37,"Pilot 10","Pilot 10: bigger feedback + video"
39,"SUPPRF71639",54,6,28,-7,-1,53,29,35,"Pilot 10","Pilot 10: bigger feedback + video"
40,"SUPPRF71639",56,6,55,15,-16,63,71,40,"Pilot 10","Pilot 10: bigger feedback + video"
41,"SUPPRF71639",78,7,46,5,17,54,29,41,"Pilot 10","Pilot 10: bigger feedback + video"
42,"SUPPRF71639",59,4,37,-8,0,67,37,45,"Pilot 10","Pilot 10: bigger feedback + video"
43,"SUPPRF71639",82,5,54,-1,0,56,54,55,"Pilot 10","Pilot 10: bigger feedback + video"
44,"SUPPRF71639",55,24,20,-28,0,66,20,48,"Pilot 10","Pilot 10: bigger feedback + video"
45,"SUPPRF71639",56,14,47,-3,-16,19,63,50,"Pilot 10","Pilot 10: bigger feedback + video"
46,"SUPPRF71639",53,29,47,-10,27,31,20,57,"Pilot 10","Pilot 10: bigger feedback + video"
47,"SUPPRF71639",48,15,66,13,12,40,54,53,"Pilot 10","Pilot 10: bigger feedback + video"
48,"SUPPRF71639",50,22,83,27,12,39,71,56,"Pilot 10","Pilot 10: bigger feedback + video"
1,"SUPPRF56870",77,2,94,61,23,21,71,33,"Pilot 10","Pilot 10: bigger feedback + video"
2,"SUPPRF56870",72,0,46,6,17,12,29,40,"Pilot 10","Pilot 10: bigger feedback + video"
3,"SUPPRF56870",70,0,61,14,24,2,37,47,"Pilot 10","Pilot 10: bigger feedback + video"
4,"SUPPRF56870",87,0,34,-5,-12,50,46,39,"Pilot 10","Pilot 10: bigger feedback + video"
5,"SUPPRF56870",94,0,37,-5,0,65,37,42,"Pilot 10","Pilot 10: bigger feedback + video"
6,"SUPPRF56870",88,0,70,-12,-1,82,71,82,"Pilot 10","Pilot 10: bigger feedback + video"
7,"SUPPRF56870",96,0,47,9,27,24,20,38,"Pilot 10","Pilot 10: bigger feedback + video"
8,"SUPPRF56870",82,0,58,-18,12,6,46,76,"Pilot 10","Pilot 10: bigger feedback + video"
9,"SUPPRF56870",100,0,28,-23,-1,47,29,51,"Pilot 10","Pilot 10: bigger feedback + video"
10,"SUPPRF56870",100,0,49,7,12,66,37,42,"Pilot 10","Pilot 10: bigger feedback + video"
11,"SUPPRF56870",100,0,38,-13,1,72,37,51,"Pilot 10","Pilot 10: bigger feedback + video"
12,"SUPPRF56870",100,0,63,-27,0,43,63,90,"Pilot 10","Pilot 10: bigger feedback + video"
13,"SUPPRF56870",100,0,15,-32,-14,20,29,47,"Pilot 10","Pilot 10: bigger feedback + video"
14,"SUPPRF56870",100,0,54,-23,0,54,54,77,"Pilot 10","Pilot 10: bigger feedback + video"
15,"SUPPRF56870",100,0,62,-21,-1,22,63,83,"Pilot 10","Pilot 10: bigger feedback + video"
16,"SUPPRF56870",100,0,67,-25,-13,33,80,92,"Pilot 10","Pilot 10: bigger feedback + video"
17,"SUPPRF56870",100,0,78,54,24,50,54,24,"Pilot 10","Pilot 10: bigger feedback + video"
18,"SUPPRF56870",100,0,45,15,-1,14,46,30,"Pilot 10","Pilot 10: bigger feedback + video"
19,"SUPPRF56870",100,0,80,-10,0,90,80,90,"Pilot 10","Pilot 10: bigger feedback + video"
20,"SUPPRF56870",100,0,56,8,-15,46,71,48,"Pilot 10","Pilot 10: bigger feedback + video"
21,"SUPPRF56870",100,0,19,-65,-1,18,20,84,"Pilot 10","Pilot 10: bigger feedback + video"
22,"SUPPRF56870",100,0,88,-6,25,5,63,94,"Pilot 10","Pilot 10: bigger feedback + video"
23,"SUPPRF56870",100,0,22,12,-15,4,37,10,"Pilot 10","Pilot 10: bigger feedback + video"
24,"SUPPRF56870",100,0,96,74,16,15,80,22,"Pilot 10","Pilot 10: bigger feedback + video"
25,"SUPPRF56870",100,0,6,-24,-14,50,20,30,"Pilot 10","Pilot 10: bigger feedback + video"
26,"SUPPRF56870",100,0,38,-2,-16,0,54,40,"Pilot 10","Pilot 10: bigger feedback + video"
27,"SUPPRF56870",100,0,8,-58,-12,3,20,66,"Pilot 10","Pilot 10: bigger feedback + video"
28,"SUPPRF56870",100,0,20,9,0,75,20,11,"Pilot 10","Pilot 10: bigger feedback + video"
29,"SUPPRF56870",100,0,24,-29,-13,18,37,53,"Pilot 10","Pilot 10: bigger feedback + video"
30,"SUPPRF56870",100,0,75,5,29,100,46,70,"Pilot 10","Pilot 10: bigger feedback + video"
31,"SUPPRF56870",100,0,16,-38,-13,34,29,54,"Pilot 10","Pilot 10: bigger feedback + video"
32,"SUPPRF56870",100,0,47,29,-16,15,63,18,"Pilot 10","Pilot 10: bigger feedback + video"
33,"SUPPRF56870",100,0,81,-19,1,0,80,100,"Pilot 10","Pilot 10: bigger feedback + video"
34,"SUPPRF56870",100,0,66,58,12,0,54,8,"Pilot 10","Pilot 10: bigger feedback + video"
35,"SUPPRF56870",98,0,55,-9,1,1,54,64,"Pilot 10","Pilot 10: bigger feedback + video"
36,"SUPPRF56870",100,0,41,-47,-13,0,54,88,"Pilot 10","Pilot 10: bigger feedback + video"
37,"SUPPRF56870",94,0,68,-32,-12,0,80,100,"Pilot 10","Pilot 10: bigger feedback + video"
38,"SUPPRF56870",100,8,77,-5,14,0,63,82,"Pilot 10","Pilot 10: bigger feedback + video"
39,"SUPPRF56870",100,9,58,53,29,0,29,5,"Pilot 10","Pilot 10: bigger feedback + video"
40,"SUPPRF56870",100,0,100,3,20,16,80,97,"Pilot 10","Pilot 10: bigger feedback + video"
41,"SUPPRF56870",100,0,50,-27,-13,6,63,77,"Pilot 10","Pilot 10: bigger feedback + video"
42,"SUPPRF56870",100,0,83,2,12,0,71,81,"Pilot 10","Pilot 10: bigger feedback + video"
43,"SUPPRF56870",100,0,71,-10,0,0,71,81,"Pilot 10","Pilot 10: bigger feedback + video"
44,"SUPPRF56870",100,0,55,20,-16,0,71,35,"Pilot 10","Pilot 10: bigger feedback + video"
45,"SUPPRF56870",100,0,46,-50,0,1,46,96,"Pilot 10","Pilot 10: bigger feedback + video"
46,"SUPPRF56870",100,0,29,-63,0,93,29,92,"Pilot 10","Pilot 10: bigger feedback + video"
47,"SUPPRF56870",100,0,35,25,15,77,20,10,"Pilot 10","Pilot 10: bigger feedback + video"
48,"SUPPRF56870",100,0,33,-23,-13,0,46,56,"Pilot 10","Pilot 10: bigger feedback + video"
1,"SUPPRF86502",57,17,63,-6,0,53,63,69,"Pilot 10","Pilot 10: bigger feedback + video"
2,"SUPPRF86502",61,14,58,29,29,73,29,29,"Pilot 10","Pilot 10: bigger feedback + video"
3,"SUPPRF86502",63,27,83,26,12,17,71,57,"Pilot 10","Pilot 10: bigger feedback + video"
4,"SUPPRF86502",62,4,70,11,-1,36,71,59,"Pilot 10","Pilot 10: bigger feedback + video"
5,"SUPPRF86502",71,19,47,-12,-16,13,63,59,"Pilot 10","Pilot 10: bigger feedback + video"
6,"SUPPRF86502",65,16,78,21,24,31,54,57,"Pilot 10","Pilot 10: bigger feedback + video"
7,"SUPPRF86502",61,23,41,-16,-13,50,54,57,"Pilot 10","Pilot 10: bigger feedback + video"
8,"SUPPRF86502",74,23,67,-2,-13,20,80,69,"Pilot 10","Pilot 10: bigger feedback + video"
9,"SUPPRF86502",72,20,16,-38,-13,59,29,54,"Pilot 10","Pilot 10: bigger feedback + video"
10,"SUPPRF86502",67,9,81,2,1,66,80,79,"Pilot 10","Pilot 10: bigger feedback + video"
11,"SUPPRF86502",79,12,46,7,0,28,46,39,"Pilot 10","Pilot 10: bigger feedback + video"
12,"SUPPRF86502",73,17,58,12,12,29,46,46,"Pilot 10","Pilot 10: bigger feedback + video"
13,"SUPPRF86502",84,16,45,-11,-1,78,46,56,"Pilot 10","Pilot 10: bigger feedback + video"
14,"SUPPRF86502",47,19,61,28,24,55,37,33,"Pilot 10","Pilot 10: bigger feedback + video"
15,"SUPPRF86502",72,13,38,9,1,74,37,29,"Pilot 10","Pilot 10: bigger feedback + video"
16,"SUPPRF86502",62,12,94,51,23,59,71,43,"Pilot 10","Pilot 10: bigger feedback + video"
17,"SUPPRF86502",54,24,37,1,0,85,37,36,"Pilot 10","Pilot 10: bigger feedback + video"
18,"SUPPRF86502",59,16,29,-2,0,37,29,31,"Pilot 10","Pilot 10: bigger feedback + video"
19,"SUPPRF86502",13,10,56,22,-15,36,71,34,"Pilot 10","Pilot 10: bigger feedback + video"
20,"SUPPRF86502",21,18,66,23,12,37,54,43,"Pilot 10","Pilot 10: bigger feedback + video"
21,"SUPPRF86502",73,25,38,-13,-16,11,54,51,"Pilot 10","Pilot 10: bigger feedback + video"
22,"SUPPRF86502",8,16,33,-13,-13,39,46,46,"Pilot 10","Pilot 10: bigger feedback + video"
23,"SUPPRF86502",1,57,100,50,20,32,80,50,"Pilot 10","Pilot 10: bigger feedback + video"
24,"SUPPRF86502",0,5,24,-2,-13,24,37,26,"Pilot 10","Pilot 10: bigger feedback + video"
25,"SUPPRF86502",0,10,8,-41,-12,24,20,49,"Pilot 10","Pilot 10: bigger feedback + video"
26,"SUPPRF86502",0,94,71,34,0,16,71,37,"Pilot 10","Pilot 10: bigger feedback + video"
27,"SUPPRF86502",0,15,55,1,1,14,54,54,"Pilot 10","Pilot 10: bigger feedback + video"
28,"SUPPRF86502",0,12,75,36,29,38,46,39,"Pilot 10","Pilot 10: bigger feedback + video"
29,"SUPPRF86502",1,7,62,-4,-1,62,63,66,"Pilot 10","Pilot 10: bigger feedback + video"
30,"SUPPRF86502",0,5,6,-21,-14,19,20,27,"Pilot 10","Pilot 10: bigger feedback + video"
31,"SUPPRF86502",0,8,22,-2,-15,56,37,24,"Pilot 10","Pilot 10: bigger feedback + video"
32,"SUPPRF86502",1,5,28,-3,-1,19,29,31,"Pilot 10","Pilot 10: bigger feedback + video"
33,"SUPPRF86502",0,7,19,-11,-1,22,20,30,"Pilot 10","Pilot 10: bigger feedback + video"
34,"SUPPRF86502",0,7,55,23,-16,12,71,32,"Pilot 10","Pilot 10: bigger feedback + video"
35,"SUPPRF86502",13,4,34,2,-12,11,46,32,"Pilot 10","Pilot 10: bigger feedback + video"
36,"SUPPRF86502",1,4,49,17,12,17,37,32,"Pilot 10","Pilot 10: bigger feedback + video"
37,"SUPPRF86502",0,4,68,34,-12,9,80,34,"Pilot 10","Pilot 10: bigger feedback + video"
38,"SUPPRF86502",1,5,35,15,15,22,20,20,"Pilot 10","Pilot 10: bigger feedback + video"
39,"SUPPRF86502",7,5,50,-6,-13,4,63,56,"Pilot 10","Pilot 10: bigger feedback + video"
40,"SUPPRF86502",0,6,46,27,17,9,29,19,"Pilot 10","Pilot 10: bigger feedback + video"
41,"SUPPRF86502",12,6,47,0,27,32,20,47,"Pilot 10","Pilot 10: bigger feedback + video"
42,"SUPPRF86502",8,6,15,-14,-14,11,29,29,"Pilot 10","Pilot 10: bigger feedback + video"
43,"SUPPRF86502",0,6,20,-10,0,15,20,30,"Pilot 10","Pilot 10: bigger feedback + video"
44,"SUPPRF86502",9,9,54,25,0,28,54,29,"Pilot 10","Pilot 10: bigger feedback + video"
45,"SUPPRF86502",3,4,96,68,16,9,80,28,"Pilot 10","Pilot 10: bigger feedback + video"
46,"SUPPRF86502",3,0,88,52,25,6,63,36,"Pilot 10","Pilot 10: bigger feedback + video"
47,"SUPPRF86502",0,3,77,54,14,5,63,23,"Pilot 10","Pilot 10: bigger feedback + video"
48,"SUPPRF86502",1,3,80,63,0,8,80,17,"Pilot 10","Pilot 10: bigger feedback + video"
1,"SUPPRF12592",72,20,80,17,0,62,80,63,"Pilot 10","Pilot 10: bigger feedback + video"
2,"SUPPRF12592",61,27,77,25,14,64,63,52,"Pilot 10","Pilot 10: bigger feedback + video"
3,"SUPPRF12592",89,12,96,16,16,62,80,80,"Pilot 10","Pilot 10: bigger feedback + video"
4,"SUPPRF12592",81,16,33,-20,-13,45,46,53,"Pilot 10","Pilot 10: bigger feedback + video"
5,"SUPPRF12592",93,4,88,32,25,24,63,56,"Pilot 10","Pilot 10: bigger feedback + video"
6,"SUPPRF12592",89,5,68,-15,-12,81,80,83,"Pilot 10","Pilot 10: bigger feedback + video"
7,"SUPPRF12592",84,7,38,16,1,35,37,22,"Pilot 10","Pilot 10: bigger feedback + video"
8,"SUPPRF12592",91,7,78,11,24,65,54,67,"Pilot 10","Pilot 10: bigger feedback + video"
9,"SUPPRF12592",98,2,100,43,20,28,80,57,"Pilot 10","Pilot 10: bigger feedback + video"
10,"SUPPRF12592",94,6,71,10,0,62,71,61,"Pilot 10","Pilot 10: bigger feedback + video"
11,"SUPPRF12592",96,1,58,15,29,24,29,43,"Pilot 10","Pilot 10: bigger feedback + video"
12,"SUPPRF12592",94,4,56,-10,-15,78,71,66,"Pilot 10","Pilot 10: bigger feedback + video"
13,"SUPPRF12592",99,2,83,17,12,86,71,66,"Pilot 10","Pilot 10: bigger feedback + video"
14,"SUPPRF12592",90,5,22,-14,-15,8,37,36,"Pilot 10","Pilot 10: bigger feedback + video"
15,"SUPPRF12592",94,3,63,13,0,31,63,50,"Pilot 10","Pilot 10: bigger feedback + video"
16,"SUPPRF12592",95,3,15,-40,-14,73,29,55,"Pilot 10","Pilot 10: bigger feedback + video"
17,"SUPPRF12592",92,3,47,16,-16,19,63,31,"Pilot 10","Pilot 10: bigger feedback + video"
18,"SUPPRF12592",79,3,19,-42,-1,32,20,61,"Pilot 10","Pilot 10: bigger feedback + video"
19,"SUPPRF12592",90,1,20,-2,0,93,20,22,"Pilot 10","Pilot 10: bigger feedback + video"
20,"SUPPRF12592",90,3,24,-13,-13,12,37,37,"Pilot 10","Pilot 10: bigger feedback + video"
21,"SUPPRF12592",84,0,81,-12,1,92,80,93,"Pilot 10","Pilot 10: bigger feedback + video"
22,"SUPPRF12592",69,1,8,-8,-12,90,20,16,"Pilot 10","Pilot 10: bigger feedback + video"
23,"SUPPRF12592",72,5,28,-34,-1,32,29,62,"Pilot 10","Pilot 10: bigger feedback + video"
24,"SUPPRF12592",97,0,61,39,24,82,37,22,"Pilot 10","Pilot 10: bigger feedback + video"
25,"SUPPRF12592",88,4,75,14,29,60,46,61,"Pilot 10","Pilot 10: bigger feedback + video"
26,"SUPPRF12592",90,2,46,-1,0,80,46,47,"Pilot 10","Pilot 10: bigger feedback + video"
27,"SUPPRF12592",94,1,35,-2,15,81,20,37,"Pilot 10","Pilot 10: bigger feedback + video"
28,"SUPPRF12592",95,0,66,-11,12,73,54,77,"Pilot 10","Pilot 10: bigger feedback + video"
29,"SUPPRF12592",83,3,16,-22,-13,36,29,38,"Pilot 10","Pilot 10: bigger feedback + video"
30,"SUPPRF12592",87,3,70,-1,-1,76,71,71,"Pilot 10","Pilot 10: bigger feedback + video"
31,"SUPPRF12592",95,2,62,24,-1,17,63,38,"Pilot 10","Pilot 10: bigger feedback + video"
32,"SUPPRF12592",93,1,55,-21,-16,85,71,76,"Pilot 10","Pilot 10: bigger feedback + video"
33,"SUPPRF12592",93,2,37,-18,0,40,37,55,"Pilot 10","Pilot 10: bigger feedback + video"
34,"SUPPRF12592",95,1,47,20,27,80,20,27,"Pilot 10","Pilot 10: bigger feedback + video"
35,"SUPPRF12592",94,3,29,-27,0,60,29,56,"Pilot 10","Pilot 10: bigger feedback + video"
36,"SUPPRF12592",88,3,38,-10,-16,71,54,48,"Pilot 10","Pilot 10: bigger feedback + video"
37,"SUPPRF12592",100,0,94,44,23,34,71,50,"Pilot 10","Pilot 10: bigger feedback + video"
38,"SUPPRF12592",87,0,50,-5,-13,21,63,55,"Pilot 10","Pilot 10: bigger feedback + video"
39,"SUPPRF12592",86,0,45,-16,-1,35,46,61,"Pilot 10","Pilot 10: bigger feedback + video"
40,"SUPPRF12592",80,0,55,-10,1,84,54,65,"Pilot 10","Pilot 10: bigger feedback + video"
41,"SUPPRF12592",75,2,46,14,17,80,29,32,"Pilot 10","Pilot 10: bigger feedback + video"
42,"SUPPRF12592",73,0,49,11,12,65,37,38,"Pilot 10","Pilot 10: bigger feedback + video"
43,"SUPPRF12592",75,6,58,16,12,73,46,42,"Pilot 10","Pilot 10: bigger feedback + video"
44,"SUPPRF12592",75,4,34,-15,-12,71,46,49,"Pilot 10","Pilot 10: bigger feedback + video"
45,"SUPPRF12592",84,0,6,-26,-14,82,20,32,"Pilot 10","Pilot 10: bigger feedback + video"
46,"SUPPRF12592",88,0,41,-9,-13,75,54,50,"Pilot 10","Pilot 10: bigger feedback + video"
47,"SUPPRF12592",75,5,54,9,0,65,54,45,"Pilot 10","Pilot 10: bigger feedback + video"
48,"SUPPRF12592",80,0,67,-10,-13,74,80,77,"Pilot 10","Pilot 10: bigger feedback + video"
1,"SUPPRF53463",99,2,6,-14,-14,1,20,20,"Pilot 10","Pilot 10: bigger feedback + video"
2,"SUPPRF53463",99,1,96,16,16,1,80,80,"Pilot 10","Pilot 10: bigger feedback + video"
3,"SUPPRF53463",98,1,81,13,1,1,80,68,"Pilot 10","Pilot 10: bigger feedback + video"
4,"SUPPRF53463",98,1,94,24,23,0,71,70,"Pilot 10","Pilot 10: bigger feedback + video"
5,"SUPPRF53463",99,0,56,-26,-15,1,71,82,"Pilot 10","Pilot 10: bigger feedback + video"
6,"SUPPRF53463",99,0,15,-10,-14,0,29,25,"Pilot 10","Pilot 10: bigger feedback + video"
7,"SUPPRF53463",98,1,83,61,12,1,71,22,"Pilot 10","Pilot 10: bigger feedback + video"
8,"SUPPRF53463",99,0,8,-9,-12,1,20,17,"Pilot 10","Pilot 10: bigger feedback + video"
9,"SUPPRF53463",99,1,22,-9,-15,1,37,31,"Pilot 10","Pilot 10: bigger feedback + video"
10,"SUPPRF53463",98,2,20,1,0,1,20,19,"Pilot 10","Pilot 10: bigger feedback + video"
11,"SUPPRF53463",99,1,71,4,0,1,71,67,"Pilot 10","Pilot 10: bigger feedback + video"
12,"SUPPRF53463",98,1,63,-13,0,1,63,76,"Pilot 10","Pilot 10: bigger feedback + video"
13,"SUPPRF53463",99,0,47,27,27,3,20,20,"Pilot 10","Pilot 10: bigger feedback + video"
14,"SUPPRF53463",100,0,29,9,0,0,29,20,"Pilot 10","Pilot 10: bigger feedback + video"
15,"SUPPRF53463",98,1,80,15,0,1,80,65,"Pilot 10","Pilot 10: bigger feedback + video"
16,"SUPPRF53463",98,1,47,-20,-16,2,63,67,"Pilot 10","Pilot 10: bigger feedback + video"
17,"SUPPRF53463",98,1,37,9,0,3,37,28,"Pilot 10","Pilot 10: bigger feedback + video"
18,"SUPPRF53463",98,1,35,15,15,5,20,20,"Pilot 10","Pilot 10: bigger feedback + video"
19,"SUPPRF53463",98,1,78,20,24,6,54,58,"Pilot 10","Pilot 10: bigger feedback + video"
20,"SUPPRF53463",98,1,66,9,12,6,54,57,"Pilot 10","Pilot 10: bigger feedback + video"
21,"SUPPRF53463",99,1,88,29,25,5,63,59,"Pilot 10","Pilot 10: bigger feedback + video"
22,"SUPPRF53463",99,1,62,-9,-1,9,63,71,"Pilot 10","Pilot 10: bigger feedback + video"
23,"SUPPRF53463",97,0,61,18,24,7,37,43,"Pilot 10","Pilot 10: bigger feedback + video"
24,"SUPPRF53463",99,1,50,-19,-13,6,63,69,"Pilot 10","Pilot 10: bigger feedback + video"
25,"SUPPRF53463",98,1,45,-2,-1,5,46,47,"Pilot 10","Pilot 10: bigger feedback + video"
26,"SUPPRF53463",98,0,28,-2,-1,5,29,30,"Pilot 10","Pilot 10: bigger feedback + video"
27,"SUPPRF53463",99,1,46,20,17,6,29,26,"Pilot 10","Pilot 10: bigger feedback + video"
28,"SUPPRF53463",99,1,38,-18,-16,5,54,56,"Pilot 10","Pilot 10: bigger feedback + video"
29,"SUPPRF53463",99,1,16,-10,-13,4,29,26,"Pilot 10","Pilot 10: bigger feedback + video"
30,"SUPPRF53463",99,1,55,0,1,8,54,55,"Pilot 10","Pilot 10: bigger feedback + video"
31,"SUPPRF53463",99,0,49,1,12,5,37,48,"Pilot 10","Pilot 10: bigger feedback + video"
32,"SUPPRF53463",98,1,54,-1,0,8,54,55,"Pilot 10","Pilot 10: bigger feedback + video"
33,"SUPPRF53463",98,0,34,-11,-12,9,46,45,"Pilot 10","Pilot 10: bigger feedback + video"
34,"SUPPRF53463",99,1,100,20,20,7,80,80,"Pilot 10","Pilot 10: bigger feedback + video"
35,"SUPPRF53463",99,0,75,32,29,6,46,43,"Pilot 10","Pilot 10: bigger feedback + video"
36,"SUPPRF53463",99,1,58,28,29,6,29,30,"Pilot 10","Pilot 10: bigger feedback + video"
37,"SUPPRF53463",98,1,19,0,-1,8,20,19,"Pilot 10","Pilot 10: bigger feedback + video"
38,"SUPPRF53463",98,0,33,-15,-13,12,46,48,"Pilot 10","Pilot 10: bigger feedback + video"
39,"SUPPRF53463",99,2,24,-16,-13,8,37,40,"Pilot 10","Pilot 10: bigger feedback + video"
40,"SUPPRF53463",100,1,67,-16,-13,10,80,83,"Pilot 10","Pilot 10: bigger feedback + video"
41,"SUPPRF53463",98,2,41,-13,-13,11,54,54,"Pilot 10","Pilot 10: bigger feedback + video"
42,"SUPPRF53463",98,1,38,0,1,8,37,38,"Pilot 10","Pilot 10: bigger feedback + video"
43,"SUPPRF53463",98,0,70,0,-1,9,71,70,"Pilot 10","Pilot 10: bigger feedback + video"
44,"SUPPRF53463",99,1,68,-15,-12,8,80,83,"Pilot 10","Pilot 10: bigger feedback + video"
45,"SUPPRF53463",99,0,46,3,0,7,46,43,"Pilot 10","Pilot 10: bigger feedback + video"
46,"SUPPRF53463",98,2,55,-17,-16,11,71,72,"Pilot 10","Pilot 10: bigger feedback + video"
47,"SUPPRF53463",98,0,77,11,14,8,63,66,"Pilot 10","Pilot 10: bigger feedback + video"
48,"SUPPRF53463",99,2,58,-7,12,10,46,65,"Pilot 10","Pilot 10: bigger feedback + video"
1,"SUPPRF17225",65,13,61,19,24,66,37,42,"Pilot 10","Pilot 10: bigger feedback + video"
2,"SUPPRF17225",73,7,80,-8,0,76,80,88,"Pilot 10","Pilot 10: bigger feedback + video"
3,"SUPPRF17225",80,11,77,12,14,54,63,65,"Pilot 10","Pilot 10: bigger feedback + video"
4,"SUPPRF17225",84,10,56,-17,-15,65,71,73,"Pilot 10","Pilot 10: bigger feedback + video"
5,"SUPPRF17225",80,8,37,5,0,76,37,32,"Pilot 10","Pilot 10: bigger feedback + video"
6,"SUPPRF17225",86,5,55,-28,-16,71,71,83,"Pilot 10","Pilot 10: bigger feedback + video"
7,"SUPPRF17225",84,7,46,6,17,55,29,40,"Pilot 10","Pilot 10: bigger feedback + video"
8,"SUPPRF17225",86,5,63,-8,0,51,63,71,"Pilot 10","Pilot 10: bigger feedback + video"
9,"SUPPRF17225",86,5,50,-4,-13,50,63,54,"Pilot 10","Pilot 10: bigger feedback + video"
10,"SUPPRF17225",89,8,83,5,12,55,71,78,"Pilot 10","Pilot 10: bigger feedback + video"
11,"SUPPRF17225",89,11,96,9,16,54,80,87,"Pilot 10","Pilot 10: bigger feedback + video"
12,"SUPPRF17225",90,7,15,-13,-14,52,29,28,"Pilot 10","Pilot 10: bigger feedback + video"
13,"SUPPRF17225",78,18,46,-6,0,54,46,52,"Pilot 10","Pilot 10: bigger feedback + video"
14,"SUPPRF17225",82,18,54,10,0,52,54,44,"Pilot 10","Pilot 10: bigger feedback + video"
15,"SUPPRF17225",84,18,29,7,0,50,29,22,"Pilot 10","Pilot 10: bigger feedback + video"
16,"SUPPRF17225",92,8,24,-20,-13,52,37,44,"Pilot 10","Pilot 10: bigger feedback + video"
17,"SUPPRF17225",76,18,58,28,29,31,29,30,"Pilot 10","Pilot 10: bigger feedback + video"
18,"SUPPRF17225",84,19,22,-14,-15,35,37,36,"Pilot 10","Pilot 10: bigger feedback + video"
19,"SUPPRF17225",80,26,70,25,-1,30,71,45,"Pilot 10","Pilot 10: bigger feedback + video"
20,"SUPPRF17225",81,21,33,-14,-13,37,46,47,"Pilot 10","Pilot 10: bigger feedback + video"
21,"SUPPRF17225",86,16,58,22,12,31,46,36,"Pilot 10","Pilot 10: bigger feedback + video"
22,"SUPPRF17225",86,16,6,-17,-14,25,20,23,"Pilot 10","Pilot 10: bigger feedback + video"
23,"SUPPRF17225",85,19,75,26,29,25,46,49,"Pilot 10","Pilot 10: bigger feedback + video"
24,"SUPPRF17225",87,17,67,-15,-13,21,80,82,"Pilot 10","Pilot 10: bigger feedback + video"
25,"SUPPRF17225",84,16,62,0,-1,23,63,62,"Pilot 10","Pilot 10: bigger feedback + video"
26,"SUPPRF17225",87,18,47,-5,-16,23,63,52,"Pilot 10","Pilot 10: bigger feedback + video"
27,"SUPPRF17225",88,13,100,23,20,20,80,77,"Pilot 10","Pilot 10: bigger feedback + video"
28,"SUPPRF17225",90,16,49,14,12,20,37,35,"Pilot 10","Pilot 10: bigger feedback + video"
29,"SUPPRF17225",87,12,78,21,24,23,54,57,"Pilot 10","Pilot 10: bigger feedback + video"
30,"SUPPRF17225",89,17,19,-7,-1,19,20,26,"Pilot 10","Pilot 10: bigger feedback + video"
31,"SUPPRF17225",87,13,38,-3,1,23,37,41,"Pilot 10","Pilot 10: bigger feedback + video"
32,"SUPPRF17225",87,16,16,-16,-13,19,29,32,"Pilot 10","Pilot 10: bigger feedback + video"
33,"SUPPRF17225",86,12,68,-13,-12,11,80,81,"Pilot 10","Pilot 10: bigger feedback + video"
34,"SUPPRF17225",77,34,45,9,-1,15,46,36,"Pilot 10","Pilot 10: bigger feedback + video"
35,"SUPPRF17225",66,23,28,-4,-1,18,29,32,"Pilot 10","Pilot 10: bigger feedback + video"
36,"SUPPRF17225",69,34,66,14,12,19,54,52,"Pilot 10","Pilot 10: bigger feedback + video"
37,"SUPPRF17225",81,36,34,-15,-12,19,46,49,"Pilot 10","Pilot 10: bigger feedback + video"
38,"SUPPRF17225",75,28,20,-13,0,29,20,33,"Pilot 10","Pilot 10: bigger feedback + video"
39,"SUPPRF17225",76,31,55,-1,1,16,54,56,"Pilot 10","Pilot 10: bigger feedback + video"
40,"SUPPRF17225",69,34,38,-21,-16,15,54,59,"Pilot 10","Pilot 10: bigger feedback + video"
41,"SUPPRF17225",68,28,71,25,0,23,71,46,"Pilot 10","Pilot 10: bigger feedback + video"
42,"SUPPRF17225",69,31,81,-5,1,16,80,86,"Pilot 10","Pilot 10: bigger feedback + video"
43,"SUPPRF17225",60,47,35,12,15,13,20,23,"Pilot 10","Pilot 10: bigger feedback + video"
44,"SUPPRF17225",63,21,88,30,25,13,63,58,"Pilot 10","Pilot 10: bigger feedback + video"
45,"SUPPRF17225",71,32,94,11,23,15,71,83,"Pilot 10","Pilot 10: bigger feedback + video"
46,"SUPPRF17225",84,28,8,-29,-12,15,20,37,"Pilot 10","Pilot 10: bigger feedback + video"
47,"SUPPRF17225",83,21,41,-21,-13,18,54,62,"Pilot 10","Pilot 10: bigger feedback + video"
48,"SUPPRF17225",85,14,47,26,27,16,20,21,"Pilot 10","Pilot 10: bigger feedback + video"
1,"SUPPRF34408",1,100,66,56,12,14,54,10,"Pilot 10","Pilot 10: bigger feedback + video"
2,"SUPPRF34408",1,99,75,58,29,61,46,17,"Pilot 10","Pilot 10: bigger feedback + video"
3,"SUPPRF34408",2,98,41,9,-13,60,54,32,"Pilot 10","Pilot 10: bigger feedback + video"
4,"SUPPRF34408",1,98,100,81,20,19,80,19,"Pilot 10","Pilot 10: bigger feedback + video"
5,"SUPPRF34408",3,97,70,56,-1,21,71,14,"Pilot 10","Pilot 10: bigger feedback + video"
6,"SUPPRF34408",2,97,33,18,-13,18,46,15,"Pilot 10","Pilot 10: bigger feedback + video"
7,"SUPPRF34408",0,99,38,23,-16,22,54,15,"Pilot 10","Pilot 10: bigger feedback + video"
8,"SUPPRF34408",0,100,35,19,15,15,20,16,"Pilot 10","Pilot 10: bigger feedback + video"
9,"SUPPRF34408",2,98,71,61,0,18,71,10,"Pilot 10","Pilot 10: bigger feedback + video"
10,"SUPPRF34408",1,99,61,40,24,22,37,21,"Pilot 10","Pilot 10: bigger feedback + video"
11,"SUPPRF34408",2,99,47,32,27,22,20,15,"Pilot 10","Pilot 10: bigger feedback + video"
12,"SUPPRF34408",1,99,55,35,1,9,54,20,"Pilot 10","Pilot 10: bigger feedback + video"
13,"SUPPRF34408",1,99,34,20,-12,19,46,14,"Pilot 10","Pilot 10: bigger feedback + video"
14,"SUPPRF34408",2,99,49,34,12,15,37,15,"Pilot 10","Pilot 10: bigger feedback + video"
15,"SUPPRF34408",0,99,45,24,-1,16,46,21,"Pilot 10","Pilot 10: bigger feedback + video"
16,"SUPPRF34408",2,98,19,8,-1,26,20,11,"Pilot 10","Pilot 10: bigger feedback + video"
17,"SUPPRF34408",1,99,29,8,0,25,29,21,"Pilot 10","Pilot 10: bigger feedback + video"
18,"SUPPRF34408",0,99,24,11,-13,17,37,13,"Pilot 10","Pilot 10: bigger feedback + video"
19,"SUPPRF34408",1,100,6,-20,-14,17,20,26,"Pilot 10","Pilot 10: bigger feedback + video"
20,"SUPPRF34408",1,100,20,7,0,18,20,13,"Pilot 10","Pilot 10: bigger feedback + video"
21,"SUPPRF34408",2,99,22,9,-15,14,37,13,"Pilot 10","Pilot 10: bigger feedback + video"
22,"SUPPRF34408",3,97,81,67,1,19,80,14,"Pilot 10","Pilot 10: bigger feedback + video"
23,"SUPPRF34408",2,99,83,73,12,16,71,10,"Pilot 10","Pilot 10: bigger feedback + video"
24,"SUPPRF34408",1,99,68,56,-12,11,80,12,"Pilot 10","Pilot 10: bigger feedback + video"
25,"SUPPRF34408",1,98,88,78,25,23,63,10,"Pilot 10","Pilot 10: bigger feedback + video"
26,"SUPPRF34408",2,99,67,56,-13,14,80,11,"Pilot 10","Pilot 10: bigger feedback + video"
27,"SUPPRF34408",4,89,94,82,23,16,71,12,"Pilot 10","Pilot 10: bigger feedback + video"
28,"SUPPRF34408",0,99,28,25,-1,29,29,3,"Pilot 10","Pilot 10: bigger feedback + video"
29,"SUPPRF34408",2,99,15,4,-14,9,29,11,"Pilot 10","Pilot 10: bigger feedback + video"
30,"SUPPRF34408",1,99,58,45,29,18,29,13,"Pilot 10","Pilot 10: bigger feedback + video"
31,"SUPPRF34408",19,99,37,21,0,20,37,16,"Pilot 10","Pilot 10: bigger feedback + video"
32,"SUPPRF34408",1,99,55,45,-16,19,71,10,"Pilot 10","Pilot 10: bigger feedback + video"
33,"SUPPRF34408",1,99,54,43,0,23,54,11,"Pilot 10","Pilot 10: bigger feedback + video"
34,"SUPPRF34408",0,99,38,24,1,20,37,14,"Pilot 10","Pilot 10: bigger feedback + video"
35,"SUPPRF34408",3,100,16,-2,-13,19,29,18,"Pilot 10","Pilot 10: bigger feedback + video"
36,"SUPPRF34408",2,99,46,32,0,12,46,14,"Pilot 10","Pilot 10: bigger feedback + video"
37,"SUPPRF34408",1,99,80,69,0,28,80,11,"Pilot 10","Pilot 10: bigger feedback + video"
38,"SUPPRF34408",2,97,77,54,14,25,63,23,"Pilot 10","Pilot 10: bigger feedback + video"
39,"SUPPRF34408",2,99,8,-12,-12,29,20,20,"Pilot 10","Pilot 10: bigger feedback + video"
40,"SUPPRF34408",2,99,78,53,24,26,54,25,"Pilot 10","Pilot 10: bigger feedback + video"
41,"SUPPRF34408",1,98,63,41,0,10,63,22,"Pilot 10","Pilot 10: bigger feedback + video"
42,"SUPPRF34408",2,98,50,24,-13,36,63,26,"Pilot 10","Pilot 10: bigger feedback + video"
43,"SUPPRF34408",2,100,56,38,-15,21,71,18,"Pilot 10","Pilot 10: bigger feedback + video"
44,"SUPPRF34408",1,99,96,68,16,31,80,28,"Pilot 10","Pilot 10: bigger feedback + video"
45,"SUPPRF34408",3,98,46,23,17,20,29,23,"Pilot 10","Pilot 10: bigger feedback + video"
46,"SUPPRF34408",1,100,47,25,-16,17,63,22,"Pilot 10","Pilot 10: bigger feedback + video"
47,"SUPPRF34408",1,98,58,41,12,38,46,17,"Pilot 10","Pilot 10: bigger feedback + video"
48,"SUPPRF34408",2,99,62,39,-1,32,63,23,"Pilot 10","Pilot 10: bigger feedback + video"
1,"SUPPRF78865",45,70,15,-12,-14,55,29,27,"Pilot 10","Pilot 10: bigger feedback + video"
2,"SUPPRF78865",41,70,80,7,0,43,80,73,"Pilot 10","Pilot 10: bigger feedback + video"
3,"SUPPRF78865",46,67,49,19,12,38,37,30,"Pilot 10","Pilot 10: bigger feedback + video"
4,"SUPPRF78865",35,69,47,-18,-16,60,63,65,"Pilot 10","Pilot 10: bigger feedback + video"
5,"SUPPRF78865",43,72,56,6,-15,27,71,50,"Pilot 10","Pilot 10: bigger feedback + video"
6,"SUPPRF78865",42,73,50,-10,-13,64,63,60,"Pilot 10","Pilot 10: bigger feedback + video"
7,"SUPPRF78865",31,74,67,-12,-13,63,80,79,"Pilot 10","Pilot 10: bigger feedback + video"
8,"SUPPRF78865",47,82,16,-11,-13,67,29,27,"Pilot 10","Pilot 10: bigger feedback + video"
9,"SUPPRF78865",43,81,6,-35,-14,29,20,41,"Pilot 10","Pilot 10: bigger feedback + video"
10,"SUPPRF78865",40,74,61,28,24,39,37,33,"Pilot 10","Pilot 10: bigger feedback + video"
11,"SUPPRF78865",31,77,35,-3,15,29,20,38,"Pilot 10","Pilot 10: bigger feedback + video"
12,"SUPPRF78865",29,78,81,52,1,27,80,29,"Pilot 10","Pilot 10: bigger feedback + video"
13,"SUPPRF78865",43,80,88,38,25,11,63,50,"Pilot 10","Pilot 10: bigger feedback + video"
14,"SUPPRF78865",40,80,100,27,20,65,80,73,"Pilot 10","Pilot 10: bigger feedback + video"
15,"SUPPRF78865",32,78,46,15,17,50,29,31,"Pilot 10","Pilot 10: bigger feedback + video"
16,"SUPPRF78865",39,78,77,12,14,58,63,65,"Pilot 10","Pilot 10: bigger feedback + video"
17,"SUPPRF78865",41,78,34,-24,-12,24,46,58,"Pilot 10","Pilot 10: bigger feedback + video"
18,"SUPPRF78865",42,70,83,17,12,53,71,66,"Pilot 10","Pilot 10: bigger feedback + video"
19,"SUPPRF78865",37,74,55,-1,1,60,54,56,"Pilot 10","Pilot 10: bigger feedback + video"
20,"SUPPRF78865",37,80,37,-13,0,28,37,50,"Pilot 10","Pilot 10: bigger feedback + video"
21,"SUPPRF78865",36,72,75,16,29,26,46,59,"Pilot 10","Pilot 10: bigger feedback + video"
22,"SUPPRF78865",34,74,29,0,0,54,29,29,"Pilot 10","Pilot 10: bigger feedback + video"
23,"SUPPRF78865",42,67,66,13,12,56,54,53,"Pilot 10","Pilot 10: bigger feedback + video"
24,"SUPPRF78865",30,68,71,5,0,66,71,66,"Pilot 10","Pilot 10: bigger feedback + video"
25,"SUPPRF78865",35,73,20,-30,0,12,20,50,"Pilot 10","Pilot 10: bigger feedback + video"
26,"SUPPRF78865",39,74,62,7,-1,45,63,55,"Pilot 10","Pilot 10: bigger feedback + video"
27,"SUPPRF78865",26,78,96,42,16,31,80,54,"Pilot 10","Pilot 10: bigger feedback + video"
28,"SUPPRF78865",34,87,68,-11,-12,72,80,79,"Pilot 10","Pilot 10: bigger feedback + video"
29,"SUPPRF78865",25,88,78,27,24,59,54,51,"Pilot 10","Pilot 10: bigger feedback + video"
30,"SUPPRF78865",25,81,94,43,23,27,71,51,"Pilot 10","Pilot 10: bigger feedback + video"
31,"SUPPRF78865",37,83,33,-15,-13,56,46,48,"Pilot 10","Pilot 10: bigger feedback + video"
32,"SUPPRF78865",33,81,24,-24,-13,57,37,48,"Pilot 10","Pilot 10: bigger feedback + video"
33,"SUPPRF78865",25,79,63,0,0,50,63,63,"Pilot 10","Pilot 10: bigger feedback + video"
34,"SUPPRF78865",36,75,41,-10,-13,67,54,51,"Pilot 10","Pilot 10: bigger feedback + video"
35,"SUPPRF78865",29,82,54,3,0,63,54,51,"Pilot 10","Pilot 10: bigger feedback + video"
36,"SUPPRF78865",38,75,47,29,27,63,20,18,"Pilot 10","Pilot 10: bigger feedback + video"
37,"SUPPRF78865",32,79,22,-11,-15,67,37,33,"Pilot 10","Pilot 10: bigger feedback + video"
38,"SUPPRF78865",27,78,38,1,1,70,37,37,"Pilot 10","Pilot 10: bigger feedback + video"
39,"SUPPRF78865",28,60,58,30,29,70,29,28,"Pilot 10","Pilot 10: bigger feedback + video"
40,"SUPPRF78865",41,68,70,34,-1,50,71,36,"Pilot 10","Pilot 10: bigger feedback + video"
41,"SUPPRF78865",44,78,28,2,-1,71,29,26,"Pilot 10","Pilot 10: bigger feedback + video"
42,"SUPPRF78865",26,77,8,-7,-12,66,20,15,"Pilot 10","Pilot 10: bigger feedback + video"
43,"SUPPRF78865",33,73,58,19,12,64,46,39,"Pilot 10","Pilot 10: bigger feedback + video"
44,"SUPPRF78865",26,78,55,5,-16,23,71,50,"Pilot 10","Pilot 10: bigger feedback + video"
45,"SUPPRF78865",31,68,38,-12,-16,65,54,50,"Pilot 10","Pilot 10: bigger feedback + video"
46,"SUPPRF78865",23,71,45,9,-1,72,46,36,"Pilot 10","Pilot 10: bigger feedback + video"
47,"SUPPRF78865",29,74,19,2,-1,80,20,17,"Pilot 10","Pilot 10: bigger feedback + video"
48,"SUPPRF78865",27,78,46,6,0,75,46,40,"Pilot 10","Pilot 10: bigger feedback + video"
1,"SUPPRF62860",48,36,66,23,12,65,54,43,"Pilot 10","Pilot 10: bigger feedback + video"
2,"SUPPRF62860",72,22,100,39,20,70,80,61,"Pilot 10","Pilot 10: bigger feedback + video"
3,"SUPPRF62860",72,8,96,12,16,86,80,84,"Pilot 10","Pilot 10: bigger feedback + video"
4,"SUPPRF62860",52,19,63,-14,0,52,63,77,"Pilot 10","Pilot 10: bigger feedback + video"
5,"SUPPRF62860",77,21,81,0,1,82,80,81,"Pilot 10","Pilot 10: bigger feedback + video"
6,"SUPPRF62860",74,25,70,9,-1,55,71,61,"Pilot 10","Pilot 10: bigger feedback + video"
7,"SUPPRF62860",49,20,35,-15,15,49,20,50,"Pilot 10","Pilot 10: bigger feedback + video"
8,"SUPPRF62860",71,11,78,5,24,55,54,73,"Pilot 10","Pilot 10: bigger feedback + video"
9,"SUPPRF62860",57,15,8,-59,-12,25,20,67,"Pilot 10","Pilot 10: bigger feedback + video"
10,"SUPPRF62860",54,40,56,-24,-15,73,71,80,"Pilot 10","Pilot 10: bigger feedback + video"
11,"SUPPRF62860",55,43,58,5,29,51,29,53,"Pilot 10","Pilot 10: bigger feedback + video"
12,"SUPPRF62860",52,50,24,-29,-13,51,37,53,"Pilot 10","Pilot 10: bigger feedback + video"
13,"SUPPRF62860",51,47,46,-2,0,48,46,48,"Pilot 10","Pilot 10: bigger feedback + video"
14,"SUPPRF62860",50,52,29,-21,0,50,29,50,"Pilot 10","Pilot 10: bigger feedback + video"
15,"SUPPRF62860",63,52,54,2,0,54,54,52,"Pilot 10","Pilot 10: bigger feedback + video"
16,"SUPPRF62860",49,50,16,-31,-13,50,29,47,"Pilot 10","Pilot 10: bigger feedback + video"
17,"SUPPRF62860",50,50,20,-29,0,47,20,49,"Pilot 10","Pilot 10: bigger feedback + video"
18,"SUPPRF62860",48,49,38,-17,1,50,37,55,"Pilot 10","Pilot 10: bigger feedback + video"
19,"SUPPRF62860",59,43,61,14,24,38,37,47,"Pilot 10","Pilot 10: bigger feedback + video"
20,"SUPPRF62860",63,37,47,-4,-16,55,63,51,"Pilot 10","Pilot 10: bigger feedback + video"
21,"SUPPRF62860",61,38,55,1,1,59,54,54,"Pilot 10","Pilot 10: bigger feedback + video"
22,"SUPPRF62860",40,57,45,4,-1,66,46,41,"Pilot 10","Pilot 10: bigger feedback + video"
23,"SUPPRF62860",57,42,49,-12,12,61,37,61,"Pilot 10","Pilot 10: bigger feedback + video"
24,"SUPPRF62860",61,45,46,-8,17,57,29,54,"Pilot 10","Pilot 10: bigger feedback + video"
25,"SUPPRF62860",46,39,77,24,14,43,63,53,"Pilot 10","Pilot 10: bigger feedback + video"
26,"SUPPRF62860",41,56,6,-53,-14,53,20,59,"Pilot 10","Pilot 10: bigger feedback + video"
27,"SUPPRF62860",37,50,55,0,-16,42,71,55,"Pilot 10","Pilot 10: bigger feedback + video"
28,"SUPPRF62860",53,44,71,16,0,54,71,55,"Pilot 10","Pilot 10: bigger feedback + video"
29,"SUPPRF62860",55,40,83,28,12,42,71,55,"Pilot 10","Pilot 10: bigger feedback + video"
30,"SUPPRF62860",38,35,37,-15,0,54,37,52,"Pilot 10","Pilot 10: bigger feedback + video"
31,"SUPPRF62860",55,48,28,-26,-1,46,29,54,"Pilot 10","Pilot 10: bigger feedback + video"
32,"SUPPRF62860",45,44,19,-8,-1,74,20,27,"Pilot 10","Pilot 10: bigger feedback + video"
33,"SUPPRF62860",61,34,94,28,23,57,71,66,"Pilot 10","Pilot 10: bigger feedback + video"
34,"SUPPRF62860",55,42,38,-18,-16,56,54,56,"Pilot 10","Pilot 10: bigger feedback + video"
35,"SUPPRF62860",56,41,75,21,29,35,46,54,"Pilot 10","Pilot 10: bigger feedback + video"
36,"SUPPRF62860",56,47,68,23,-12,45,80,45,"Pilot 10","Pilot 10: bigger feedback + video"
37,"SUPPRF62860",34,43,47,28,27,84,20,19,"Pilot 10","Pilot 10: bigger feedback + video"
38,"SUPPRF62860",48,44,22,-29,-15,49,37,51,"Pilot 10","Pilot 10: bigger feedback + video"
39,"SUPPRF62860",53,52,50,-8,-13,60,63,58,"Pilot 10","Pilot 10: bigger feedback + video"
40,"SUPPRF62860",47,55,58,1,12,44,46,57,"Pilot 10","Pilot 10: bigger feedback + video"
41,"SUPPRF62860",50,43,62,1,-1,55,63,61,"Pilot 10","Pilot 10: bigger feedback + video"
42,"SUPPRF62860",41,37,34,-22,-12,45,46,56,"Pilot 10","Pilot 10: bigger feedback + video"
43,"SUPPRF62860",42,59,67,11,-13,64,80,56,"Pilot 10","Pilot 10: bigger feedback + video"
44,"SUPPRF62860",30,41,15,-18,-14,62,29,33,"Pilot 10","Pilot 10: bigger feedback + video"
45,"SUPPRF62860",52,42,80,24,0,53,80,56,"Pilot 10","Pilot 10: bigger feedback + video"
46,"SUPPRF62860",36,33,33,-12,-13,58,46,45,"Pilot 10","Pilot 10: bigger feedback + video"
47,"SUPPRF62860",38,35,88,36,25,42,63,52,"Pilot 10","Pilot 10: bigger feedback + video"
48,"SUPPRF62860",55,38,41,4,-13,40,54,37,"Pilot 10","Pilot 10: bigger feedback + video"
1,"SUPPRF65333",44,55,16,-9,-13,59,29,25,"Pilot 10","Pilot 10: bigger feedback + video"
2,"SUPPRF65333",50,52,75,48,29,49,46,27,"Pilot 10","Pilot 10: bigger feedback + video"
3,"SUPPRF65333",50,49,15,-7,-14,55,29,22,"Pilot 10","Pilot 10: bigger feedback + video"
4,"SUPPRF65333",50,53,80,7,0,55,80,73,"Pilot 10","Pilot 10: bigger feedback + video"
5,"SUPPRF65333",51,52,37,9,0,54,37,28,"Pilot 10","Pilot 10: bigger feedback + video"
6,"SUPPRF65333",52,39,81,30,1,28,80,51,"Pilot 10","Pilot 10: bigger feedback + video"
7,"SUPPRF65333",50,47,33,4,-13,58,46,29,"Pilot 10","Pilot 10: bigger feedback + video"
8,"SUPPRF65333",47,48,46,1,0,56,46,45,"Pilot 10","Pilot 10: bigger feedback + video"
9,"SUPPRF65333",50,52,6,-11,-14,56,20,17,"Pilot 10","Pilot 10: bigger feedback + video"
10,"SUPPRF65333",51,43,54,20,0,19,54,34,"Pilot 10","Pilot 10: bigger feedback + video"
11,"SUPPRF65333",60,40,96,22,16,56,80,74,"Pilot 10","Pilot 10: bigger feedback + video"
12,"SUPPRF65333",64,40,20,9,0,64,20,11,"Pilot 10","Pilot 10: bigger feedback + video"
13,"SUPPRF65333",64,34,50,-6,-13,58,63,56,"Pilot 10","Pilot 10: bigger feedback + video"
14,"SUPPRF65333",60,36,34,-4,-12,58,46,38,"Pilot 10","Pilot 10: bigger feedback + video"
15,"SUPPRF65333",58,36,55,14,1,40,54,41,"Pilot 10","Pilot 10: bigger feedback + video"
16,"SUPPRF65333",56,42,24,-7,-13,57,37,31,"Pilot 10","Pilot 10: bigger feedback + video"
17,"SUPPRF65333",54,40,49,18,12,60,37,31,"Pilot 10","Pilot 10: bigger feedback + video"
18,"SUPPRF65333",51,24,47,35,27,64,20,12,"Pilot 10","Pilot 10: bigger feedback + video"
19,"SUPPRF65333",60,28,28,-11,-1,21,29,39,"Pilot 10","Pilot 10: bigger feedback + video"
20,"SUPPRF65333",57,29,61,22,24,36,37,39,"Pilot 10","Pilot 10: bigger feedback + video"
21,"SUPPRF65333",56,34,45,15,-1,55,46,30,"Pilot 10","Pilot 10: bigger feedback + video"
22,"SUPPRF65333",57,34,66,21,12,62,54,45,"Pilot 10","Pilot 10: bigger feedback + video"
23,"SUPPRF65333",51,27,67,-9,-13,68,80,76,"Pilot 10","Pilot 10: bigger feedback + video"
24,"SUPPRF65333",51,33,47,2,-16,37,63,45,"Pilot 10","Pilot 10: bigger feedback + video"
25,"SUPPRF65333",56,32,55,-6,-16,71,71,61,"Pilot 10","Pilot 10: bigger feedback + video"
26,"SUPPRF65333",58,37,71,15,0,69,71,56,"Pilot 10","Pilot 10: bigger feedback + video"
27,"SUPPRF65333",52,41,77,21,14,55,63,56,"Pilot 10","Pilot 10: bigger feedback + video"
28,"SUPPRF65333",62,28,100,25,20,75,80,75,"Pilot 10","Pilot 10: bigger feedback + video"
29,"SUPPRF65333",61,40,94,29,23,71,71,65,"Pilot 10","Pilot 10: bigger feedback + video"
30,"SUPPRF65333",36,35,38,-24,1,56,37,62,"Pilot 10","Pilot 10: bigger feedback + video"
31,"SUPPRF65333",55,31,62,10,-1,55,63,52,"Pilot 10","Pilot 10: bigger feedback + video"
32,"SUPPRF65333",37,31,22,-11,-15,65,37,33,"Pilot 10","Pilot 10: bigger feedback + video"
33,"SUPPRF65333",38,40,56,-3,-15,62,71,59,"Pilot 10","Pilot 10: bigger feedback + video"
34,"SUPPRF65333",50,27,58,12,12,48,46,46,"Pilot 10","Pilot 10: bigger feedback + video"
35,"SUPPRF65333",52,43,63,11,0,64,63,52,"Pilot 10","Pilot 10: bigger feedback + video"
36,"SUPPRF65333",62,30,68,5,-12,70,80,63,"Pilot 10","Pilot 10: bigger feedback + video"
37,"SUPPRF65333",33,44,41,-11,-13,57,54,52,"Pilot 10","Pilot 10: bigger feedback + video"
38,"SUPPRF65333",52,28,88,36,25,65,63,52,"Pilot 10","Pilot 10: bigger feedback + video"
39,"SUPPRF65333",55,35,8,-10,-12,52,20,18,"Pilot 10","Pilot 10: bigger feedback + video"
40,"SUPPRF65333",55,32,78,25,24,49,54,53,"Pilot 10","Pilot 10: bigger feedback + video"
41,"SUPPRF65333",52,36,19,8,-1,73,20,11,"Pilot 10","Pilot 10: bigger feedback + video"
42,"SUPPRF65333",59,26,46,27,17,58,29,19,"Pilot 10","Pilot 10: bigger feedback + video"
43,"SUPPRF65333",54,34,35,20,15,64,20,15,"Pilot 10","Pilot 10: bigger feedback + video"
44,"SUPPRF65333",64,38,70,6,-1,66,71,64,"Pilot 10","Pilot 10: bigger feedback + video"
45,"SUPPRF65333",60,42,58,34,29,69,29,24,"Pilot 10","Pilot 10: bigger feedback + video"
46,"SUPPRF65333",57,26,38,-6,-16,27,54,44,"Pilot 10","Pilot 10: bigger feedback + video"
47,"SUPPRF65333",56,25,29,11,0,58,29,18,"Pilot 10","Pilot 10: bigger feedback + video"
48,"SUPPRF65333",63,39,83,35,12,36,71,48,"Pilot 10","Pilot 10: bigger feedback + video"
1,"SUPPRF82563",36,35,71,32,0,37,71,39,"Pilot 10","Pilot 10: bigger feedback + video"
2,"SUPPRF82563",35,28,38,-13,-16,3,54,51,"Pilot 10","Pilot 10: bigger feedback + video"
3,"SUPPRF82563",34,33,46,11,17,59,29,35,"Pilot 10","Pilot 10: bigger feedback + video"
4,"SUPPRF82563",33,27,68,20,-12,40,80,48,"Pilot 10","Pilot 10: bigger feedback + video"
5,"SUPPRF82563",28,27,81,34,1,46,80,47,"Pilot 10","Pilot 10: bigger feedback + video"
6,"SUPPRF82563",36,25,34,3,-12,40,46,31,"Pilot 10","Pilot 10: bigger feedback + video"
7,"SUPPRF82563",30,21,41,20,-13,61,54,21,"Pilot 10","Pilot 10: bigger feedback + video"
8,"SUPPRF82563",30,20,58,27,29,56,29,31,"Pilot 10","Pilot 10: bigger feedback + video"
9,"SUPPRF82563",30,19,38,-2,1,16,37,40,"Pilot 10","Pilot 10: bigger feedback + video"
10,"SUPPRF82563",27,31,37,23,0,32,37,14,"Pilot 10","Pilot 10: bigger feedback + video"
11,"SUPPRF82563",40,31,77,44,14,62,63,33,"Pilot 10","Pilot 10: bigger feedback + video"
12,"SUPPRF82563",32,30,46,-11,0,55,46,57,"Pilot 10","Pilot 10: bigger feedback + video"
13,"SUPPRF82563",35,37,67,11,-13,72,80,56,"Pilot 10","Pilot 10: bigger feedback + video"
14,"SUPPRF82563",33,32,33,8,-13,54,46,25,"Pilot 10","Pilot 10: bigger feedback + video"
15,"SUPPRF82563",36,37,56,28,-15,50,71,28,"Pilot 10","Pilot 10: bigger feedback + video"
16,"SUPPRF82563",34,36,47,20,-16,37,63,27,"Pilot 10","Pilot 10: bigger feedback + video"
17,"SUPPRF82563",38,32,28,1,-1,43,29,27,"Pilot 10","Pilot 10: bigger feedback + video"
18,"SUPPRF82563",32,35,66,44,12,32,54,22,"Pilot 10","Pilot 10: bigger feedback + video"
19,"SUPPRF82563",35,31,80,14,0,67,80,66,"Pilot 10","Pilot 10: bigger feedback + video"
20,"SUPPRF82563",32,34,63,12,0,42,63,51,"Pilot 10","Pilot 10: bigger feedback + video"
21,"SUPPRF82563",32,32,54,16,0,13,54,38,"Pilot 10","Pilot 10: bigger feedback + video"
22,"SUPPRF82563",30,33,50,10,-13,26,63,40,"Pilot 10","Pilot 10: bigger feedback + video"
23,"SUPPRF82563",33,34,55,24,-16,9,71,31,"Pilot 10","Pilot 10: bigger feedback + video"
24,"SUPPRF82563",32,35,88,65,25,18,63,23,"Pilot 10","Pilot 10: bigger feedback + video"
25,"SUPPRF82563",34,43,20,-18,0,39,20,38,"Pilot 10","Pilot 10: bigger feedback + video"
26,"SUPPRF82563",32,33,24,-14,-13,9,37,38,"Pilot 10","Pilot 10: bigger feedback + video"
27,"SUPPRF82563",36,34,70,27,-1,18,71,43,"Pilot 10","Pilot 10: bigger feedback + video"
28,"SUPPRF82563",38,35,22,-44,-15,26,37,66,"Pilot 10","Pilot 10: bigger feedback + video"
29,"SUPPRF82563",36,34,61,13,24,63,37,48,"Pilot 10","Pilot 10: bigger feedback + video"
30,"SUPPRF82563",33,34,55,16,1,20,54,39,"Pilot 10","Pilot 10: bigger feedback + video"
31,"SUPPRF82563",36,42,16,-13,-13,71,29,29,"Pilot 10","Pilot 10: bigger feedback + video"
32,"SUPPRF82563",35,37,96,62,16,26,80,34,"Pilot 10","Pilot 10: bigger feedback + video"
33,"SUPPRF82563",39,39,49,-9,12,66,37,58,"Pilot 10","Pilot 10: bigger feedback + video"
34,"SUPPRF82563",37,38,94,59,23,33,71,35,"Pilot 10","Pilot 10: bigger feedback + video"
35,"SUPPRF82563",31,21,29,2,0,13,29,27,"Pilot 10","Pilot 10: bigger feedback + video"
36,"SUPPRF82563",34,35,35,-15,15,61,20,50,"Pilot 10","Pilot 10: bigger feedback + video"
37,"SUPPRF82563",29,31,47,32,27,13,20,15,"Pilot 10","Pilot 10: bigger feedback + video"
38,"SUPPRF82563",37,38,75,16,29,57,46,59,"Pilot 10","Pilot 10: bigger feedback + video"
39,"SUPPRF82563",35,38,19,6,-1,32,20,13,"Pilot 10","Pilot 10: bigger feedback + video"
40,"SUPPRF82563",30,33,83,53,12,9,71,30,"Pilot 10","Pilot 10: bigger feedback + video"
41,"SUPPRF82563",36,34,78,48,24,18,54,30,"Pilot 10","Pilot 10: bigger feedback + video"
42,"SUPPRF82563",34,36,58,40,12,68,46,18,"Pilot 10","Pilot 10: bigger feedback + video"
43,"SUPPRF82563",34,35,45,-18,-1,54,46,63,"Pilot 10","Pilot 10: bigger feedback + video"
44,"SUPPRF82563",26,43,8,-25,-12,56,20,33,"Pilot 10","Pilot 10: bigger feedback + video"
45,"SUPPRF82563",34,33,15,-5,-14,57,29,20,"Pilot 10","Pilot 10: bigger feedback + video"
46,"SUPPRF82563",25,42,6,-34,-14,23,20,40,"Pilot 10","Pilot 10: bigger feedback + video"
47,"SUPPRF82563",49,27,100,72,20,24,80,28,"Pilot 10","Pilot 10: bigger feedback + video"
48,"SUPPRF82563",39,39,62,31,-1,14,63,31,"Pilot 10","Pilot 10: bigger feedback + video"
1,"SUPPRF61122",55,46,100,34,20,60,80,66,"Pilot 10","Pilot 10: bigger feedback + video"
2,"SUPPRF61122",50,51,55,6,1,49,54,49,"Pilot 10","Pilot 10: bigger feedback + video"
3,"SUPPRF61122",41,62,33,-7,-13,48,46,40,"Pilot 10","Pilot 10: bigger feedback + video"
4,"SUPPRF61122",51,50,83,26,12,50,71,57,"Pilot 10","Pilot 10: bigger feedback + video"
5,"SUPPRF61122",53,48,81,32,1,49,80,49,"Pilot 10","Pilot 10: bigger feedback + video"
6,"SUPPRF61122",59,41,47,27,27,49,20,20,"Pilot 10","Pilot 10: bigger feedback + video"
7,"SUPPRF61122",45,56,58,26,12,52,46,32,"Pilot 10","Pilot 10: bigger feedback + video"
8,"SUPPRF61122",65,31,62,11,-1,52,63,51,"Pilot 10","Pilot 10: bigger feedback + video"
9,"SUPPRF61122",32,69,22,-26,-15,49,37,48,"Pilot 10","Pilot 10: bigger feedback + video"
10,"SUPPRF61122",50,51,38,7,1,64,37,31,"Pilot 10","Pilot 10: bigger feedback + video"
11,"SUPPRF61122",33,60,34,-17,-12,67,46,51,"Pilot 10","Pilot 10: bigger feedback + video"
12,"SUPPRF61122",87,42,20,2,0,72,20,18,"Pilot 10","Pilot 10: bigger feedback + video"
13,"SUPPRF61122",23,51,15,-35,-14,50,29,50,"Pilot 10","Pilot 10: bigger feedback + video"
14,"SUPPRF61122",71,41,58,28,29,66,29,30,"Pilot 10","Pilot 10: bigger feedback + video"
15,"SUPPRF61122",55,43,49,6,12,67,37,43,"Pilot 10","Pilot 10: bigger feedback + video"
16,"SUPPRF61122",37,53,8,-10,-12,82,20,18,"Pilot 10","Pilot 10: bigger feedback + video"
17,"SUPPRF61122",54,48,29,8,0,80,29,21,"Pilot 10","Pilot 10: bigger feedback + video"
18,"SUPPRF61122",71,39,70,1,-1,75,71,69,"Pilot 10","Pilot 10: bigger feedback + video"
19,"SUPPRF61122",94,18,94,18,23,54,71,76,"Pilot 10","Pilot 10: bigger feedback + video"
20,"SUPPRF61122",37,57,24,-13,-13,55,37,37,"Pilot 10","Pilot 10: bigger feedback + video"
21,"SUPPRF61122",88,26,66,17,12,69,54,49,"Pilot 10","Pilot 10: bigger feedback + video"
22,"SUPPRF61122",71,39,37,0,0,76,37,37,"Pilot 10","Pilot 10: bigger feedback + video"
23,"SUPPRF61122",90,16,54,4,0,56,54,50,"Pilot 10","Pilot 10: bigger feedback + video"
24,"SUPPRF61122",58,42,35,34,15,87,20,1,"Pilot 10","Pilot 10: bigger feedback + video"
25,"SUPPRF61122",41,61,41,-8,-13,70,54,49,"Pilot 10","Pilot 10: bigger feedback + video"
26,"SUPPRF61122",27,56,50,-8,-13,63,63,58,"Pilot 10","Pilot 10: bigger feedback + video"
27,"SUPPRF61122",25,76,38,-17,-16,67,54,55,"Pilot 10","Pilot 10: bigger feedback + video"
28,"SUPPRF61122",27,79,16,-26,-13,66,29,42,"Pilot 10","Pilot 10: bigger feedback + video"
29,"SUPPRF61122",43,53,68,-5,-12,77,80,73,"Pilot 10","Pilot 10: bigger feedback + video"
30,"SUPPRF61122",97,6,78,35,24,79,54,43,"Pilot 10","Pilot 10: bigger feedback + video"
31,"SUPPRF61122",55,42,61,20,24,66,37,41,"Pilot 10","Pilot 10: bigger feedback + video"
32,"SUPPRF61122",40,62,46,-6,17,50,29,52,"Pilot 10","Pilot 10: bigger feedback + video"
33,"SUPPRF61122",55,43,45,6,-1,59,46,39,"Pilot 10","Pilot 10: bigger feedback + video"
34,"SUPPRF61122",54,49,19,2,-1,85,20,17,"Pilot 10","Pilot 10: bigger feedback + video"
35,"SUPPRF61122",75,37,63,8,0,80,63,55,"Pilot 10","Pilot 10: bigger feedback + video"
36,"SUPPRF61122",53,46,55,6,-16,45,71,49,"Pilot 10","Pilot 10: bigger feedback + video"
37,"SUPPRF61122",53,41,6,3,-14,58,20,3,"Pilot 10","Pilot 10: bigger feedback + video"
38,"SUPPRF61122",98,13,96,14,16,87,80,82,"Pilot 10","Pilot 10: bigger feedback + video"
39,"SUPPRF61122",66,39,46,5,0,95,46,41,"Pilot 10","Pilot 10: bigger feedback + video"
40,"SUPPRF61122",77,30,77,27,14,48,63,50,"Pilot 10","Pilot 10: bigger feedback + video"
41,"SUPPRF61122",80,32,80,-2,0,87,80,82,"Pilot 10","Pilot 10: bigger feedback + video"
42,"SUPPRF61122",81,25,67,0,-13,59,80,67,"Pilot 10","Pilot 10: bigger feedback + video"
43,"SUPPRF61122",80,32,75,27,29,57,46,48,"Pilot 10","Pilot 10: bigger feedback + video"
44,"SUPPRF61122",52,51,47,-5,-16,71,63,52,"Pilot 10","Pilot 10: bigger feedback + video"
45,"SUPPRF61122",57,46,71,4,0,46,71,67,"Pilot 10","Pilot 10: bigger feedback + video"
46,"SUPPRF61122",53,52,56,-15,-15,66,71,71,"Pilot 10","Pilot 10: bigger feedback + video"
47,"SUPPRF61122",40,54,28,-22,-1,50,29,50,"Pilot 10","Pilot 10: bigger feedback + video"
48,"SUPPRF61122",55,43,88,35,25,80,63,53,"Pilot 10","Pilot 10: bigger feedback + video"
1,"SUPPRF20210",85,74,62,-10,-1,67,63,72,"Pilot 10","Pilot 10: bigger feedback + video"
2,"SUPPRF20210",75,63,56,-19,-15,72,71,75,"Pilot 10","Pilot 10: bigger feedback + video"
3,"SUPPRF20210",62,68,88,27,25,55,63,61,"Pilot 10","Pilot 10: bigger feedback + video"
4,"SUPPRF20210",69,74,77,0,14,73,63,77,"Pilot 10","Pilot 10: bigger feedback + video"
5,"SUPPRF20210",65,71,8,-54,-12,71,20,62,"Pilot 10","Pilot 10: bigger feedback + video"
6,"SUPPRF20210",71,60,81,0,1,73,80,81,"Pilot 10","Pilot 10: bigger feedback + video"
7,"SUPPRF20210",80,50,54,-12,0,80,54,66,"Pilot 10","Pilot 10: bigger feedback + video"
8,"SUPPRF20210",55,63,16,-65,-13,75,29,81,"Pilot 10","Pilot 10: bigger feedback + video"
9,"SUPPRF20210",49,52,28,7,-1,45,29,21,"Pilot 10","Pilot 10: bigger feedback + video"
10,"SUPPRF20210",51,55,46,19,17,54,29,27,"Pilot 10","Pilot 10: bigger feedback + video"
11,"SUPPRF20210",52,70,50,-10,-13,54,63,60,"Pilot 10","Pilot 10: bigger feedback + video"
12,"SUPPRF20210",52,52,66,20,12,57,54,46,"Pilot 10","Pilot 10: bigger feedback + video"
13,"SUPPRF20210",57,41,19,-13,-1,60,20,32,"Pilot 10","Pilot 10: bigger feedback + video"
14,"SUPPRF20210",53,41,61,13,24,54,37,48,"Pilot 10","Pilot 10: bigger feedback + video"
15,"SUPPRF20210",71,36,100,20,20,60,80,80,"Pilot 10","Pilot 10: bigger feedback + video"
16,"SUPPRF20210",63,36,70,15,-1,54,71,55,"Pilot 10","Pilot 10: bigger feedback + video"
17,"SUPPRF20210",50,42,68,4,-12,61,80,64,"Pilot 10","Pilot 10: bigger feedback + video"
18,"SUPPRF20210",53,55,75,39,29,57,46,36,"Pilot 10","Pilot 10: bigger feedback + video"
19,"SUPPRF20210",48,52,38,-23,-16,57,54,61,"Pilot 10","Pilot 10: bigger feedback + video"
20,"SUPPRF20210",62,55,78,37,24,51,54,41,"Pilot 10","Pilot 10: bigger feedback + video"
21,"SUPPRF20210",69,75,80,0,0,69,80,80,"Pilot 10","Pilot 10: bigger feedback + video"
22,"SUPPRF20210",66,50,46,-7,0,63,46,53,"Pilot 10","Pilot 10: bigger feedback + video"
23,"SUPPRF20210",57,50,29,0,0,54,29,29,"Pilot 10","Pilot 10: bigger feedback + video"
24,"SUPPRF20210",62,49,94,21,23,61,71,73,"Pilot 10","Pilot 10: bigger feedback + video"
25,"SUPPRF20210",52,52,35,0,15,57,20,35,"Pilot 10","Pilot 10: bigger feedback + video"
26,"SUPPRF20210",44,46,34,-15,-12,48,46,49,"Pilot 10","Pilot 10: bigger feedback + video"
27,"SUPPRF20210",54,54,38,0,1,34,37,38,"Pilot 10","Pilot 10: bigger feedback + video"
28,"SUPPRF20210",67,67,20,-3,0,39,20,23,"Pilot 10","Pilot 10: bigger feedback + video"
29,"SUPPRF20210",52,51,24,-33,-13,48,37,57,"Pilot 10","Pilot 10: bigger feedback + video"
30,"SUPPRF20210",58,33,47,24,27,44,20,23,"Pilot 10","Pilot 10: bigger feedback + video"
31,"SUPPRF20210",55,50,58,20,29,38,29,38,"Pilot 10","Pilot 10: bigger feedback + video"
32,"SUPPRF20210",48,45,37,-6,0,32,37,43,"Pilot 10","Pilot 10: bigger feedback + video"
33,"SUPPRF20210",52,48,22,-18,-15,28,37,40,"Pilot 10","Pilot 10: bigger feedback + video"
34,"SUPPRF20210",53,60,67,-19,-13,74,80,86,"Pilot 10","Pilot 10: bigger feedback + video"
35,"SUPPRF20210",56,68,33,-9,-13,66,46,42,"Pilot 10","Pilot 10: bigger feedback + video"
36,"SUPPRF20210",63,16,47,-20,-16,68,63,67,"Pilot 10","Pilot 10: bigger feedback + video"
37,"SUPPRF20210",65,73,63,-18,0,63,63,81,"Pilot 10","Pilot 10: bigger feedback + video"
38,"SUPPRF20210",76,26,49,2,12,52,37,47,"Pilot 10","Pilot 10: bigger feedback + video"
39,"SUPPRF20210",62,20,58,-19,12,63,46,77,"Pilot 10","Pilot 10: bigger feedback + video"
40,"SUPPRF20210",29,26,83,6,12,55,71,77,"Pilot 10","Pilot 10: bigger feedback + video"
41,"SUPPRF20210",60,29,55,-5,1,59,54,60,"Pilot 10","Pilot 10: bigger feedback + video"
42,"SUPPRF20210",29,35,96,19,16,63,80,77,"Pilot 10","Pilot 10: bigger feedback + video"
43,"SUPPRF20210",47,38,45,1,-1,44,46,44,"Pilot 10","Pilot 10: bigger feedback + video"
44,"SUPPRF20210",51,25,71,3,0,50,71,68,"Pilot 10","Pilot 10: bigger feedback + video"
45,"SUPPRF20210",46,14,6,-19,-14,63,20,25,"Pilot 10","Pilot 10: bigger feedback + video"
46,"SUPPRF20210",38,56,15,-23,-14,54,29,38,"Pilot 10","Pilot 10: bigger feedback + video"
47,"SUPPRF20210",53,26,55,-15,-16,69,71,70,"Pilot 10","Pilot 10: bigger feedback + video"
48,"SUPPRF20210",63,46,41,-13,-13,40,54,54,"Pilot 10","Pilot 10: bigger feedback + video"
1,"SUPPRF37840",51,9,37,-3,0,80,37,40,"Pilot 10","Pilot 10: bigger feedback + video"
2,"SUPPRF37840",50,8,46,21,0,40,46,25,"Pilot 10","Pilot 10: bigger feedback + video"
3,"SUPPRF37840",51,8,54,-6,0,80,54,60,"Pilot 10","Pilot 10: bigger feedback + video"
4,"SUPPRF37840",61,5,100,20,20,80,80,80,"Pilot 10","Pilot 10: bigger feedback + video"
5,"SUPPRF37840",51,7,28,-2,-1,80,29,30,"Pilot 10","Pilot 10: bigger feedback + video"
6,"SUPPRF37840",50,7,33,-12,-13,60,46,45,"Pilot 10","Pilot 10: bigger feedback + video"
7,"SUPPRF37840",50,5,62,12,-1,60,63,50,"Pilot 10","Pilot 10: bigger feedback + video"
8,"SUPPRF37840",49,7,38,-12,1,20,37,50,"Pilot 10","Pilot 10: bigger feedback + video"
9,"SUPPRF37840",49,5,46,21,17,75,29,25,"Pilot 10","Pilot 10: bigger feedback + video"
10,"SUPPRF37840",51,6,58,28,29,50,29,30,"Pilot 10","Pilot 10: bigger feedback + video"
11,"SUPPRF37840",51,5,55,-23,-16,80,71,78,"Pilot 10","Pilot 10: bigger feedback + video"
12,"SUPPRF37840",50,6,66,16,12,30,54,50,"Pilot 10","Pilot 10: bigger feedback + video"
13,"SUPPRF37840",51,5,81,1,1,85,80,80,"Pilot 10","Pilot 10: bigger feedback + video"
14,"SUPPRF37840",50,5,67,-13,-13,90,80,80,"Pilot 10","Pilot 10: bigger feedback + video"
15,"SUPPRF37840",49,6,29,-1,0,25,29,30,"Pilot 10","Pilot 10: bigger feedback + video"
16,"SUPPRF37840",51,5,77,17,14,45,63,60,"Pilot 10","Pilot 10: bigger feedback + video"
17,"SUPPRF37840",51,6,55,0,1,65,54,55,"Pilot 10","Pilot 10: bigger feedback + video"
18,"SUPPRF37840",49,5,47,-13,-16,40,63,60,"Pilot 10","Pilot 10: bigger feedback + video"
19,"SUPPRF37840",52,6,41,-25,-13,85,54,66,"Pilot 10","Pilot 10: bigger feedback + video"
20,"SUPPRF37840",51,8,19,-1,-1,75,20,20,"Pilot 10","Pilot 10: bigger feedback + video"
21,"SUPPRF37840",52,5,94,24,23,65,71,70,"Pilot 10","Pilot 10: bigger feedback + video"
22,"SUPPRF37840",51,8,70,0,-1,75,71,70,"Pilot 10","Pilot 10: bigger feedback + video"
23,"SUPPRF37840",49,8,63,-2,0,45,63,65,"Pilot 10","Pilot 10: bigger feedback + video"
24,"SUPPRF37840",49,9,47,32,27,30,20,15,"Pilot 10","Pilot 10: bigger feedback + video"
25,"SUPPRF37840",49,10,50,-15,-13,50,63,65,"Pilot 10","Pilot 10: bigger feedback + video"
26,"SUPPRF37840",50,9,8,-12,-12,25,20,20,"Pilot 10","Pilot 10: bigger feedback + video"
27,"SUPPRF37840",49,11,80,0,0,75,80,80,"Pilot 10","Pilot 10: bigger feedback + video"
28,"SUPPRF37840",51,12,68,-12,-12,90,80,80,"Pilot 10","Pilot 10: bigger feedback + video"
29,"SUPPRF37840",49,11,20,0,0,10,20,20,"Pilot 10","Pilot 10: bigger feedback + video"
30,"SUPPRF37840",49,12,16,-24,-13,10,29,40,"Pilot 10","Pilot 10: bigger feedback + video"
31,"SUPPRF37840",49,9,22,-28,-15,0,37,50,"Pilot 10","Pilot 10: bigger feedback + video"
32,"SUPPRF37840",46,10,15,-10,-14,10,29,25,"Pilot 10","Pilot 10: bigger feedback + video"
33,"SUPPRF37840",49,13,58,8,12,10,46,50,"Pilot 10","Pilot 10: bigger feedback + video"
34,"SUPPRF37840",43,16,38,-32,-16,80,54,70,"Pilot 10","Pilot 10: bigger feedback + video"
35,"SUPPRF37840",39,17,35,15,15,75,20,20,"Pilot 10","Pilot 10: bigger feedback + video"
36,"SUPPRF37840",38,29,75,35,29,40,46,40,"Pilot 10","Pilot 10: bigger feedback + video"
37,"SUPPRF37840",38,23,96,21,16,80,80,75,"Pilot 10","Pilot 10: bigger feedback + video"
38,"SUPPRF37840",42,28,61,31,24,70,37,30,"Pilot 10","Pilot 10: bigger feedback + video"
39,"SUPPRF37840",38,32,71,-9,0,80,71,80,"Pilot 10","Pilot 10: bigger feedback + video"
40,"SUPPRF37840",37,37,24,-16,-13,30,37,40,"Pilot 10","Pilot 10: bigger feedback + video"
41,"SUPPRF37840",39,36,34,-16,-12,80,46,50,"Pilot 10","Pilot 10: bigger feedback + video"
42,"SUPPRF37840",38,40,49,19,12,85,37,30,"Pilot 10","Pilot 10: bigger feedback + video"
43,"SUPPRF37840",38,46,78,18,24,75,54,60,"Pilot 10","Pilot 10: bigger feedback + video"
44,"SUPPRF37840",40,45,88,38,25,10,63,50,"Pilot 10","Pilot 10: bigger feedback + video"
45,"SUPPRF37840",39,45,45,15,-1,40,46,30,"Pilot 10","Pilot 10: bigger feedback + video"
46,"SUPPRF37840",40,53,83,11,12,80,71,72,"Pilot 10","Pilot 10: bigger feedback + video"
47,"SUPPRF37840",33,49,6,-14,-14,85,20,20,"Pilot 10","Pilot 10: bigger feedback + video"
48,"SUPPRF37840",41,54,56,-24,-15,90,71,80,"Pilot 10","Pilot 10: bigger feedback + video"
1,"SUPPRF61000",34,40,22,-13,-15,34,37,35,"Pilot 10","Pilot 10: bigger feedback + video"
2,"SUPPRF61000",70,37,100,64,20,30,80,36,"Pilot 10","Pilot 10: bigger feedback + video"
3,"SUPPRF61000",54,35,66,31,12,41,54,35,"Pilot 10","Pilot 10: bigger feedback + video"
4,"SUPPRF61000",54,44,75,33,29,54,46,42,"Pilot 10","Pilot 10: bigger feedback + video"
5,"SUPPRF61000",46,56,50,-3,-13,46,63,53,"Pilot 10","Pilot 10: bigger feedback + video"
6,"SUPPRF61000",54,44,46,27,17,28,29,19,"Pilot 10","Pilot 10: bigger feedback + video"
7,"SUPPRF61000",51,44,58,25,12,32,46,33,"Pilot 10","Pilot 10: bigger feedback + video"
8,"SUPPRF61000",32,39,20,7,0,20,20,13,"Pilot 10","Pilot 10: bigger feedback + video"
9,"SUPPRF61000",49,53,38,4,1,39,37,34,"Pilot 10","Pilot 10: bigger feedback + video"
10,"SUPPRF61000",52,47,80,33,0,60,80,47,"Pilot 10","Pilot 10: bigger feedback + video"
11,"SUPPRF61000",45,42,24,-15,-13,33,37,39,"Pilot 10","Pilot 10: bigger feedback + video"
12,"SUPPRF61000",51,47,33,0,-13,42,46,33,"Pilot 10","Pilot 10: bigger feedback + video"
13,"SUPPRF61000",54,50,96,58,16,16,80,38,"Pilot 10","Pilot 10: bigger feedback + video"
14,"SUPPRF61000",44,46,37,5,0,34,37,32,"Pilot 10","Pilot 10: bigger feedback + video"
15,"SUPPRF61000",33,71,15,-9,-14,44,29,24,"Pilot 10","Pilot 10: bigger feedback + video"
16,"SUPPRF61000",29,49,29,3,0,31,29,26,"Pilot 10","Pilot 10: bigger feedback + video"
17,"SUPPRF61000",45,48,47,12,-16,40,63,35,"Pilot 10","Pilot 10: bigger feedback + video"
18,"SUPPRF61000",50,46,62,21,-1,19,63,41,"Pilot 10","Pilot 10: bigger feedback + video"
19,"SUPPRF61000",38,45,55,20,1,33,54,35,"Pilot 10","Pilot 10: bigger feedback + video"
20,"SUPPRF61000",17,62,83,57,12,16,71,26,"Pilot 10","Pilot 10: bigger feedback + video"
21,"SUPPRF61000",29,26,56,25,-15,26,71,31,"Pilot 10","Pilot 10: bigger feedback + video"
22,"SUPPRF61000",24,36,54,17,0,43,54,37,"Pilot 10","Pilot 10: bigger feedback + video"
23,"SUPPRF61000",29,65,28,11,-1,44,29,17,"Pilot 10","Pilot 10: bigger feedback + video"
24,"SUPPRF61000",32,60,35,22,15,79,20,13,"Pilot 10","Pilot 10: bigger feedback + video"
25,"SUPPRF61000",28,58,68,0,-12,53,80,68,"Pilot 10","Pilot 10: bigger feedback + video"
26,"SUPPRF61000",41,63,46,22,0,33,46,24,"Pilot 10","Pilot 10: bigger feedback + video"
27,"SUPPRF61000",56,53,61,40,24,11,37,21,"Pilot 10","Pilot 10: bigger feedback + video"
28,"SUPPRF61000",50,49,45,19,-1,62,46,26,"Pilot 10","Pilot 10: bigger feedback + video"
29,"SUPPRF61000",23,51,8,-1,-12,60,20,9,"Pilot 10","Pilot 10: bigger feedback + video"
30,"SUPPRF61000",48,47,67,30,-13,31,80,37,"Pilot 10","Pilot 10: bigger feedback + video"
31,"SUPPRF61000",47,53,55,14,-16,42,71,41,"Pilot 10","Pilot 10: bigger feedback + video"
32,"SUPPRF61000",64,46,71,35,0,37,71,36,"Pilot 10","Pilot 10: bigger feedback + video"
33,"SUPPRF61000",52,45,41,6,-13,33,54,35,"Pilot 10","Pilot 10: bigger feedback + video"
34,"SUPPRF61000",19,60,6,-9,-14,30,20,15,"Pilot 10","Pilot 10: bigger feedback + video"
35,"SUPPRF61000",29,57,49,29,12,47,37,20,"Pilot 10","Pilot 10: bigger feedback + video"
36,"SUPPRF61000",32,57,34,7,-12,36,46,27,"Pilot 10","Pilot 10: bigger feedback + video"
37,"SUPPRF61000",55,52,58,41,29,16,29,17,"Pilot 10","Pilot 10: bigger feedback + video"
38,"SUPPRF61000",33,55,38,8,-16,29,54,30,"Pilot 10","Pilot 10: bigger feedback + video"
39,"SUPPRF61000",26,51,81,45,1,20,80,36,"Pilot 10","Pilot 10: bigger feedback + video"
40,"SUPPRF61000",43,61,19,14,-1,79,20,5,"Pilot 10","Pilot 10: bigger feedback + video"
41,"SUPPRF61000",46,56,78,32,24,65,54,46,"Pilot 10","Pilot 10: bigger feedback + video"
42,"SUPPRF61000",52,61,63,17,0,54,63,46,"Pilot 10","Pilot 10: bigger feedback + video"
43,"SUPPRF61000",54,54,94,46,23,38,71,48,"Pilot 10","Pilot 10: bigger feedback + video"
44,"SUPPRF61000",52,54,77,44,14,48,63,33,"Pilot 10","Pilot 10: bigger feedback + video"
45,"SUPPRF61000",16,76,16,-16,-13,74,29,32,"Pilot 10","Pilot 10: bigger feedback + video"
46,"SUPPRF61000",58,60,88,58,25,40,63,30,"Pilot 10","Pilot 10: bigger feedback + video"
47,"SUPPRF61000",62,54,70,9,-1,63,71,61,"Pilot 10","Pilot 10: bigger feedback + video"
48,"SUPPRF61000",55,58,47,40,27,87,20,7,"Pilot 10","Pilot 10: bigger feedback + video"
1,"SUPPRF77020",21,51,15,-14,-14,62,29,29,"Pilot 10","Pilot 10: bigger feedback + video"
2,"SUPPRF77020",57,45,38,2,-16,34,54,36,"Pilot 10","Pilot 10: bigger feedback + video"
3,"SUPPRF77020",77,38,63,1,0,58,63,62,"Pilot 10","Pilot 10: bigger feedback + video"
4,"SUPPRF77020",43,42,47,-19,-16,62,63,66,"Pilot 10","Pilot 10: bigger feedback + video"
5,"SUPPRF77020",62,37,37,8,0,65,37,29,"Pilot 10","Pilot 10: bigger feedback + video"
6,"SUPPRF77020",48,30,62,20,-1,31,63,42,"Pilot 10","Pilot 10: bigger feedback + video"
7,"SUPPRF77020",53,40,67,0,-13,71,80,67,"Pilot 10","Pilot 10: bigger feedback + video"
8,"SUPPRF77020",97,21,19,-1,-1,69,20,20,"Pilot 10","Pilot 10: bigger feedback + video"
9,"SUPPRF77020",47,34,33,0,-13,27,46,33,"Pilot 10","Pilot 10: bigger feedback + video"
10,"SUPPRF77020",46,35,46,7,0,32,46,39,"Pilot 10","Pilot 10: bigger feedback + video"
11,"SUPPRF77020",45,19,38,13,1,71,37,25,"Pilot 10","Pilot 10: bigger feedback + video"
12,"SUPPRF77020",47,19,50,-24,-13,67,63,74,"Pilot 10","Pilot 10: bigger feedback + video"
13,"SUPPRF77020",34,26,58,34,29,36,29,24,"Pilot 10","Pilot 10: bigger feedback + video"
14,"SUPPRF77020",67,33,77,34,14,10,63,43,"Pilot 10","Pilot 10: bigger feedback + video"
15,"SUPPRF77020",52,22,96,15,16,71,80,81,"Pilot 10","Pilot 10: bigger feedback + video"
16,"SUPPRF77020",47,35,35,17,15,58,20,18,"Pilot 10","Pilot 10: bigger feedback + video"
17,"SUPPRF77020",66,30,70,-3,-1,77,71,73,"Pilot 10","Pilot 10: bigger feedback + video"
18,"SUPPRF77020",47,34,55,-2,1,31,54,57,"Pilot 10","Pilot 10: bigger feedback + video"
19,"SUPPRF77020",49,48,46,9,17,9,29,37,"Pilot 10","Pilot 10: bigger feedback + video"
20,"SUPPRF77020",66,35,68,-6,-12,67,80,74,"Pilot 10","Pilot 10: bigger feedback + video"
21,"SUPPRF77020",55,48,49,19,12,61,37,30,"Pilot 10","Pilot 10: bigger feedback + video"
22,"SUPPRF77020",46,40,45,5,-1,23,46,40,"Pilot 10","Pilot 10: bigger feedback + video"
23,"SUPPRF77020",38,39,24,-9,-13,71,37,33,"Pilot 10","Pilot 10: bigger feedback + video"
24,"SUPPRF77020",48,49,75,38,29,63,46,37,"Pilot 10","Pilot 10: bigger feedback + video"
25,"SUPPRF77020",45,39,28,-7,-1,60,29,35,"Pilot 10","Pilot 10: bigger feedback + video"
26,"SUPPRF77020",38,35,61,31,24,29,37,30,"Pilot 10","Pilot 10: bigger feedback + video"
27,"SUPPRF77020",44,42,94,35,23,40,71,59,"Pilot 10","Pilot 10: bigger feedback + video"
28,"SUPPRF77020",75,47,54,-4,0,78,54,58,"Pilot 10","Pilot 10: bigger feedback + video"
29,"SUPPRF77020",29,38,47,26,27,78,20,21,"Pilot 10","Pilot 10: bigger feedback + video"
30,"SUPPRF77020",53,35,41,-16,-13,93,54,57,"Pilot 10","Pilot 10: bigger feedback + video"
31,"SUPPRF77020",76,38,100,26,20,81,80,74,"Pilot 10","Pilot 10: bigger feedback + video"
32,"SUPPRF77020",33,44,56,-15,-15,82,71,71,"Pilot 10","Pilot 10: bigger feedback + video"
33,"SUPPRF77020",48,47,20,0,0,85,20,20,"Pilot 10","Pilot 10: bigger feedback + video"
34,"SUPPRF77020",56,35,66,8,12,77,54,58,"Pilot 10","Pilot 10: bigger feedback + video"
35,"SUPPRF77020",54,43,88,13,25,67,63,75,"Pilot 10","Pilot 10: bigger feedback + video"
36,"SUPPRF77020",77,31,71,-5,0,70,71,76,"Pilot 10","Pilot 10: bigger feedback + video"
37,"SUPPRF77020",50,35,80,-3,0,83,80,83,"Pilot 10","Pilot 10: bigger feedback + video"
38,"SUPPRF77020",46,50,16,-8,-13,66,29,24,"Pilot 10","Pilot 10: bigger feedback + video"
39,"SUPPRF77020",43,47,34,-40,-12,72,46,74,"Pilot 10","Pilot 10: bigger feedback + video"
40,"SUPPRF77020",52,44,78,16,24,67,54,62,"Pilot 10","Pilot 10: bigger feedback + video"
41,"SUPPRF77020",49,41,22,-8,-15,12,37,30,"Pilot 10","Pilot 10: bigger feedback + video"
42,"SUPPRF77020",44,39,58,0,12,40,46,58,"Pilot 10","Pilot 10: bigger feedback + video"
43,"SUPPRF77020",44,54,55,-20,-16,64,71,75,"Pilot 10","Pilot 10: bigger feedback + video"
44,"SUPPRF77020",49,49,81,6,1,52,80,75,"Pilot 10","Pilot 10: bigger feedback + video"
45,"SUPPRF77020",36,36,6,-27,-14,27,20,33,"Pilot 10","Pilot 10: bigger feedback + video"
46,"SUPPRF77020",53,67,83,9,12,69,71,74,"Pilot 10","Pilot 10: bigger feedback + video"
47,"SUPPRF77020",39,55,29,-29,0,5,29,58,"Pilot 10","Pilot 10: bigger feedback + video"
48,"SUPPRF77020",42,65,8,-64,-12,26,20,72,"Pilot 10","Pilot 10: bigger feedback + video"
1,"SUPPRF13951",54,13,94,24,23,88,71,70,"Pilot 10","Pilot 10: bigger feedback + video"
2,"SUPPRF13951",58,11,96,21,16,78,80,75,"Pilot 10","Pilot 10: bigger feedback + video"
3,"SUPPRF13951",55,5,62,2,-1,80,63,60,"Pilot 10","Pilot 10: bigger feedback + video"
4,"SUPPRF13951",58,5,58,10,12,83,46,48,"Pilot 10","Pilot 10: bigger feedback + video"
5,"SUPPRF13951",57,2,75,22,29,83,46,53,"Pilot 10","Pilot 10: bigger feedback + video"
6,"SUPPRF13951",59,0,47,22,27,91,20,25,"Pilot 10","Pilot 10: bigger feedback + video"
7,"SUPPRF13951",57,0,70,20,-1,15,71,50,"Pilot 10","Pilot 10: bigger feedback + video"
8,"SUPPRF13951",59,0,29,-6,0,75,29,35,"Pilot 10","Pilot 10: bigger feedback + video"
9,"SUPPRF13951",55,0,68,-12,-12,80,80,80,"Pilot 10","Pilot 10: bigger feedback + video"
10,"SUPPRF13951",55,0,16,-19,-13,58,29,35,"Pilot 10","Pilot 10: bigger feedback + video"
11,"SUPPRF13951",50,0,50,-28,-13,64,63,78,"Pilot 10","Pilot 10: bigger feedback + video"
12,"SUPPRF13951",51,0,38,-18,-16,74,54,56,"Pilot 10","Pilot 10: bigger feedback + video"
13,"SUPPRF13951",50,0,35,12,15,62,20,23,"Pilot 10","Pilot 10: bigger feedback + video"
14,"SUPPRF13951",50,0,34,-25,-12,29,46,59,"Pilot 10","Pilot 10: bigger feedback + video"
15,"SUPPRF13951",50,0,19,-9,-1,41,20,28,"Pilot 10","Pilot 10: bigger feedback + video"
16,"SUPPRF13951",50,0,6,-19,-14,30,20,25,"Pilot 10","Pilot 10: bigger feedback + video"
17,"SUPPRF13951",50,0,71,3,0,7,71,68,"Pilot 10","Pilot 10: bigger feedback + video"
18,"SUPPRF13951",51,0,67,-12,-13,21,80,79,"Pilot 10","Pilot 10: bigger feedback + video"
19,"SUPPRF13951",50,0,38,-14,1,15,37,52,"Pilot 10","Pilot 10: bigger feedback + video"
20,"SUPPRF13951",49,0,46,-5,0,19,46,51,"Pilot 10","Pilot 10: bigger feedback + video"
21,"SUPPRF13951",48,0,49,6,12,15,37,43,"Pilot 10","Pilot 10: bigger feedback + video"
22,"SUPPRF13951",47,0,58,31,29,7,29,27,"Pilot 10","Pilot 10: bigger feedback + video"
23,"SUPPRF13951",48,0,54,-2,0,28,54,56,"Pilot 10","Pilot 10: bigger feedback + video"
24,"SUPPRF13951",45,0,56,-14,-15,23,71,70,"Pilot 10","Pilot 10: bigger feedback + video"
25,"SUPPRF13951",48,0,28,2,-1,20,29,26,"Pilot 10","Pilot 10: bigger feedback + video"
26,"SUPPRF13951",48,0,100,75,20,26,80,25,"Pilot 10","Pilot 10: bigger feedback + video"
27,"SUPPRF13951",46,0,33,-11,-13,17,46,44,"Pilot 10","Pilot 10: bigger feedback + video"
28,"SUPPRF13951",46,0,47,-7,-16,22,63,54,"Pilot 10","Pilot 10: bigger feedback + video"
29,"SUPPRF13951",46,0,63,8,0,19,63,55,"Pilot 10","Pilot 10: bigger feedback + video"
30,"SUPPRF13951",45,0,22,-37,-15,23,37,59,"Pilot 10","Pilot 10: bigger feedback + video"
31,"SUPPRF13951",45,0,78,46,24,21,54,32,"Pilot 10","Pilot 10: bigger feedback + video"
32,"SUPPRF13951",43,0,45,-1,-1,25,46,46,"Pilot 10","Pilot 10: bigger feedback + video"
33,"SUPPRF13951",43,0,46,17,17,29,29,29,"Pilot 10","Pilot 10: bigger feedback + video"
34,"SUPPRF13951",44,0,15,-15,-14,22,29,30,"Pilot 10","Pilot 10: bigger feedback + video"
35,"SUPPRF13951",42,0,77,10,14,6,63,67,"Pilot 10","Pilot 10: bigger feedback + video"
36,"SUPPRF13951",44,0,61,19,24,3,37,42,"Pilot 10","Pilot 10: bigger feedback + video"
37,"SUPPRF13951",41,0,80,-2,0,9,80,82,"Pilot 10","Pilot 10: bigger feedback + video"
38,"SUPPRF13951",43,0,20,-5,0,16,20,25,"Pilot 10","Pilot 10: bigger feedback + video"
39,"SUPPRF13951",42,0,81,1,1,21,80,80,"Pilot 10","Pilot 10: bigger feedback + video"
40,"SUPPRF13951",38,0,37,-26,0,8,37,63,"Pilot 10","Pilot 10: bigger feedback + video"
41,"SUPPRF13951",42,0,41,-23,-13,14,54,64,"Pilot 10","Pilot 10: bigger feedback + video"
42,"SUPPRF13951",43,0,83,19,12,16,71,64,"Pilot 10","Pilot 10: bigger feedback + video"
43,"SUPPRF13951",42,0,88,18,25,4,63,70,"Pilot 10","Pilot 10: bigger feedback + video"
44,"SUPPRF13951",42,0,24,-32,-13,16,37,56,"Pilot 10","Pilot 10: bigger feedback + video"
45,"SUPPRF13951",40,0,66,8,12,13,54,58,"Pilot 10","Pilot 10: bigger feedback + video"
46,"SUPPRF13951",42,0,55,-5,1,14,54,60,"Pilot 10","Pilot 10: bigger feedback + video"
47,"SUPPRF13951",40,0,8,-19,-12,15,20,27,"Pilot 10","Pilot 10: bigger feedback + video"
48,"SUPPRF13951",37,0,55,-13,-16,17,71,68,"Pilot 10","Pilot 10: bigger feedback + video"
1,"SUPPRF79160",67,50,61,20,24,70,37,41,"Pilot 10","Pilot 10: bigger feedback + video"
2,"SUPPRF79160",61,34,55,0,1,71,54,55,"Pilot 10","Pilot 10: bigger feedback + video"
3,"SUPPRF79160",71,28,46,-1,0,75,46,47,"Pilot 10","Pilot 10: bigger feedback + video"
4,"SUPPRF79160",68,21,58,8,12,65,46,50,"Pilot 10","Pilot 10: bigger feedback + video"
5,"SUPPRF79160",26,8,15,-7,-14,75,29,22,"Pilot 10","Pilot 10: bigger feedback + video"
6,"SUPPRF79160",52,36,67,-8,-13,60,80,75,"Pilot 10","Pilot 10: bigger feedback + video"
7,"SUPPRF79160",50,59,54,14,0,55,54,40,"Pilot 10","Pilot 10: bigger feedback + video"
8,"SUPPRF79160",24,71,24,-16,-13,50,37,40,"Pilot 10","Pilot 10: bigger feedback + video"
9,"SUPPRF79160",39,64,37,10,0,60,37,27,"Pilot 10","Pilot 10: bigger feedback + video"
10,"SUPPRF79160",80,40,81,1,1,61,80,80,"Pilot 10","Pilot 10: bigger feedback + video"
11,"SUPPRF79160",30,67,29,5,0,70,29,24,"Pilot 10","Pilot 10: bigger feedback + video"
12,"SUPPRF79160",50,62,20,3,0,70,20,17,"Pilot 10","Pilot 10: bigger feedback + video"
13,"SUPPRF79160",52,49,28,6,-1,69,29,22,"Pilot 10","Pilot 10: bigger feedback + video"
14,"SUPPRF79160",51,50,38,-2,1,48,37,40,"Pilot 10","Pilot 10: bigger feedback + video"
15,"SUPPRF79160",68,31,78,34,24,38,54,44,"Pilot 10","Pilot 10: bigger feedback + video"
16,"SUPPRF79160",50,50,49,9,12,60,37,40,"Pilot 10","Pilot 10: bigger feedback + video"
17,"SUPPRF79160",0,69,6,-17,-14,70,20,23,"Pilot 10","Pilot 10: bigger feedback + video"
18,"SUPPRF79160",99,25,96,20,16,82,80,76,"Pilot 10","Pilot 10: bigger feedback + video"
19,"SUPPRF79160",52,49,62,-3,-1,74,63,65,"Pilot 10","Pilot 10: bigger feedback + video"
20,"SUPPRF79160",48,59,45,5,-1,71,46,40,"Pilot 10","Pilot 10: bigger feedback + video"
21,"SUPPRF79160",66,48,77,22,14,41,63,55,"Pilot 10","Pilot 10: bigger feedback + video"
22,"SUPPRF79160",51,50,66,6,12,50,54,60,"Pilot 10","Pilot 10: bigger feedback + video"
23,"SUPPRF79160",38,65,56,-14,-15,60,71,70,"Pilot 10","Pilot 10: bigger feedback + video"
24,"SUPPRF79160",51,73,35,20,15,50,20,15,"Pilot 10","Pilot 10: bigger feedback + video"
25,"SUPPRF79160",59,57,70,3,-1,50,71,67,"Pilot 10","Pilot 10: bigger feedback + video"
26,"SUPPRF79160",71,50,83,23,12,38,71,60,"Pilot 10","Pilot 10: bigger feedback + video"
27,"SUPPRF79160",14,74,8,-12,-12,40,20,20,"Pilot 10","Pilot 10: bigger feedback + video"
28,"SUPPRF79160",47,74,16,-9,-13,70,29,25,"Pilot 10","Pilot 10: bigger feedback + video"
29,"SUPPRF79160",66,72,58,37,29,37,29,21,"Pilot 10","Pilot 10: bigger feedback + video"
30,"SUPPRF79160",51,58,50,-18,-13,71,63,68,"Pilot 10","Pilot 10: bigger feedback + video"
31,"SUPPRF79160",67,34,47,30,27,60,20,17,"Pilot 10","Pilot 10: bigger feedback + video"
32,"SUPPRF79160",65,49,46,21,17,50,29,25,"Pilot 10","Pilot 10: bigger feedback + video"
33,"SUPPRF79160",26,63,38,-24,-16,52,54,62,"Pilot 10","Pilot 10: bigger feedback + video"
34,"SUPPRF79160",73,23,75,29,29,65,46,46,"Pilot 10","Pilot 10: bigger feedback + video"
35,"SUPPRF79160",52,63,63,8,0,30,63,55,"Pilot 10","Pilot 10: bigger feedback + video"
36,"SUPPRF79160",9,76,22,-22,-15,70,37,44,"Pilot 10","Pilot 10: bigger feedback + video"
37,"SUPPRF79160",33,78,19,3,-1,78,20,16,"Pilot 10","Pilot 10: bigger feedback + video"
38,"SUPPRF79160",54,34,71,-5,0,70,71,76,"Pilot 10","Pilot 10: bigger feedback + video"
39,"SUPPRF79160",50,60,41,-16,-13,66,54,57,"Pilot 10","Pilot 10: bigger feedback + video"
40,"SUPPRF79160",31,50,33,-17,-13,31,46,50,"Pilot 10","Pilot 10: bigger feedback + video"
41,"SUPPRF79160",100,18,100,26,20,81,80,74,"Pilot 10","Pilot 10: bigger feedback + video"
42,"SUPPRF79160",78,35,88,28,25,50,63,60,"Pilot 10","Pilot 10: bigger feedback + video"
43,"SUPPRF79160",100,11,94,11,23,71,71,83,"Pilot 10","Pilot 10: bigger feedback + video"
44,"SUPPRF79160",48,65,47,-13,-16,28,63,60,"Pilot 10","Pilot 10: bigger feedback + video"
45,"SUPPRF79160",26,59,68,-16,-12,80,80,84,"Pilot 10","Pilot 10: bigger feedback + video"
46,"SUPPRF79160",72,51,80,3,0,41,80,77,"Pilot 10","Pilot 10: bigger feedback + video"
47,"SUPPRF79160",34,65,34,-18,-12,26,46,52,"Pilot 10","Pilot 10: bigger feedback + video"
48,"SUPPRF79160",13,78,55,-23,-16,59,71,78,"Pilot 10","Pilot 10: bigger feedback + video"
1,"SUPPRF57557",74,27,81,2,1,72,80,79,"Pilot 10","Pilot 10: bigger feedback + video"
2,"SUPPRF57557",72,25,38,2,1,33,37,36,"Pilot 10","Pilot 10: bigger feedback + video"
3,"SUPPRF57557",76,28,8,-20,-12,35,20,28,"Pilot 10","Pilot 10: bigger feedback + video"
4,"SUPPRF57557",40,22,67,-15,-13,75,80,82,"Pilot 10","Pilot 10: bigger feedback + video"
5,"SUPPRF57557",51,21,47,22,27,45,20,25,"Pilot 10","Pilot 10: bigger feedback + video"
6,"SUPPRF57557",69,23,83,41,12,23,71,42,"Pilot 10","Pilot 10: bigger feedback + video"
7,"SUPPRF57557",77,24,68,-6,-12,69,80,74,"Pilot 10","Pilot 10: bigger feedback + video"
8,"SUPPRF57557",43,20,100,29,20,57,80,71,"Pilot 10","Pilot 10: bigger feedback + video"
9,"SUPPRF57557",68,20,61,-8,24,62,37,69,"Pilot 10","Pilot 10: bigger feedback + video"
10,"SUPPRF57557",58,20,6,-63,-14,29,20,69,"Pilot 10","Pilot 10: bigger feedback + video"
11,"SUPPRF57557",64,27,75,36,29,32,46,39,"Pilot 10","Pilot 10: bigger feedback + video"
12,"SUPPRF57557",84,25,50,-19,-13,67,63,69,"Pilot 10","Pilot 10: bigger feedback + video"
13,"SUPPRF57557",69,30,45,-19,-1,24,46,64,"Pilot 10","Pilot 10: bigger feedback + video"
14,"SUPPRF57557",71,26,70,6,-1,26,71,64,"Pilot 10","Pilot 10: bigger feedback + video"
15,"SUPPRF57557",66,31,55,-10,1,52,54,65,"Pilot 10","Pilot 10: bigger feedback + video"
16,"SUPPRF57557",58,31,33,-12,-13,60,46,45,"Pilot 10","Pilot 10: bigger feedback + video"
17,"SUPPRF57557",57,23,58,33,29,72,29,25,"Pilot 10","Pilot 10: bigger feedback + video"
18,"SUPPRF57557",58,25,41,-17,-13,34,54,58,"Pilot 10","Pilot 10: bigger feedback + video"
19,"SUPPRF57557",67,33,29,-10,0,30,29,39,"Pilot 10","Pilot 10: bigger feedback + video"
20,"SUPPRF57557",69,24,88,36,25,65,63,52,"Pilot 10","Pilot 10: bigger feedback + video"
21,"SUPPRF57557",69,24,66,1,12,48,54,65,"Pilot 10","Pilot 10: bigger feedback + video"
22,"SUPPRF57557",72,22,28,0,-1,62,29,28,"Pilot 10","Pilot 10: bigger feedback + video"
23,"SUPPRF57557",64,25,54,0,0,69,54,54,"Pilot 10","Pilot 10: bigger feedback + video"
24,"SUPPRF57557",70,35,38,-5,-16,52,54,43,"Pilot 10","Pilot 10: bigger feedback + video"
25,"SUPPRF57557",63,27,47,5,-16,61,63,42,"Pilot 10","Pilot 10: bigger feedback + video"
26,"SUPPRF57557",80,37,71,-2,0,46,71,73,"Pilot 10","Pilot 10: bigger feedback + video"
27,"SUPPRF57557",46,22,16,-47,-13,42,29,63,"Pilot 10","Pilot 10: bigger feedback + video"
28,"SUPPRF57557",65,27,24,-15,-13,47,37,39,"Pilot 10","Pilot 10: bigger feedback + video"
29,"SUPPRF57557",77,17,55,1,-16,61,71,54,"Pilot 10","Pilot 10: bigger feedback + video"
30,"SUPPRF57557",67,25,62,-11,-1,64,63,73,"Pilot 10","Pilot 10: bigger feedback + video"
31,"SUPPRF57557",69,15,94,36,23,68,71,58,"Pilot 10","Pilot 10: bigger feedback + video"
32,"SUPPRF57557",72,26,20,-17,0,50,20,37,"Pilot 10","Pilot 10: bigger feedback + video"
33,"SUPPRF57557",52,23,15,-18,-14,64,29,33,"Pilot 10","Pilot 10: bigger feedback + video"
34,"SUPPRF57557",44,29,19,-16,-1,41,20,35,"Pilot 10","Pilot 10: bigger feedback + video"
35,"SUPPRF57557",60,22,37,4,0,61,37,33,"Pilot 10","Pilot 10: bigger feedback + video"
36,"SUPPRF57557",77,35,77,7,14,71,63,70,"Pilot 10","Pilot 10: bigger feedback + video"
37,"SUPPRF57557",70,27,80,0,0,73,80,80,"Pilot 10","Pilot 10: bigger feedback + video"
38,"SUPPRF57557",71,24,63,0,0,66,63,63,"Pilot 10","Pilot 10: bigger feedback + video"
39,"SUPPRF57557",65,37,22,-12,-15,55,37,34,"Pilot 10","Pilot 10: bigger feedback + video"
40,"SUPPRF57557",57,23,35,-5,15,32,20,40,"Pilot 10","Pilot 10: bigger feedback + video"
41,"SUPPRF57557",66,25,34,-3,-12,68,46,37,"Pilot 10","Pilot 10: bigger feedback + video"
42,"SUPPRF57557",74,34,78,35,24,35,54,43,"Pilot 10","Pilot 10: bigger feedback + video"
43,"SUPPRF57557",73,31,96,40,16,38,80,56,"Pilot 10","Pilot 10: bigger feedback + video"
44,"SUPPRF57557",58,4,58,2,12,39,46,56,"Pilot 10","Pilot 10: bigger feedback + video"
45,"SUPPRF57557",69,27,56,21,-15,26,71,35,"Pilot 10","Pilot 10: bigger feedback + video"
46,"SUPPRF57557",66,11,49,6,12,72,37,43,"Pilot 10","Pilot 10: bigger feedback + video"
47,"SUPPRF57557",68,23,46,5,17,57,29,41,"Pilot 10","Pilot 10: bigger feedback + video"
48,"SUPPRF57557",78,27,46,-7,0,62,46,53,"Pilot 10","Pilot 10: bigger feedback + video"
1,"SUPPRF12856",49,54,46,6,17,60,29,40,"Pilot 10","Pilot 10: bigger feedback + video"
2,"SUPPRF12856",52,47,54,6,0,43,54,48,"Pilot 10","Pilot 10: bigger feedback + video"
3,"SUPPRF12856",39,62,38,-14,-16,68,54,52,"Pilot 10","Pilot 10: bigger feedback + video"
4,"SUPPRF12856",51,55,71,11,0,55,71,60,"Pilot 10","Pilot 10: bigger feedback + video"
5,"SUPPRF12856",37,65,55,-15,1,32,54,70,"Pilot 10","Pilot 10: bigger feedback + video"
6,"SUPPRF12856",40,63,68,-12,-12,32,80,80,"Pilot 10","Pilot 10: bigger feedback + video"
7,"SUPPRF12856",19,72,6,-24,-14,62,20,30,"Pilot 10","Pilot 10: bigger feedback + video"
8,"SUPPRF12856",42,73,56,-19,-15,68,71,75,"Pilot 10","Pilot 10: bigger feedback + video"
9,"SUPPRF12856",41,63,63,-12,0,39,63,75,"Pilot 10","Pilot 10: bigger feedback + video"
10,"SUPPRF12856",39,48,80,15,0,35,80,65,"Pilot 10","Pilot 10: bigger feedback + video"
11,"SUPPRF12856",40,43,45,-11,-1,49,46,56,"Pilot 10","Pilot 10: bigger feedback + video"
12,"SUPPRF12856",43,48,58,8,12,37,46,50,"Pilot 10","Pilot 10: bigger feedback + video"
13,"SUPPRF12856",37,59,38,5,1,31,37,33,"Pilot 10","Pilot 10: bigger feedback + video"
14,"SUPPRF12856",38,54,61,35,24,38,37,26,"Pilot 10","Pilot 10: bigger feedback + video"
15,"SUPPRF12856",47,51,81,14,1,60,80,67,"Pilot 10","Pilot 10: bigger feedback + video"
16,"SUPPRF12856",43,66,34,13,-12,16,46,21,"Pilot 10","Pilot 10: bigger feedback + video"
17,"SUPPRF12856",45,55,41,-12,-13,52,54,53,"Pilot 10","Pilot 10: bigger feedback + video"
18,"SUPPRF12856",56,43,88,28,25,60,63,60,"Pilot 10","Pilot 10: bigger feedback + video"
19,"SUPPRF12856",37,59,8,-2,-12,75,20,10,"Pilot 10","Pilot 10: bigger feedback + video"
20,"SUPPRF12856",46,51,47,-16,-16,33,63,63,"Pilot 10","Pilot 10: bigger feedback + video"
21,"SUPPRF12856",50,39,46,-10,0,52,46,56,"Pilot 10","Pilot 10: bigger feedback + video"
22,"SUPPRF12856",43,56,28,-22,-1,62,29,50,"Pilot 10","Pilot 10: bigger feedback + video"
23,"SUPPRF12856",53,59,62,17,-1,54,63,45,"Pilot 10","Pilot 10: bigger feedback + video"
24,"SUPPRF12856",39,43,33,-27,-13,44,46,60,"Pilot 10","Pilot 10: bigger feedback + video"
25,"SUPPRF12856",34,37,37,-5,0,22,37,42,"Pilot 10","Pilot 10: bigger feedback + video"
26,"SUPPRF12856",38,59,55,-15,-16,65,71,70,"Pilot 10","Pilot 10: bigger feedback + video"
27,"SUPPRF12856",42,57,49,10,12,27,37,39,"Pilot 10","Pilot 10: bigger feedback + video"
28,"SUPPRF12856",55,49,100,40,20,60,80,60,"Pilot 10","Pilot 10: bigger feedback + video"
29,"SUPPRF12856",48,64,67,-18,-13,74,80,85,"Pilot 10","Pilot 10: bigger feedback + video"
30,"SUPPRF12856",38,54,50,0,-13,39,63,50,"Pilot 10","Pilot 10: bigger feedback + video"
31,"SUPPRF12856",57,51,94,26,23,65,71,68,"Pilot 10","Pilot 10: bigger feedback + video"
32,"SUPPRF12856",56,50,77,37,14,28,63,40,"Pilot 10","Pilot 10: bigger feedback + video"
33,"SUPPRF12856",41,41,29,-6,0,67,29,35,"Pilot 10","Pilot 10: bigger feedback + video"
34,"SUPPRF12856",41,42,70,10,-1,46,71,60,"Pilot 10","Pilot 10: bigger feedback + video"
35,"SUPPRF12856",40,44,78,28,24,28,54,50,"Pilot 10","Pilot 10: bigger feedback + video"
36,"SUPPRF12856",39,47,66,6,12,62,54,60,"Pilot 10","Pilot 10: bigger feedback + video"
37,"SUPPRF12856",33,41,35,19,15,71,20,16,"Pilot 10","Pilot 10: bigger feedback + video"
38,"SUPPRF12856",45,39,75,21,29,39,46,54,"Pilot 10","Pilot 10: bigger feedback + video"
39,"SUPPRF12856",58,47,96,16,16,79,80,80,"Pilot 10","Pilot 10: bigger feedback + video"
40,"SUPPRF12856",38,52,19,4,-1,69,20,15,"Pilot 10","Pilot 10: bigger feedback + video"
41,"SUPPRF12856",36,40,15,-5,-14,72,29,20,"Pilot 10","Pilot 10: bigger feedback + video"
42,"SUPPRF12856",42,41,47,36,27,75,20,11,"Pilot 10","Pilot 10: bigger feedback + video"
43,"SUPPRF12856",33,61,24,-33,-13,17,37,57,"Pilot 10","Pilot 10: bigger feedback + video"
44,"SUPPRF12856",42,61,58,26,29,56,29,32,"Pilot 10","Pilot 10: bigger feedback + video"
45,"SUPPRF12856",54,59,83,1,12,65,71,82,"Pilot 10","Pilot 10: bigger feedback + video"
46,"SUPPRF12856",43,60,16,-14,-13,39,29,30,"Pilot 10","Pilot 10: bigger feedback + video"
47,"SUPPRF12856",39,66,22,-48,-15,40,37,70,"Pilot 10","Pilot 10: bigger feedback + video"
48,"SUPPRF12856",41,51,20,13,0,73,20,7,"Pilot 10","Pilot 10: bigger feedback + video"
1,"SUPPRF26467",93,9,28,-19,-1,78,29,47,"Pilot 10","Pilot 10: bigger feedback + video"
2,"SUPPRF26467",49,0,47,13,27,60,20,34,"Pilot 10","Pilot 10: bigger feedback + video"
3,"SUPPRF26467",100,9,35,-26,15,40,20,61,"Pilot 10","Pilot 10: bigger feedback + video"
4,"SUPPRF26467",93,0,94,6,23,88,71,88,"Pilot 10","Pilot 10: bigger feedback + video"
5,"SUPPRF26467",79,0,38,-8,-16,4,54,46,"Pilot 10","Pilot 10: bigger feedback + video"
6,"SUPPRF26467",50,0,29,-28,0,37,29,57,"Pilot 10","Pilot 10: bigger feedback + video"
7,"SUPPRF26467",75,7,49,-20,12,51,37,69,"Pilot 10","Pilot 10: bigger feedback + video"
8,"SUPPRF26467",75,0,75,2,29,52,46,73,"Pilot 10","Pilot 10: bigger feedback + video"
9,"SUPPRF26467",68,0,37,-19,0,28,37,56,"Pilot 10","Pilot 10: bigger feedback + video"
10,"SUPPRF26467",65,4,58,-15,29,68,29,73,"Pilot 10","Pilot 10: bigger feedback + video"
11,"SUPPRF26467",86,14,16,-53,-13,46,29,69,"Pilot 10","Pilot 10: bigger feedback + video"
12,"SUPPRF26467",90,6,19,-32,-1,63,20,51,"Pilot 10","Pilot 10: bigger feedback + video"
13,"SUPPRF26467",81,5,55,-9,-16,48,71,64,"Pilot 10","Pilot 10: bigger feedback + video"
14,"SUPPRF26467",89,0,88,14,25,15,63,74,"Pilot 10","Pilot 10: bigger feedback + video"
15,"SUPPRF26467",92,0,83,10,12,7,71,73,"Pilot 10","Pilot 10: bigger feedback + video"
16,"SUPPRF26467",95,3,15,-34,-14,10,29,49,"Pilot 10","Pilot 10: bigger feedback + video"
17,"SUPPRF26467",75,10,46,-12,17,36,29,58,"Pilot 10","Pilot 10: bigger feedback + video"
18,"SUPPRF26467",94,11,66,0,12,27,54,66,"Pilot 10","Pilot 10: bigger feedback + video"
19,"SUPPRF26467",67,26,45,-20,-1,12,46,65,"Pilot 10","Pilot 10: bigger feedback + video"
20,"SUPPRF26467",87,15,54,-4,0,26,54,58,"Pilot 10","Pilot 10: bigger feedback + video"
21,"SUPPRF26467",77,12,55,0,1,14,54,55,"Pilot 10","Pilot 10: bigger feedback + video"
22,"SUPPRF26467",29,47,62,2,-1,17,63,60,"Pilot 10","Pilot 10: bigger feedback + video"
23,"SUPPRF26467",71,15,80,18,0,44,80,62,"Pilot 10","Pilot 10: bigger feedback + video"
24,"SUPPRF26467",15,69,50,-17,-13,21,63,67,"Pilot 10","Pilot 10: bigger feedback + video"
25,"SUPPRF26467",21,78,78,11,24,35,54,67,"Pilot 10","Pilot 10: bigger feedback + video"
26,"SUPPRF26467",51,53,81,5,1,32,80,76,"Pilot 10","Pilot 10: bigger feedback + video"
27,"SUPPRF26467",86,1,6,-48,-14,17,20,54,"Pilot 10","Pilot 10: bigger feedback + video"
28,"SUPPRF26467",74,20,61,12,24,15,37,49,"Pilot 10","Pilot 10: bigger feedback + video"
29,"SUPPRF26467",76,13,33,31,-13,36,46,2,"Pilot 10","Pilot 10: bigger feedback + video"
30,"SUPPRF26467",64,20,38,-15,1,24,37,53,"Pilot 10","Pilot 10: bigger feedback + video"
31,"SUPPRF26467",41,36,47,4,-16,44,63,43,"Pilot 10","Pilot 10: bigger feedback + video"
32,"SUPPRF26467",48,44,46,-10,0,24,46,56,"Pilot 10","Pilot 10: bigger feedback + video"
33,"SUPPRF26467",5,70,8,-45,-12,36,20,53,"Pilot 10","Pilot 10: bigger feedback + video"
34,"SUPPRF26467",49,47,58,-3,12,41,46,61,"Pilot 10","Pilot 10: bigger feedback + video"
35,"SUPPRF26467",50,23,63,15,0,11,63,48,"Pilot 10","Pilot 10: bigger feedback + video"
36,"SUPPRF26467",51,23,22,-31,-15,40,37,53,"Pilot 10","Pilot 10: bigger feedback + video"
37,"SUPPRF26467",97,3,100,3,20,21,80,97,"Pilot 10","Pilot 10: bigger feedback + video"
38,"SUPPRF26467",87,15,20,-27,0,8,20,47,"Pilot 10","Pilot 10: bigger feedback + video"
39,"SUPPRF26467",72,19,24,-34,-13,35,37,58,"Pilot 10","Pilot 10: bigger feedback + video"
40,"SUPPRF26467",70,16,67,-8,-13,23,80,75,"Pilot 10","Pilot 10: bigger feedback + video"
41,"SUPPRF26467",85,10,96,3,16,4,80,93,"Pilot 10","Pilot 10: bigger feedback + video"
42,"SUPPRF26467",45,31,34,-35,-12,28,46,69,"Pilot 10","Pilot 10: bigger feedback + video"
43,"SUPPRF26467",70,5,70,17,-1,22,71,53,"Pilot 10","Pilot 10: bigger feedback + video"
44,"SUPPRF26467",46,51,56,-3,-15,38,71,59,"Pilot 10","Pilot 10: bigger feedback + video"
45,"SUPPRF26467",55,39,71,21,0,47,71,50,"Pilot 10","Pilot 10: bigger feedback + video"
46,"SUPPRF26467",43,51,68,16,-12,23,80,52,"Pilot 10","Pilot 10: bigger feedback + video"
47,"SUPPRF26467",67,33,41,-8,-13,29,54,49,"Pilot 10","Pilot 10: bigger feedback + video"
48,"SUPPRF26467",52,37,77,14,14,40,63,63,"Pilot 10","Pilot 10: bigger feedback + video"
1,"SUPPRF12547",68,67,81,6,1,80,80,75,"Pilot 10","Pilot 10: bigger feedback + video"
2,"SUPPRF12547",66,53,6,-19,-14,88,20,25,"Pilot 10","Pilot 10: bigger feedback + video"
3,"SUPPRF12547",65,51,77,17,14,62,63,60,"Pilot 10","Pilot 10: bigger feedback + video"
4,"SUPPRF12547",68,52,67,-10,-13,60,80,77,"Pilot 10","Pilot 10: bigger feedback + video"
5,"SUPPRF12547",51,37,8,-7,-12,22,20,15,"Pilot 10","Pilot 10: bigger feedback + video"
6,"SUPPRF12547",53,36,83,13,12,30,71,70,"Pilot 10","Pilot 10: bigger feedback + video"
7,"SUPPRF12547",51,24,46,11,17,35,29,35,"Pilot 10","Pilot 10: bigger feedback + video"
8,"SUPPRF12547",62,12,88,23,25,60,63,65,"Pilot 10","Pilot 10: bigger feedback + video"
9,"SUPPRF12547",68,13,94,24,23,73,71,70,"Pilot 10","Pilot 10: bigger feedback + video"
10,"SUPPRF12547",60,1,33,-17,-13,50,46,50,"Pilot 10","Pilot 10: bigger feedback + video"
11,"SUPPRF12547",52,3,37,-3,0,31,37,40,"Pilot 10","Pilot 10: bigger feedback + video"
12,"SUPPRF12547",62,7,50,-25,-13,69,63,75,"Pilot 10","Pilot 10: bigger feedback + video"
13,"SUPPRF12547",69,1,100,20,20,75,80,80,"Pilot 10","Pilot 10: bigger feedback + video"
14,"SUPPRF12547",63,0,24,4,-13,66,37,20,"Pilot 10","Pilot 10: bigger feedback + video"
15,"SUPPRF12547",67,0,45,21,-1,80,46,24,"Pilot 10","Pilot 10: bigger feedback + video"
16,"SUPPRF12547",66,3,41,-9,-13,80,54,50,"Pilot 10","Pilot 10: bigger feedback + video"
17,"SUPPRF12547",59,0,47,-20,-16,68,63,67,"Pilot 10","Pilot 10: bigger feedback + video"
18,"SUPPRF12547",54,0,46,3,0,66,46,43,"Pilot 10","Pilot 10: bigger feedback + video"
19,"SUPPRF12547",53,0,22,-5,-15,74,37,27,"Pilot 10","Pilot 10: bigger feedback + video"
20,"SUPPRF12547",68,0,78,21,24,65,54,57,"Pilot 10","Pilot 10: bigger feedback + video"
21,"SUPPRF12547",55,0,29,-8,0,70,29,37,"Pilot 10","Pilot 10: bigger feedback + video"
22,"SUPPRF12547",52,0,49,34,12,73,37,15,"Pilot 10","Pilot 10: bigger feedback + video"
23,"SUPPRF12547",51,0,62,-3,-1,61,63,65,"Pilot 10","Pilot 10: bigger feedback + video"
24,"SUPPRF12547",50,1,55,-10,-16,56,71,65,"Pilot 10","Pilot 10: bigger feedback + video"
25,"SUPPRF12547",49,0,54,-16,0,70,54,70,"Pilot 10","Pilot 10: bigger feedback + video"
26,"SUPPRF12547",53,0,61,36,24,75,37,25,"Pilot 10","Pilot 10: bigger feedback + video"
27,"SUPPRF12547",58,0,58,3,12,69,46,55,"Pilot 10","Pilot 10: bigger feedback + video"
28,"SUPPRF12547",50,0,20,12,0,86,20,8,"Pilot 10","Pilot 10: bigger feedback + video"
29,"SUPPRF12547",52,0,28,-2,-1,70,29,30,"Pilot 10","Pilot 10: bigger feedback + video"
30,"SUPPRF12547",51,1,56,-19,-15,80,71,75,"Pilot 10","Pilot 10: bigger feedback + video"
31,"SUPPRF12547",51,1,75,47,29,27,46,28,"Pilot 10","Pilot 10: bigger feedback + video"
32,"SUPPRF12547",52,1,63,-2,0,78,63,65,"Pilot 10","Pilot 10: bigger feedback + video"
33,"SUPPRF12547",45,0,70,16,-1,87,71,54,"Pilot 10","Pilot 10: bigger feedback + video"
34,"SUPPRF12547",48,0,16,-20,-13,60,29,36,"Pilot 10","Pilot 10: bigger feedback + video"
35,"SUPPRF12547",56,1,71,1,0,98,71,70,"Pilot 10","Pilot 10: bigger feedback + video"
36,"SUPPRF12547",48,0,34,-3,-12,25,46,37,"Pilot 10","Pilot 10: bigger feedback + video"
37,"SUPPRF12547",50,0,55,0,1,51,54,55,"Pilot 10","Pilot 10: bigger feedback + video"
38,"SUPPRF12547",45,0,19,-1,-1,61,20,20,"Pilot 10","Pilot 10: bigger feedback + video"
39,"SUPPRF12547",40,1,68,3,-12,51,80,65,"Pilot 10","Pilot 10: bigger feedback + video"
40,"SUPPRF12547",47,0,38,2,1,75,37,36,"Pilot 10","Pilot 10: bigger feedback + video"
41,"SUPPRF12547",51,1,58,31,29,77,29,27,"Pilot 10","Pilot 10: bigger feedback + video"
42,"SUPPRF12547",53,1,80,10,0,72,80,70,"Pilot 10","Pilot 10: bigger feedback + video"
43,"SUPPRF12547",51,1,96,16,16,79,80,80,"Pilot 10","Pilot 10: bigger feedback + video"
44,"SUPPRF12547",52,1,66,10,12,71,54,56,"Pilot 10","Pilot 10: bigger feedback + video"
45,"SUPPRF12547",50,0,35,15,15,80,20,20,"Pilot 10","Pilot 10: bigger feedback + video"
46,"SUPPRF12547",46,3,15,-35,-14,50,29,50,"Pilot 10","Pilot 10: bigger feedback + video"
47,"SUPPRF12547",49,6,38,-22,-16,76,54,60,"Pilot 10","Pilot 10: bigger feedback + video"
48,"SUPPRF12547",50,10,47,32,27,82,20,15,"Pilot 10","Pilot 10: bigger feedback + video"
1,"SUPPRF33361",53,32,15,-10,-14,43,29,25,"Pilot 10","Pilot 10: bigger feedback + video"
2,"SUPPRF33361",50,27,20,2,0,16,20,18,"Pilot 10","Pilot 10: bigger feedback + video"
3,"SUPPRF33361",57,9,28,6,-1,17,29,22,"Pilot 10","Pilot 10: bigger feedback + video"
4,"SUPPRF33361",57,27,8,-34,-12,18,20,42,"Pilot 10","Pilot 10: bigger feedback + video"
5,"SUPPRF33361",61,28,50,14,-13,24,63,36,"Pilot 10","Pilot 10: bigger feedback + video"
6,"SUPPRF33361",57,31,49,16,12,17,37,33,"Pilot 10","Pilot 10: bigger feedback + video"
7,"SUPPRF33361",64,30,46,-22,0,20,46,68,"Pilot 10","Pilot 10: bigger feedback + video"
8,"SUPPRF33361",64,23,24,-9,-13,28,37,33,"Pilot 10","Pilot 10: bigger feedback + video"
9,"SUPPRF33361",60,29,35,26,15,67,20,9,"Pilot 10","Pilot 10: bigger feedback + video"
10,"SUPPRF33361",74,28,94,63,23,15,71,31,"Pilot 10","Pilot 10: bigger feedback + video"
11,"SUPPRF33361",65,33,70,14,-1,15,71,56,"Pilot 10","Pilot 10: bigger feedback + video"
12,"SUPPRF33361",58,36,47,22,27,25,20,25,"Pilot 10","Pilot 10: bigger feedback + video"
13,"SUPPRF33361",54,38,47,-10,-16,53,63,57,"Pilot 10","Pilot 10: bigger feedback + video"
14,"SUPPRF33361",47,57,81,20,1,53,80,61,"Pilot 10","Pilot 10: bigger feedback + video"
15,"SUPPRF33361",39,56,55,-3,-16,5,71,58,"Pilot 10","Pilot 10: bigger feedback + video"
16,"SUPPRF33361",67,79,38,2,1,84,37,36,"Pilot 10","Pilot 10: bigger feedback + video"
17,"SUPPRF33361",34,66,56,-19,-15,67,71,75,"Pilot 10","Pilot 10: bigger feedback + video"
18,"SUPPRF33361",42,60,78,11,24,69,54,67,"Pilot 10","Pilot 10: bigger feedback + video"
19,"SUPPRF33361",39,63,46,3,17,51,29,43,"Pilot 10","Pilot 10: bigger feedback + video"
20,"SUPPRF33361",33,63,45,-10,-1,49,46,55,"Pilot 10","Pilot 10: bigger feedback + video"
21,"SUPPRF33361",27,71,33,-21,-13,17,46,54,"Pilot 10","Pilot 10: bigger feedback + video"
22,"SUPPRF33361",32,63,77,7,14,52,63,70,"Pilot 10","Pilot 10: bigger feedback + video"
23,"SUPPRF33361",37,59,67,-11,-13,18,80,78,"Pilot 10","Pilot 10: bigger feedback + video"
24,"SUPPRF33361",34,64,34,-8,-12,28,46,42,"Pilot 10","Pilot 10: bigger feedback + video"
25,"SUPPRF33361",51,47,63,0,0,29,63,63,"Pilot 10","Pilot 10: bigger feedback + video"
26,"SUPPRF33361",47,48,83,15,12,71,71,68,"Pilot 10","Pilot 10: bigger feedback + video"
27,"SUPPRF33361",37,62,55,-14,1,51,54,69,"Pilot 10","Pilot 10: bigger feedback + video"
28,"SUPPRF33361",43,66,41,-9,-13,3,54,50,"Pilot 10","Pilot 10: bigger feedback + video"
29,"SUPPRF33361",52,50,16,-14,-13,52,29,30,"Pilot 10","Pilot 10: bigger feedback + video"
30,"SUPPRF33361",32,59,75,24,29,55,46,51,"Pilot 10","Pilot 10: bigger feedback + video"
31,"SUPPRF33361",38,55,66,17,12,24,54,49,"Pilot 10","Pilot 10: bigger feedback + video"
32,"SUPPRF33361",5,68,37,-26,0,53,37,63,"Pilot 10","Pilot 10: bigger feedback + video"
33,"SUPPRF33361",22,71,96,24,16,14,80,72,"Pilot 10","Pilot 10: bigger feedback + video"
34,"SUPPRF33361",0,64,38,-31,-16,45,54,69,"Pilot 10","Pilot 10: bigger feedback + video"
35,"SUPPRF33361",2,61,58,-3,29,34,29,61,"Pilot 10","Pilot 10: bigger feedback + video"
36,"SUPPRF33361",1,62,29,-4,0,35,29,33,"Pilot 10","Pilot 10: bigger feedback + video"
37,"SUPPRF33361",7,79,88,40,25,16,63,48,"Pilot 10","Pilot 10: bigger feedback + video"
38,"SUPPRF33361",1,98,71,6,0,71,71,65,"Pilot 10","Pilot 10: bigger feedback + video"
39,"SUPPRF33361",6,95,19,-38,-1,32,20,57,"Pilot 10","Pilot 10: bigger feedback + video"
40,"SUPPRF33361",41,78,54,-4,0,26,54,58,"Pilot 10","Pilot 10: bigger feedback + video"
41,"SUPPRF33361",5,86,100,13,20,77,80,87,"Pilot 10","Pilot 10: bigger feedback + video"
42,"SUPPRF33361",0,98,58,17,12,13,46,41,"Pilot 10","Pilot 10: bigger feedback + video"
43,"SUPPRF33361",2,80,62,3,-1,19,63,59,"Pilot 10","Pilot 10: bigger feedback + video"
44,"SUPPRF33361",1,84,80,34,0,12,80,46,"Pilot 10","Pilot 10: bigger feedback + video"
45,"SUPPRF33361",3,88,22,-39,-15,33,37,61,"Pilot 10","Pilot 10: bigger feedback + video"
46,"SUPPRF33361",1,98,68,-18,-12,16,80,86,"Pilot 10","Pilot 10: bigger feedback + video"
47,"SUPPRF33361",6,65,61,-8,24,34,37,69,"Pilot 10","Pilot 10: bigger feedback + video"
48,"SUPPRF33361",15,75,6,-68,-14,38,20,74,"Pilot 10","Pilot 10: bigger feedback + video"
1,"SUPPRF71005",50,65,55,15,1,80,54,40,"Pilot 10","Pilot 10: bigger feedback + video"
2,"SUPPRF71005",52,50,38,18,1,80,37,20,"Pilot 10","Pilot 10: bigger feedback + video"
3,"SUPPRF71005",50,50,35,20,15,81,20,15,"Pilot 10","Pilot 10: bigger feedback + video"
4,"SUPPRF71005",60,42,29,-2,0,68,29,31,"Pilot 10","Pilot 10: bigger feedback + video"
5,"SUPPRF71005",53,45,62,7,-1,70,63,55,"Pilot 10","Pilot 10: bigger feedback + video"
6,"SUPPRF71005",55,42,80,10,0,73,80,70,"Pilot 10","Pilot 10: bigger feedback + video"
7,"SUPPRF71005",63,37,88,18,25,75,63,70,"Pilot 10","Pilot 10: bigger feedback + video"
8,"SUPPRF71005",39,48,28,-26,-1,63,29,54,"Pilot 10","Pilot 10: bigger feedback + video"
9,"SUPPRF71005",57,50,56,-9,-15,54,71,65,"Pilot 10","Pilot 10: bigger feedback + video"
10,"SUPPRF71005",59,48,77,8,14,64,63,69,"Pilot 10","Pilot 10: bigger feedback + video"
11,"SUPPRF71005",58,50,46,-22,0,70,46,68,"Pilot 10","Pilot 10: bigger feedback + video"
12,"SUPPRF71005",56,50,55,11,-16,44,71,44,"Pilot 10","Pilot 10: bigger feedback + video"
13,"SUPPRF71005",54,44,70,18,-1,60,71,52,"Pilot 10","Pilot 10: bigger feedback + video"
14,"SUPPRF71005",56,41,47,25,27,74,20,22,"Pilot 10","Pilot 10: bigger feedback + video"
15,"SUPPRF71005",61,45,34,-16,-12,40,46,50,"Pilot 10","Pilot 10: bigger feedback + video"
16,"SUPPRF71005",51,50,33,-2,-13,40,46,35,"Pilot 10","Pilot 10: bigger feedback + video"
17,"SUPPRF71005",50,50,46,10,17,43,29,36,"Pilot 10","Pilot 10: bigger feedback + video"
18,"SUPPRF71005",34,56,15,-46,-14,35,29,61,"Pilot 10","Pilot 10: bigger feedback + video"
19,"SUPPRF71005",31,62,6,-14,-14,69,20,20,"Pilot 10","Pilot 10: bigger feedback + video"
20,"SUPPRF71005",51,49,20,12,0,58,20,8,"Pilot 10","Pilot 10: bigger feedback + video"
21,"SUPPRF71005",53,51,66,28,12,33,54,38,"Pilot 10","Pilot 10: bigger feedback + video"
22,"SUPPRF71005",57,58,58,27,12,61,46,31,"Pilot 10","Pilot 10: bigger feedback + video"
23,"SUPPRF71005",50,51,19,-1,-1,41,20,20,"Pilot 10","Pilot 10: bigger feedback + video"
24,"SUPPRF71005",53,49,37,7,0,51,37,30,"Pilot 10","Pilot 10: bigger feedback + video"
25,"SUPPRF71005",25,42,8,-6,-12,67,20,14,"Pilot 10","Pilot 10: bigger feedback + video"
26,"SUPPRF71005",56,45,58,30,29,55,29,28,"Pilot 10","Pilot 10: bigger feedback + video"
27,"SUPPRF71005",60,44,96,66,16,54,80,30,"Pilot 10","Pilot 10: bigger feedback + video"
28,"SUPPRF71005",56,48,16,11,-13,31,29,5,"Pilot 10","Pilot 10: bigger feedback + video"
29,"SUPPRF71005",39,58,47,22,-16,55,63,25,"Pilot 10","Pilot 10: bigger feedback + video"
30,"SUPPRF71005",50,40,68,53,-12,38,80,15,"Pilot 10","Pilot 10: bigger feedback + video"
31,"SUPPRF71005",44,44,38,5,-16,52,54,33,"Pilot 10","Pilot 10: bigger feedback + video"
32,"SUPPRF71005",78,42,100,24,20,72,80,76,"Pilot 10","Pilot 10: bigger feedback + video"
33,"SUPPRF71005",56,43,75,42,29,45,46,33,"Pilot 10","Pilot 10: bigger feedback + video"
34,"SUPPRF71005",61,44,67,-15,-13,76,80,82,"Pilot 10","Pilot 10: bigger feedback + video"
35,"SUPPRF71005",60,50,50,-14,-13,71,63,64,"Pilot 10","Pilot 10: bigger feedback + video"
36,"SUPPRF71005",59,45,71,35,0,46,71,36,"Pilot 10","Pilot 10: bigger feedback + video"
37,"SUPPRF71005",46,55,24,-23,-13,45,37,47,"Pilot 10","Pilot 10: bigger feedback + video"
38,"SUPPRF71005",52,41,22,16,-15,34,37,6,"Pilot 10","Pilot 10: bigger feedback + video"
39,"SUPPRF71005",51,52,49,-25,12,65,37,74,"Pilot 10","Pilot 10: bigger feedback + video"
40,"SUPPRF71005",49,57,54,15,0,53,54,39,"Pilot 10","Pilot 10: bigger feedback + video"
41,"SUPPRF71005",52,50,45,29,-1,31,46,16,"Pilot 10","Pilot 10: bigger feedback + video"
42,"SUPPRF71005",50,50,61,20,24,42,37,41,"Pilot 10","Pilot 10: bigger feedback + video"
43,"SUPPRF71005",51,51,78,25,24,52,54,53,"Pilot 10","Pilot 10: bigger feedback + video"
44,"SUPPRF71005",49,48,94,76,23,51,71,18,"Pilot 10","Pilot 10: bigger feedback + video"
45,"SUPPRF71005",52,39,83,11,12,72,71,72,"Pilot 10","Pilot 10: bigger feedback + video"
46,"SUPPRF71005",48,42,63,14,0,52,63,49,"Pilot 10","Pilot 10: bigger feedback + video"
47,"SUPPRF71005",53,50,41,-30,-13,55,54,71,"Pilot 10","Pilot 10: bigger feedback + video"
48,"SUPPRF71005",47,33,81,13,1,67,80,68,"Pilot 10","Pilot 10: bigger feedback + video"
1,"SUPPRF51078",58,54,70,1,-1,61,71,69,"Pilot 10","Pilot 10: bigger feedback + video"
2,"SUPPRF51078",47,49,66,13,12,54,54,53,"Pilot 10","Pilot 10: bigger feedback + video"
3,"SUPPRF51078",49,42,29,-30,0,66,29,59,"Pilot 10","Pilot 10: bigger feedback + video"
4,"SUPPRF51078",46,50,83,4,12,65,71,79,"Pilot 10","Pilot 10: bigger feedback + video"
5,"SUPPRF51078",45,54,35,-24,15,57,20,59,"Pilot 10","Pilot 10: bigger feedback + video"
6,"SUPPRF51078",59,60,47,-19,-16,68,63,66,"Pilot 10","Pilot 10: bigger feedback + video"
7,"SUPPRF51078",53,55,55,-9,1,61,54,64,"Pilot 10","Pilot 10: bigger feedback + video"
8,"SUPPRF51078",56,57,33,-25,-13,54,46,58,"Pilot 10","Pilot 10: bigger feedback + video"
9,"SUPPRF51078",47,44,94,26,23,49,71,68,"Pilot 10","Pilot 10: bigger feedback + video"
10,"SUPPRF51078",57,50,61,1,24,66,37,60,"Pilot 10","Pilot 10: bigger feedback + video"
11,"SUPPRF51078",54,59,50,-14,-13,60,63,64,"Pilot 10","Pilot 10: bigger feedback + video"
12,"SUPPRF51078",45,52,22,-44,-15,65,37,66,"Pilot 10","Pilot 10: bigger feedback + video"
13,"SUPPRF51078",49,52,38,-34,-16,55,54,72,"Pilot 10","Pilot 10: bigger feedback + video"
14,"SUPPRF51078",45,55,46,-27,0,67,46,73,"Pilot 10","Pilot 10: bigger feedback + video"
15,"SUPPRF51078",59,42,68,1,-12,46,80,67,"Pilot 10","Pilot 10: bigger feedback + video"
16,"SUPPRF51078",64,47,49,16,12,45,37,33,"Pilot 10","Pilot 10: bigger feedback + video"
17,"SUPPRF51078",76,47,96,23,16,53,80,73,"Pilot 10","Pilot 10: bigger feedback + video"
18,"SUPPRF51078",48,51,75,15,29,68,46,60,"Pilot 10","Pilot 10: bigger feedback + video"
19,"SUPPRF51078",47,56,34,-24,-12,40,46,58,"Pilot 10","Pilot 10: bigger feedback + video"
20,"SUPPRF51078",50,41,8,-41,-12,37,20,49,"Pilot 10","Pilot 10: bigger feedback + video"
21,"SUPPRF51078",53,53,41,-10,-13,57,54,51,"Pilot 10","Pilot 10: bigger feedback + video"
22,"SUPPRF51078",47,47,77,22,14,43,63,55,"Pilot 10","Pilot 10: bigger feedback + video"
23,"SUPPRF51078",42,41,15,-33,-14,48,29,48,"Pilot 10","Pilot 10: bigger feedback + video"
24,"SUPPRF51078",55,54,63,8,0,55,63,55,"Pilot 10","Pilot 10: bigger feedback + video"
25,"SUPPRF51078",45,48,80,27,0,50,80,53,"Pilot 10","Pilot 10: bigger feedback + video"
26,"SUPPRF51078",51,52,58,6,29,47,29,52,"Pilot 10","Pilot 10: bigger feedback + video"
27,"SUPPRF51078",51,49,47,-9,27,56,20,56,"Pilot 10","Pilot 10: bigger feedback + video"
28,"SUPPRF51078",45,47,19,-35,-1,54,20,54,"Pilot 10","Pilot 10: bigger feedback + video"
29,"SUPPRF51078",54,59,100,43,20,57,80,57,"Pilot 10","Pilot 10: bigger feedback + video"
30,"SUPPRF51078",43,49,45,-15,-1,46,46,60,"Pilot 10","Pilot 10: bigger feedback + video"
31,"SUPPRF51078",50,55,58,-2,12,52,46,60,"Pilot 10","Pilot 10: bigger feedback + video"
32,"SUPPRF51078",47,54,54,-3,0,49,54,57,"Pilot 10","Pilot 10: bigger feedback + video"
33,"SUPPRF51078",47,58,56,8,-15,47,71,48,"Pilot 10","Pilot 10: bigger feedback + video"
34,"SUPPRF51078",44,52,28,-32,-1,56,29,60,"Pilot 10","Pilot 10: bigger feedback + video"
35,"SUPPRF51078",52,53,55,0,-16,50,71,55,"Pilot 10","Pilot 10: bigger feedback + video"
36,"SUPPRF51078",49,55,24,-34,-13,47,37,58,"Pilot 10","Pilot 10: bigger feedback + video"
37,"SUPPRF51078",49,48,67,11,-13,53,80,56,"Pilot 10","Pilot 10: bigger feedback + video"
38,"SUPPRF51078",54,51,38,-21,1,60,37,59,"Pilot 10","Pilot 10: bigger feedback + video"
39,"SUPPRF51078",50,50,16,-34,-13,54,29,50,"Pilot 10","Pilot 10: bigger feedback + video"
40,"SUPPRF51078",50,48,20,-29,0,48,20,49,"Pilot 10","Pilot 10: bigger feedback + video"
41,"SUPPRF51078",49,49,71,20,0,50,71,51,"Pilot 10","Pilot 10: bigger feedback + video"
42,"SUPPRF51078",22,35,37,-12,0,49,37,49,"Pilot 10","Pilot 10: bigger feedback + video"
43,"SUPPRF51078",30,58,81,26,1,49,80,55,"Pilot 10","Pilot 10: bigger feedback + video"
44,"SUPPRF51078",47,47,62,-3,-1,45,63,65,"Pilot 10","Pilot 10: bigger feedback + video"
45,"SUPPRF51078",28,46,46,-4,17,36,29,50,"Pilot 10","Pilot 10: bigger feedback + video"
46,"SUPPRF51078",47,53,88,42,25,46,63,46,"Pilot 10","Pilot 10: bigger feedback + video"
47,"SUPPRF51078",51,50,78,34,24,45,54,44,"Pilot 10","Pilot 10: bigger feedback + video"
48,"SUPPRF51078",21,45,6,-51,-14,49,20,57,"Pilot 10","Pilot 10: bigger feedback + video"
1,"SUPPRF89542",87,12,55,-20,-16,84,71,75,"Pilot 10","Pilot 10: bigger feedback + video"
2,"SUPPRF89542",81,16,46,-20,17,48,29,66,"Pilot 10","Pilot 10: bigger feedback + video"
3,"SUPPRF89542",95,6,88,24,25,66,63,64,"Pilot 10","Pilot 10: bigger feedback + video"
4,"SUPPRF89542",82,16,68,-17,-12,76,80,85,"Pilot 10","Pilot 10: bigger feedback + video"
5,"SUPPRF89542",78,26,38,-29,1,25,37,67,"Pilot 10","Pilot 10: bigger feedback + video"
6,"SUPPRF89542",92,13,75,-2,29,41,46,77,"Pilot 10","Pilot 10: bigger feedback + video"
7,"SUPPRF89542",76,24,28,-27,-1,0,29,55,"Pilot 10","Pilot 10: bigger feedback + video"
8,"SUPPRF89542",35,20,16,-47,-13,25,29,63,"Pilot 10","Pilot 10: bigger feedback + video"
9,"SUPPRF89542",37,52,8,-65,-12,42,20,73,"Pilot 10","Pilot 10: bigger feedback + video"
10,"SUPPRF89542",72,43,67,-7,-13,62,80,74,"Pilot 10","Pilot 10: bigger feedback + video"
11,"SUPPRF89542",52,35,22,-54,-15,53,37,76,"Pilot 10","Pilot 10: bigger feedback + video"
12,"SUPPRF89542",64,44,15,-51,-14,27,29,66,"Pilot 10","Pilot 10: bigger feedback + video"
13,"SUPPRF89542",90,13,94,24,23,41,71,70,"Pilot 10","Pilot 10: bigger feedback + video"
14,"SUPPRF89542",32,61,29,-41,0,40,29,70,"Pilot 10","Pilot 10: bigger feedback + video"
15,"SUPPRF89542",75,21,50,-24,-13,62,63,74,"Pilot 10","Pilot 10: bigger feedback + video"
16,"SUPPRF89542",78,14,71,0,0,56,71,71,"Pilot 10","Pilot 10: bigger feedback + video"
17,"SUPPRF89542",72,23,61,-7,24,55,37,68,"Pilot 10","Pilot 10: bigger feedback + video"
18,"SUPPRF89542",79,10,83,7,12,63,71,76,"Pilot 10","Pilot 10: bigger feedback + video"
19,"SUPPRF89542",94,9,100,81,20,10,80,19,"Pilot 10","Pilot 10: bigger feedback + video"
20,"SUPPRF89542",60,33,35,-45,15,53,20,80,"Pilot 10","Pilot 10: bigger feedback + video"
21,"SUPPRF89542",82,15,70,-3,-1,35,71,73,"Pilot 10","Pilot 10: bigger feedback + video"
22,"SUPPRF89542",65,22,54,7,0,75,54,47,"Pilot 10","Pilot 10: bigger feedback + video"
23,"SUPPRF89542",60,16,56,-25,-15,43,71,81,"Pilot 10","Pilot 10: bigger feedback + video"
24,"SUPPRF89542",75,26,49,-2,12,22,37,51,"Pilot 10","Pilot 10: bigger feedback + video"
25,"SUPPRF89542",31,13,6,-62,-14,82,20,68,"Pilot 10","Pilot 10: bigger feedback + video"
26,"SUPPRF89542",45,32,38,-43,-16,69,54,81,"Pilot 10","Pilot 10: bigger feedback + video"
27,"SUPPRF89542",90,17,96,24,16,58,80,72,"Pilot 10","Pilot 10: bigger feedback + video"
28,"SUPPRF89542",67,24,58,-21,29,72,29,79,"Pilot 10","Pilot 10: bigger feedback + video"
29,"SUPPRF89542",86,10,81,2,1,55,80,79,"Pilot 10","Pilot 10: bigger feedback + video"
30,"SUPPRF89542",37,61,63,-11,0,59,63,74,"Pilot 10","Pilot 10: bigger feedback + video"
31,"SUPPRF89542",70,32,24,-40,-13,48,37,64,"Pilot 10","Pilot 10: bigger feedback + video"
32,"SUPPRF89542",81,25,33,-46,-13,58,46,79,"Pilot 10","Pilot 10: bigger feedback + video"
33,"SUPPRF89542",74,32,47,-21,27,63,20,68,"Pilot 10","Pilot 10: bigger feedback + video"
34,"SUPPRF89542",83,26,46,-3,0,26,46,49,"Pilot 10","Pilot 10: bigger feedback + video"
35,"SUPPRF89542",79,25,34,-38,-12,52,46,72,"Pilot 10","Pilot 10: bigger feedback + video"
36,"SUPPRF89542",77,28,19,-60,-1,67,20,79,"Pilot 10","Pilot 10: bigger feedback + video"
37,"SUPPRF89542",70,24,80,7,0,57,80,73,"Pilot 10","Pilot 10: bigger feedback + video"
38,"SUPPRF89542",83,35,62,-6,-1,54,63,68,"Pilot 10","Pilot 10: bigger feedback + video"
39,"SUPPRF89542",67,19,55,13,1,11,54,42,"Pilot 10","Pilot 10: bigger feedback + video"
40,"SUPPRF89542",81,11,47,-29,-16,34,63,76,"Pilot 10","Pilot 10: bigger feedback + video"
41,"SUPPRF89542",57,21,41,-29,-13,37,54,70,"Pilot 10","Pilot 10: bigger feedback + video"
42,"SUPPRF89542",81,54,58,6,12,26,46,52,"Pilot 10","Pilot 10: bigger feedback + video"
43,"SUPPRF89542",72,37,45,-21,-1,50,46,66,"Pilot 10","Pilot 10: bigger feedback + video"
44,"SUPPRF89542",81,44,77,5,14,61,63,72,"Pilot 10","Pilot 10: bigger feedback + video"
45,"SUPPRF89542",72,34,66,-1,12,45,54,67,"Pilot 10","Pilot 10: bigger feedback + video"
46,"SUPPRF89542",28,63,20,-72,0,65,20,92,"Pilot 10","Pilot 10: bigger feedback + video"
47,"SUPPRF89542",72,15,78,2,24,66,54,76,"Pilot 10","Pilot 10: bigger feedback + video"
48,"SUPPRF89542",76,56,37,-42,0,60,37,79,"Pilot 10","Pilot 10: bigger feedback + video"
1,"SUPPRF40116",55,54,6,-13,-14,62,20,19,"Pilot 10","Pilot 10: bigger feedback + video"
2,"SUPPRF40116",56,52,96,23,16,45,80,73,"Pilot 10","Pilot 10: bigger feedback + video"
3,"SUPPRF40116",51,54,67,-13,-13,52,80,80,"Pilot 10","Pilot 10: bigger feedback + video"
4,"SUPPRF40116",53,54,37,6,0,60,37,31,"Pilot 10","Pilot 10: bigger feedback + video"
5,"SUPPRF40116",58,55,46,-1,0,35,46,47,"Pilot 10","Pilot 10: bigger feedback + video"
6,"SUPPRF40116",61,55,100,11,20,65,80,89,"Pilot 10","Pilot 10: bigger feedback + video"
7,"SUPPRF40116",57,60,45,12,-1,37,46,33,"Pilot 10","Pilot 10: bigger feedback + video"
8,"SUPPRF40116",60,53,94,30,23,43,71,64,"Pilot 10","Pilot 10: bigger feedback + video"
9,"SUPPRF40116",59,54,75,18,29,28,46,57,"Pilot 10","Pilot 10: bigger feedback + video"
10,"SUPPRF40116",53,53,33,-7,-13,57,46,40,"Pilot 10","Pilot 10: bigger feedback + video"
11,"SUPPRF40116",52,53,66,8,12,56,54,58,"Pilot 10","Pilot 10: bigger feedback + video"
12,"SUPPRF40116",52,53,55,-26,-16,60,71,81,"Pilot 10","Pilot 10: bigger feedback + video"
13,"SUPPRF40116",51,52,41,-15,-13,32,54,56,"Pilot 10","Pilot 10: bigger feedback + video"
14,"SUPPRF40116",54,52,71,4,0,39,71,67,"Pilot 10","Pilot 10: bigger feedback + video"
15,"SUPPRF40116",52,54,24,-17,-13,50,37,41,"Pilot 10","Pilot 10: bigger feedback + video"
16,"SUPPRF40116",57,49,77,20,14,61,63,57,"Pilot 10","Pilot 10: bigger feedback + video"
17,"SUPPRF40116",62,52,8,-4,-12,64,20,12,"Pilot 10","Pilot 10: bigger feedback + video"
18,"SUPPRF40116",50,56,54,8,0,34,54,46,"Pilot 10","Pilot 10: bigger feedback + video"
19,"SUPPRF40116",51,50,15,-18,-14,53,29,33,"Pilot 10","Pilot 10: bigger feedback + video"
20,"SUPPRF40116",56,48,68,12,-12,30,80,56,"Pilot 10","Pilot 10: bigger feedback + video"
21,"SUPPRF40116",64,54,50,-4,-13,73,63,54,"Pilot 10","Pilot 10: bigger feedback + video"
22,"SUPPRF40116",65,55,58,41,29,59,29,17,"Pilot 10","Pilot 10: bigger feedback + video"
23,"SUPPRF40116",58,48,78,19,24,50,54,59,"Pilot 10","Pilot 10: bigger feedback + video"
24,"SUPPRF40116",54,47,28,10,-1,53,29,18,"Pilot 10","Pilot 10: bigger feedback + video"
25,"SUPPRF40116",50,43,70,10,-1,60,71,60,"Pilot 10","Pilot 10: bigger feedback + video"
26,"SUPPRF40116",54,49,38,-19,-16,44,54,57,"Pilot 10","Pilot 10: bigger feedback + video"
27,"SUPPRF40116",43,56,38,17,1,75,37,21,"Pilot 10","Pilot 10: bigger feedback + video"
28,"SUPPRF40116",60,38,62,6,-1,46,63,56,"Pilot 10","Pilot 10: bigger feedback + video"
29,"SUPPRF40116",57,40,80,-3,0,62,80,83,"Pilot 10","Pilot 10: bigger feedback + video"
30,"SUPPRF40116",51,41,56,-15,-15,60,71,71,"Pilot 10","Pilot 10: bigger feedback + video"
31,"SUPPRF40116",52,55,81,13,1,78,80,68,"Pilot 10","Pilot 10: bigger feedback + video"
32,"SUPPRF40116",51,57,19,16,-1,71,20,3,"Pilot 10","Pilot 10: bigger feedback + video"
33,"SUPPRF40116",62,43,88,30,25,62,63,58,"Pilot 10","Pilot 10: bigger feedback + video"
34,"SUPPRF40116",51,43,35,19,15,72,20,16,"Pilot 10","Pilot 10: bigger feedback + video"
35,"SUPPRF40116",56,46,83,25,12,81,71,58,"Pilot 10","Pilot 10: bigger feedback + video"
36,"SUPPRF40116",49,48,47,-8,-16,47,63,55,"Pilot 10","Pilot 10: bigger feedback + video"
37,"SUPPRF40116",55,44,46,20,17,76,29,26,"Pilot 10","Pilot 10: bigger feedback + video"
38,"SUPPRF40116",53,46,58,23,12,32,46,35,"Pilot 10","Pilot 10: bigger feedback + video"
39,"SUPPRF40116",54,45,55,-11,1,59,54,66,"Pilot 10","Pilot 10: bigger feedback + video"
40,"SUPPRF40116",54,44,61,24,24,34,37,37,"Pilot 10","Pilot 10: bigger feedback + video"
41,"SUPPRF40116",63,46,47,26,27,76,20,21,"Pilot 10","Pilot 10: bigger feedback + video"
42,"SUPPRF40116",56,58,29,0,0,56,29,29,"Pilot 10","Pilot 10: bigger feedback + video"
43,"SUPPRF40116",51,44,22,-2,-15,56,37,24,"Pilot 10","Pilot 10: bigger feedback + video"
44,"SUPPRF40116",53,45,16,-18,-13,50,29,34,"Pilot 10","Pilot 10: bigger feedback + video"
45,"SUPPRF40116",59,44,49,9,12,60,37,40,"Pilot 10","Pilot 10: bigger feedback + video"
46,"SUPPRF40116",48,41,34,-15,-12,45,46,49,"Pilot 10","Pilot 10: bigger feedback + video"
47,"SUPPRF40116",55,41,63,6,0,32,63,57,"Pilot 10","Pilot 10: bigger feedback + video"
48,"SUPPRF40116",72,40,20,0,0,58,20,20,"Pilot 10","Pilot 10: bigger feedback + video"
1,"SUPPRF98981",28,97,35,-50,15,55,20,85,"Pilot 10","Pilot 10: bigger feedback + video"
2,"SUPPRF98981",3,98,16,-44,-13,20,29,60,"Pilot 10","Pilot 10: bigger feedback + video"
3,"SUPPRF98981",72,80,83,2,12,49,71,81,"Pilot 10","Pilot 10: bigger feedback + video"
4,"SUPPRF98981",72,66,67,-6,-13,51,80,73,"Pilot 10","Pilot 10: bigger feedback + video"
5,"SUPPRF98981",33,87,8,-66,-12,37,20,74,"Pilot 10","Pilot 10: bigger feedback + video"
6,"SUPPRF98981",83,64,71,-6,0,63,71,77,"Pilot 10","Pilot 10: bigger feedback + video"
7,"SUPPRF98981",81,59,47,-38,-16,51,63,85,"Pilot 10","Pilot 10: bigger feedback + video"
8,"SUPPRF98981",68,51,24,-53,-13,52,37,77,"Pilot 10","Pilot 10: bigger feedback + video"
9,"SUPPRF98981",76,34,81,16,1,37,80,65,"Pilot 10","Pilot 10: bigger feedback + video"
10,"SUPPRF98981",68,66,47,-30,27,56,20,77,"Pilot 10","Pilot 10: bigger feedback + video"
11,"SUPPRF98981",26,77,29,-12,0,72,29,41,"Pilot 10","Pilot 10: bigger feedback + video"
12,"SUPPRF98981",69,65,54,37,0,46,54,17,"Pilot 10","Pilot 10: bigger feedback + video"
13,"SUPPRF98981",69,70,94,52,23,53,71,42,"Pilot 10","Pilot 10: bigger feedback + video"
14,"SUPPRF98981",74,62,78,56,24,74,54,22,"Pilot 10","Pilot 10: bigger feedback + video"
15,"SUPPRF98981",98,7,100,57,20,73,80,43,"Pilot 10","Pilot 10: bigger feedback + video"
16,"SUPPRF98981",79,72,41,10,-13,45,54,31,"Pilot 10","Pilot 10: bigger feedback + video"
17,"SUPPRF98981",65,78,20,4,0,84,20,16,"Pilot 10","Pilot 10: bigger feedback + video"
18,"SUPPRF98981",76,75,22,-22,-15,79,37,44,"Pilot 10","Pilot 10: bigger feedback + video"
19,"SUPPRF98981",81,65,62,-9,-1,67,63,71,"Pilot 10","Pilot 10: bigger feedback + video"
20,"SUPPRF98981",56,52,37,-18,0,54,37,55,"Pilot 10","Pilot 10: bigger feedback + video"
21,"SUPPRF98981",61,14,61,-26,24,22,37,87,"Pilot 10","Pilot 10: bigger feedback + video"
22,"SUPPRF98981",84,62,70,0,-1,64,71,70,"Pilot 10","Pilot 10: bigger feedback + video"
23,"SUPPRF98981",71,22,56,-2,-15,84,71,58,"Pilot 10","Pilot 10: bigger feedback + video"
24,"SUPPRF98981",70,48,38,9,1,92,37,29,"Pilot 10","Pilot 10: bigger feedback + video"
25,"SUPPRF98981",66,75,38,16,-16,86,54,22,"Pilot 10","Pilot 10: bigger feedback + video"
26,"SUPPRF98981",53,45,46,-3,0,86,46,49,"Pilot 10","Pilot 10: bigger feedback + video"
27,"SUPPRF98981",87,10,55,1,-16,90,71,54,"Pilot 10","Pilot 10: bigger feedback + video"
28,"SUPPRF98981",80,40,49,17,12,90,37,32,"Pilot 10","Pilot 10: bigger feedback + video"
29,"SUPPRF98981",86,83,77,24,14,52,63,53,"Pilot 10","Pilot 10: bigger feedback + video"
30,"SUPPRF98981",54,71,28,-21,-1,51,29,49,"Pilot 10","Pilot 10: bigger feedback + video"
31,"SUPPRF98981",94,4,45,-1,-1,96,46,46,"Pilot 10","Pilot 10: bigger feedback + video"
32,"SUPPRF98981",81,6,63,-7,0,91,63,70,"Pilot 10","Pilot 10: bigger feedback + video"
33,"SUPPRF98981",82,9,19,5,-1,72,20,14,"Pilot 10","Pilot 10: bigger feedback + video"
34,"SUPPRF98981",82,89,55,-8,1,66,54,63,"Pilot 10","Pilot 10: bigger feedback + video"
35,"SUPPRF98981",77,78,80,22,0,63,80,58,"Pilot 10","Pilot 10: bigger feedback + video"
36,"SUPPRF98981",10,89,50,-30,-13,91,63,80,"Pilot 10","Pilot 10: bigger feedback + video"
37,"SUPPRF98981",63,71,68,11,-12,89,80,57,"Pilot 10","Pilot 10: bigger feedback + video"
38,"SUPPRF98981",51,62,58,32,12,70,46,26,"Pilot 10","Pilot 10: bigger feedback + video"
39,"SUPPRF98981",75,45,46,-10,17,51,29,56,"Pilot 10","Pilot 10: bigger feedback + video"
40,"SUPPRF98981",4,81,33,-23,-13,68,46,56,"Pilot 10","Pilot 10: bigger feedback + video"
41,"SUPPRF98981",17,76,96,69,16,91,80,27,"Pilot 10","Pilot 10: bigger feedback + video"
42,"SUPPRF98981",99,1,88,29,25,50,63,59,"Pilot 10","Pilot 10: bigger feedback + video"
43,"SUPPRF98981",58,67,15,-46,-14,54,29,61,"Pilot 10","Pilot 10: bigger feedback + video"
44,"SUPPRF98981",81,72,66,12,12,48,54,54,"Pilot 10","Pilot 10: bigger feedback + video"
45,"SUPPRF98981",86,27,58,3,29,68,29,55,"Pilot 10","Pilot 10: bigger feedback + video"
46,"SUPPRF98981",15,11,34,-28,-12,54,46,62,"Pilot 10","Pilot 10: bigger feedback + video"
47,"SUPPRF98981",99,4,75,12,29,91,46,63,"Pilot 10","Pilot 10: bigger feedback + video"
48,"SUPPRF98981",2,95,6,-87,-14,94,20,93,"Pilot 10","Pilot 10: bigger feedback + video"
1,"SUPPRF06248",55,58,67,-14,-13,69,80,81,"Pilot 10","Pilot 10: bigger feedback + video"
2,"SUPPRF06248",53,54,38,-2,1,61,37,40,"Pilot 10","Pilot 10: bigger feedback + video"
3,"SUPPRF06248",57,55,29,7,0,60,29,22,"Pilot 10","Pilot 10: bigger feedback + video"
4,"SUPPRF06248",59,52,58,23,29,63,29,35,"Pilot 10","Pilot 10: bigger feedback + video"
5,"SUPPRF06248",53,59,37,8,0,61,37,29,"Pilot 10","Pilot 10: bigger feedback + video"
6,"SUPPRF06248",54,53,45,-20,-1,51,46,65,"Pilot 10","Pilot 10: bigger feedback + video"
7,"SUPPRF06248",51,53,41,-3,-13,50,54,44,"Pilot 10","Pilot 10: bigger feedback + video"
8,"SUPPRF06248",57,50,81,41,1,50,80,40,"Pilot 10","Pilot 10: bigger feedback + video"
9,"SUPPRF06248",52,57,63,10,0,62,63,53,"Pilot 10","Pilot 10: bigger feedback + video"
10,"SUPPRF06248",51,50,47,4,-16,57,63,43,"Pilot 10","Pilot 10: bigger feedback + video"
11,"SUPPRF06248",50,48,50,10,-13,58,63,40,"Pilot 10","Pilot 10: bigger feedback + video"
12,"SUPPRF06248",54,48,46,-4,0,56,46,50,"Pilot 10","Pilot 10: bigger feedback + video"
13,"SUPPRF06248",47,49,46,20,17,53,29,26,"Pilot 10","Pilot 10: bigger feedback + video"
14,"SUPPRF06248",53,53,22,-28,-15,64,37,50,"Pilot 10","Pilot 10: bigger feedback + video"
15,"SUPPRF06248",44,57,49,12,12,47,37,37,"Pilot 10","Pilot 10: bigger feedback + video"
16,"SUPPRF06248",40,59,71,16,0,53,71,55,"Pilot 10","Pilot 10: bigger feedback + video"
17,"SUPPRF06248",48,58,55,20,1,52,54,35,"Pilot 10","Pilot 10: bigger feedback + video"
18,"SUPPRF06248",49,57,83,20,12,55,71,63,"Pilot 10","Pilot 10: bigger feedback + video"
19,"SUPPRF06248",44,56,55,-10,-16,52,71,65,"Pilot 10","Pilot 10: bigger feedback + video"
20,"SUPPRF06248",43,59,38,-27,-16,49,54,65,"Pilot 10","Pilot 10: bigger feedback + video"
21,"SUPPRF06248",44,64,75,20,29,47,46,55,"Pilot 10","Pilot 10: bigger feedback + video"
22,"SUPPRF06248",49,51,78,27,24,47,54,51,"Pilot 10","Pilot 10: bigger feedback + video"
23,"SUPPRF06248",45,57,100,60,20,44,80,40,"Pilot 10","Pilot 10: bigger feedback + video"
24,"SUPPRF06248",47,58,80,6,0,49,80,74,"Pilot 10","Pilot 10: bigger feedback + video"
25,"SUPPRF06248",48,51,24,-8,-13,52,37,32,"Pilot 10","Pilot 10: bigger feedback + video"
26,"SUPPRF06248",42,51,19,-13,-1,41,20,32,"Pilot 10","Pilot 10: bigger feedback + video"
27,"SUPPRF06248",44,50,62,16,-1,51,63,46,"Pilot 10","Pilot 10: bigger feedback + video"
28,"SUPPRF06248",42,59,94,30,23,55,71,64,"Pilot 10","Pilot 10: bigger feedback + video"
29,"SUPPRF06248",39,58,61,19,24,55,37,42,"Pilot 10","Pilot 10: bigger feedback + video"
30,"SUPPRF06248",44,55,96,44,16,48,80,52,"Pilot 10","Pilot 10: bigger feedback + video"
31,"SUPPRF06248",48,61,56,-8,-15,52,71,64,"Pilot 10","Pilot 10: bigger feedback + video"
32,"SUPPRF06248",36,58,34,-14,-12,54,46,48,"Pilot 10","Pilot 10: bigger feedback + video"
33,"SUPPRF06248",40,58,28,6,-1,47,29,22,"Pilot 10","Pilot 10: bigger feedback + video"
34,"SUPPRF06248",37,63,66,26,12,47,54,40,"Pilot 10","Pilot 10: bigger feedback + video"
35,"SUPPRF06248",41,62,6,-18,-14,47,20,24,"Pilot 10","Pilot 10: bigger feedback + video"
36,"SUPPRF06248",29,62,15,-2,-14,50,29,17,"Pilot 10","Pilot 10: bigger feedback + video"
37,"SUPPRF06248",26,60,88,48,25,48,63,40,"Pilot 10","Pilot 10: bigger feedback + video"
38,"SUPPRF06248",36,52,77,31,14,50,63,46,"Pilot 10","Pilot 10: bigger feedback + video"
39,"SUPPRF06248",32,58,20,5,0,48,20,15,"Pilot 10","Pilot 10: bigger feedback + video"
40,"SUPPRF06248",29,65,68,58,-12,70,80,10,"Pilot 10","Pilot 10: bigger feedback + video"
41,"SUPPRF06248",28,64,54,9,0,49,54,45,"Pilot 10","Pilot 10: bigger feedback + video"
42,"SUPPRF06248",25,65,33,-7,-13,48,46,40,"Pilot 10","Pilot 10: bigger feedback + video"
43,"SUPPRF06248",25,67,16,-4,-13,34,29,20,"Pilot 10","Pilot 10: bigger feedback + video"
44,"SUPPRF06248",17,65,47,35,27,55,20,12,"Pilot 10","Pilot 10: bigger feedback + video"
45,"SUPPRF06248",27,62,8,-13,-12,49,20,21,"Pilot 10","Pilot 10: bigger feedback + video"
46,"SUPPRF06248",27,63,35,25,15,46,20,10,"Pilot 10","Pilot 10: bigger feedback + video"
47,"SUPPRF06248",29,65,70,24,-1,50,71,46,"Pilot 10","Pilot 10: bigger feedback + video"
48,"SUPPRF06248",29,56,58,13,12,50,46,45,"Pilot 10","Pilot 10: bigger feedback + video"
1,"SUPPRF87563",32,64,24,0,-13,40,37,24,"Pilot 10","Pilot 10: bigger feedback + video"
2,"SUPPRF87563",27,75,35,15,15,65,20,20,"Pilot 10","Pilot 10: bigger feedback + video"
3,"SUPPRF87563",25,69,20,-10,0,65,20,30,"Pilot 10","Pilot 10: bigger feedback + video"
4,"SUPPRF87563",59,60,75,40,29,60,46,35,"Pilot 10","Pilot 10: bigger feedback + video"
5,"SUPPRF87563",42,50,54,24,0,69,54,30,"Pilot 10","Pilot 10: bigger feedback + video"
6,"SUPPRF87563",29,66,33,-7,-13,60,46,40,"Pilot 10","Pilot 10: bigger feedback + video"
7,"SUPPRF87563",26,73,68,45,-12,66,80,23,"Pilot 10","Pilot 10: bigger feedback + video"
8,"SUPPRF87563",30,54,47,23,27,63,20,24,"Pilot 10","Pilot 10: bigger feedback + video"
9,"SUPPRF87563",50,44,81,37,1,65,80,44,"Pilot 10","Pilot 10: bigger feedback + video"
10,"SUPPRF87563",49,47,66,32,12,66,54,34,"Pilot 10","Pilot 10: bigger feedback + video"
11,"SUPPRF87563",46,47,78,39,24,73,54,39,"Pilot 10","Pilot 10: bigger feedback + video"
12,"SUPPRF87563",52,50,6,-35,-14,71,20,41,"Pilot 10","Pilot 10: bigger feedback + video"
13,"SUPPRF87563",49,49,41,-5,-13,63,54,46,"Pilot 10","Pilot 10: bigger feedback + video"
14,"SUPPRF87563",48,48,38,13,-16,61,54,25,"Pilot 10","Pilot 10: bigger feedback + video"
15,"SUPPRF87563",49,49,62,30,-1,64,63,32,"Pilot 10","Pilot 10: bigger feedback + video"
16,"SUPPRF87563",49,50,94,54,23,60,71,40,"Pilot 10","Pilot 10: bigger feedback + video"
17,"SUPPRF87563",50,50,46,9,17,68,29,37,"Pilot 10","Pilot 10: bigger feedback + video"
18,"SUPPRF87563",100,48,100,52,20,67,80,48,"Pilot 10","Pilot 10: bigger feedback + video"
19,"SUPPRF87563",44,43,56,9,-15,69,71,47,"Pilot 10","Pilot 10: bigger feedback + video"
20,"SUPPRF87563",48,50,55,-6,-16,76,71,61,"Pilot 10","Pilot 10: bigger feedback + video"
21,"SUPPRF87563",50,47,46,-3,0,47,46,49,"Pilot 10","Pilot 10: bigger feedback + video"
22,"SUPPRF87563",53,47,45,11,-1,50,46,34,"Pilot 10","Pilot 10: bigger feedback + video"
23,"SUPPRF87563",52,49,22,-18,-15,44,37,40,"Pilot 10","Pilot 10: bigger feedback + video"
24,"SUPPRF87563",48,46,15,-36,-14,43,29,51,"Pilot 10","Pilot 10: bigger feedback + video"
25,"SUPPRF87563",46,50,67,-8,-13,65,80,75,"Pilot 10","Pilot 10: bigger feedback + video"
26,"SUPPRF87563",49,48,34,-11,-12,58,46,45,"Pilot 10","Pilot 10: bigger feedback + video"
27,"SUPPRF87563",49,48,77,51,14,65,63,26,"Pilot 10","Pilot 10: bigger feedback + video"
28,"SUPPRF87563",51,49,47,-6,-16,65,63,53,"Pilot 10","Pilot 10: bigger feedback + video"
29,"SUPPRF87563",49,49,19,1,-1,92,20,18,"Pilot 10","Pilot 10: bigger feedback + video"
30,"SUPPRF87563",100,53,88,35,25,79,63,53,"Pilot 10","Pilot 10: bigger feedback + video"
31,"SUPPRF87563",35,53,50,-14,-13,83,63,64,"Pilot 10","Pilot 10: bigger feedback + video"
32,"SUPPRF87563",51,50,55,7,1,85,54,48,"Pilot 10","Pilot 10: bigger feedback + video"
33,"SUPPRF87563",34,52,38,-3,1,75,37,41,"Pilot 10","Pilot 10: bigger feedback + video"
34,"SUPPRF87563",79,53,96,39,16,37,80,57,"Pilot 10","Pilot 10: bigger feedback + video"
35,"SUPPRF87563",69,35,63,20,0,76,63,43,"Pilot 10","Pilot 10: bigger feedback + video"
36,"SUPPRF87563",73,29,8,-9,-12,57,20,17,"Pilot 10","Pilot 10: bigger feedback + video"
37,"SUPPRF87563",64,31,49,15,12,63,37,34,"Pilot 10","Pilot 10: bigger feedback + video"
38,"SUPPRF87563",64,38,16,-41,-13,49,29,57,"Pilot 10","Pilot 10: bigger feedback + video"
39,"SUPPRF87563",70,30,61,26,24,56,37,35,"Pilot 10","Pilot 10: bigger feedback + video"
40,"SUPPRF87563",77,28,80,-1,0,76,80,81,"Pilot 10","Pilot 10: bigger feedback + video"
41,"SUPPRF87563",67,62,70,60,-1,86,71,10,"Pilot 10","Pilot 10: bigger feedback + video"
42,"SUPPRF87563",63,24,58,14,29,86,29,44,"Pilot 10","Pilot 10: bigger feedback + video"
43,"SUPPRF87563",63,18,29,-16,0,64,29,45,"Pilot 10","Pilot 10: bigger feedback + video"
44,"SUPPRF87563",65,27,58,16,12,57,46,42,"Pilot 10","Pilot 10: bigger feedback + video"
45,"SUPPRF87563",72,30,83,20,12,69,71,63,"Pilot 10","Pilot 10: bigger feedback + video"
46,"SUPPRF87563",69,27,71,13,0,70,71,58,"Pilot 10","Pilot 10: bigger feedback + video"
47,"SUPPRF87563",64,18,28,-11,-1,69,29,39,"Pilot 10","Pilot 10: bigger feedback + video"
48,"SUPPRF87563",68,15,37,-16,0,77,37,53,"Pilot 10","Pilot 10: bigger feedback + video"
1,"SUPPRF61705",40,62,41,-29,-13,53,54,70,"Pilot 11","Pilot 11: bigger feedback + video + socially anxious"
2,"SUPPRF61705",45,64,55,20,1,39,54,35,"Pilot 11","Pilot 11: bigger feedback + video + socially anxious"
3,"SUPPRF61705",58,59,96,62,16,45,80,34,"Pilot 11","Pilot 11: bigger feedback + video + socially anxious"
4,"SUPPRF61705",37,62,29,-2,0,27,29,31,"Pilot 11","Pilot 11: bigger feedback + video + socially anxious"
5,"SUPPRF61705",45,64,47,0,-16,42,63,47,"Pilot 11","Pilot 11: bigger feedback + video + socially anxious"
6,"SUPPRF61705",55,62,67,12,-13,62,80,55,"Pilot 11","Pilot 11: bigger feedback + video + socially anxious"
7,"SUPPRF61705",43,59,70,45,-1,19,71,25,"Pilot 11","Pilot 11: bigger feedback + video + socially anxious"
8,"SUPPRF61705",33,53,33,19,-13,16,46,14,"Pilot 11","Pilot 11: bigger feedback + video + socially anxious"
9,"SUPPRF61705",44,57,77,61,14,32,63,16,"Pilot 11","Pilot 11: bigger feedback + video + socially anxious"
10,"SUPPRF61705",60,42,66,54,12,8,54,12,"Pilot 11","Pilot 11: bigger feedback + video + socially anxious"
11,"SUPPRF61705",45,48,20,9,0,54,20,11,"Pilot 11","Pilot 11: bigger feedback + video + socially anxious"
12,"SUPPRF61705",46,42,34,6,-12,46,46,28,"Pilot 11","Pilot 11: bigger feedback + video + socially anxious"
13,"SUPPRF61705",39,46,37,-4,0,27,37,41,"Pilot 11","Pilot 11: bigger feedback + video + socially anxious"
14,"SUPPRF61705",71,49,100,70,20,30,80,30,"Pilot 11","Pilot 11: bigger feedback + video + socially anxious"
15,"SUPPRF61705",43,44,75,43,29,32,46,32,"Pilot 11","Pilot 11: bigger feedback + video + socially anxious"
16,"SUPPRF61705",52,40,61,19,24,38,37,42,"Pilot 11","Pilot 11: bigger feedback + video + socially anxious"
17,"SUPPRF61705",59,51,62,24,-1,39,63,38,"Pilot 11","Pilot 11: bigger feedback + video + socially anxious"
18,"SUPPRF61705",32,39,45,15,-1,23,46,30,"Pilot 11","Pilot 11: bigger feedback + video + socially anxious"
19,"SUPPRF61705",49,47,16,-37,-13,49,29,53,"Pilot 11","Pilot 11: bigger feedback + video + socially anxious"
20,"SUPPRF61705",48,53,46,17,17,39,29,29,"Pilot 11","Pilot 11: bigger feedback + video + socially anxious"
21,"SUPPRF61705",51,52,78,62,24,39,54,16,"Pilot 11","Pilot 11: bigger feedback + video + socially anxious"
22,"SUPPRF61705",52,46,38,13,1,60,37,25,"Pilot 11","Pilot 11: bigger feedback + video + socially anxious"
23,"SUPPRF61705",38,38,28,-6,-1,35,29,34,"Pilot 11","Pilot 11: bigger feedback + video + socially anxious"
24,"SUPPRF61705",37,45,63,25,0,58,63,38,"Pilot 11","Pilot 11: bigger feedback + video + socially anxious"
25,"SUPPRF61705",34,40,24,9,-13,65,37,15,"Pilot 11","Pilot 11: bigger feedback + video + socially anxious"
26,"SUPPRF61705",42,33,49,13,12,42,37,36,"Pilot 11","Pilot 11: bigger feedback + video + socially anxious"
27,"SUPPRF61705",41,39,6,-23,-14,31,20,29,"Pilot 11","Pilot 11: bigger feedback + video + socially anxious"
28,"SUPPRF61705",33,41,71,35,0,39,71,36,"Pilot 11","Pilot 11: bigger feedback + video + socially anxious"
29,"SUPPRF61705",37,33,47,37,27,80,20,10,"Pilot 11","Pilot 11: bigger feedback + video + socially anxious"
30,"SUPPRF61705",36,41,94,82,23,73,71,12,"Pilot 11","Pilot 11: bigger feedback + video + socially anxious"
31,"SUPPRF61705",35,39,68,9,-12,41,80,59,"Pilot 11","Pilot 11: bigger feedback + video + socially anxious"
32,"SUPPRF61705",30,44,88,45,25,31,63,43,"Pilot 11","Pilot 11: bigger feedback + video + socially anxious"
33,"SUPPRF61705",35,40,80,21,0,61,80,59,"Pilot 11","Pilot 11: bigger feedback + video + socially anxious"
34,"SUPPRF61705",39,29,19,8,-1,54,20,11,"Pilot 11","Pilot 11: bigger feedback + video + socially anxious"
35,"SUPPRF61705",38,38,58,41,29,45,29,17,"Pilot 11","Pilot 11: bigger feedback + video + socially anxious"
36,"SUPPRF61705",33,34,56,11,-15,36,71,45,"Pilot 11","Pilot 11: bigger feedback + video + socially anxious"
37,"SUPPRF61705",40,35,55,27,-16,26,71,28,"Pilot 11","Pilot 11: bigger feedback + video + socially anxious"
38,"SUPPRF61705",55,29,81,61,1,22,80,20,"Pilot 11","Pilot 11: bigger feedback + video + socially anxious"
39,"SUPPRF61705",44,38,22,-25,-15,55,37,47,"Pilot 11","Pilot 11: bigger feedback + video + socially anxious"
40,"SUPPRF61705",31,33,35,7,15,35,20,28,"Pilot 11","Pilot 11: bigger feedback + video + socially anxious"
41,"SUPPRF61705",39,38,58,21,12,29,46,37,"Pilot 11","Pilot 11: bigger feedback + video + socially anxious"
42,"SUPPRF61705",31,34,46,15,0,37,46,31,"Pilot 11","Pilot 11: bigger feedback + video + socially anxious"
43,"SUPPRF61705",36,34,38,17,-16,46,54,21,"Pilot 11","Pilot 11: bigger feedback + video + socially anxious"
44,"SUPPRF61705",44,40,8,-14,-12,45,20,22,"Pilot 11","Pilot 11: bigger feedback + video + socially anxious"
45,"SUPPRF61705",35,42,15,-13,-14,41,29,28,"Pilot 11","Pilot 11: bigger feedback + video + socially anxious"
46,"SUPPRF61705",39,37,54,32,0,53,54,22,"Pilot 11","Pilot 11: bigger feedback + video + socially anxious"
47,"SUPPRF61705",54,33,83,51,12,39,71,32,"Pilot 11","Pilot 11: bigger feedback + video + socially anxious"
48,"SUPPRF61705",37,39,50,32,-13,39,63,18,"Pilot 11","Pilot 11: bigger feedback + video + socially anxious"
1,"SUPPRF88145",51,100,38,-12,-16,70,54,50,"Pilot 11","Pilot 11: bigger feedback + video + socially anxious"
2,"SUPPRF88145",80,100,47,46,27,95,20,1,"Pilot 11","Pilot 11: bigger feedback + video + socially anxious"
3,"SUPPRF88145",64,100,38,-42,1,80,37,80,"Pilot 11","Pilot 11: bigger feedback + video + socially anxious"
4,"SUPPRF88145",77,100,62,-8,-1,80,63,70,"Pilot 11","Pilot 11: bigger feedback + video + socially anxious"
5,"SUPPRF88145",84,96,83,23,12,80,71,60,"Pilot 11","Pilot 11: bigger feedback + video + socially anxious"
6,"SUPPRF88145",80,100,61,31,24,80,37,30,"Pilot 11","Pilot 11: bigger feedback + video + socially anxious"
7,"SUPPRF88145",43,100,15,-5,-14,0,29,20,"Pilot 11","Pilot 11: bigger feedback + video + socially anxious"
8,"SUPPRF88145",100,100,58,-2,12,0,46,60,"Pilot 11","Pilot 11: bigger feedback + video + socially anxious"
9,"SUPPRF88145",0,100,6,-24,-14,0,20,30,"Pilot 11","Pilot 11: bigger feedback + video + socially anxious"
10,"SUPPRF88145",96,90,88,8,25,95,63,80,"Pilot 11","Pilot 11: bigger feedback + video + socially anxious"
11,"SUPPRF88145",72,24,70,10,-1,0,71,60,"Pilot 11","Pilot 11: bigger feedback + video + socially anxious"
12,"SUPPRF88145",39,100,78,58,24,0,54,20,"Pilot 11","Pilot 11: bigger feedback + video + socially anxious"
13,"SUPPRF88145",75,100,24,-56,-13,80,37,80,"Pilot 11","Pilot 11: bigger feedback + video + socially anxious"
14,"SUPPRF88145",69,13,66,-14,12,80,54,80,"Pilot 11","Pilot 11: bigger feedback + video + socially anxious"
15,"SUPPRF88145",88,56,45,10,-1,100,46,35,"Pilot 11","Pilot 11: bigger feedback + video + socially anxious"
16,"SUPPRF88145",77,0,100,40,20,0,80,60,"Pilot 11","Pilot 11: bigger feedback + video + socially anxious"
17,"SUPPRF88145",0,78,67,-13,-13,0,80,80,"Pilot 11","Pilot 11: bigger feedback + video + socially anxious"
18,"SUPPRF88145",76,80,54,-21,0,45,54,75,"Pilot 11","Pilot 11: bigger feedback + video + socially anxious"
19,"SUPPRF88145",100,15,56,-44,-15,100,71,100,"Pilot 11","Pilot 11: bigger feedback + video + socially anxious"
20,"SUPPRF88145",100,4,94,19,23,100,71,75,"Pilot 11","Pilot 11: bigger feedback + video + socially anxious"
21,"SUPPRF88145",88,51,80,45,0,100,80,35,"Pilot 11","Pilot 11: bigger feedback + video + socially anxious"
22,"SUPPRF88145",51,82,37,-13,0,15,37,50,"Pilot 11","Pilot 11: bigger feedback + video + socially anxious"
23,"SUPPRF88145",69,25,63,-37,0,100,63,100,"Pilot 11","Pilot 11: bigger feedback + video + socially anxious"
24,"SUPPRF88145",63,73,77,32,14,0,63,45,"Pilot 11","Pilot 11: bigger feedback + video + socially anxious"
25,"SUPPRF88145",86,52,50,-40,-13,0,63,90,"Pilot 11","Pilot 11: bigger feedback + video + socially anxious"
26,"SUPPRF88145",59,100,34,-21,-12,10,46,55,"Pilot 11","Pilot 11: bigger feedback + video + socially anxious"
27,"SUPPRF88145",100,0,81,11,1,65,80,70,"Pilot 11","Pilot 11: bigger feedback + video + socially anxious"
28,"SUPPRF88145",0,100,22,-23,-15,100,37,45,"Pilot 11","Pilot 11: bigger feedback + video + socially anxious"
29,"SUPPRF88145",0,100,41,-34,-13,80,54,75,"Pilot 11","Pilot 11: bigger feedback + video + socially anxious"
30,"SUPPRF88145",100,84,46,1,0,40,46,45,"Pilot 11","Pilot 11: bigger feedback + video + socially anxious"
31,"SUPPRF88145",64,4,28,3,-1,100,29,25,"Pilot 11","Pilot 11: bigger feedback + video + socially anxious"
32,"SUPPRF88145",100,0,71,41,0,0,71,30,"Pilot 11","Pilot 11: bigger feedback + video + socially anxious"
33,"SUPPRF88145",2,0,8,-32,-12,90,20,40,"Pilot 11","Pilot 11: bigger feedback + video + socially anxious"
34,"SUPPRF88145",0,95,16,-64,-13,85,29,80,"Pilot 11","Pilot 11: bigger feedback + video + socially anxious"
35,"SUPPRF88145",57,43,55,-5,1,20,54,60,"Pilot 11","Pilot 11: bigger feedback + video + socially anxious"
36,"SUPPRF88145",96,3,96,-4,16,95,80,100,"Pilot 11","Pilot 11: bigger feedback + video + socially anxious"
37,"SUPPRF88145",100,0,75,10,29,0,46,65,"Pilot 11","Pilot 11: bigger feedback + video + socially anxious"
38,"SUPPRF88145",81,14,47,-13,-16,25,63,60,"Pilot 11","Pilot 11: bigger feedback + video + socially anxious"
39,"SUPPRF88145",66,71,19,9,-1,0,20,10,"Pilot 11","Pilot 11: bigger feedback + video + socially anxious"
40,"SUPPRF88145",66,30,46,-24,17,85,29,70,"Pilot 11","Pilot 11: bigger feedback + video + socially anxious"
41,"SUPPRF88145",89,4,58,38,29,80,29,20,"Pilot 11","Pilot 11: bigger feedback + video + socially anxious"
42,"SUPPRF88145",35,8,29,-41,0,100,29,70,"Pilot 11","Pilot 11: bigger feedback + video + socially anxious"
43,"SUPPRF88145",99,6,49,-1,12,100,37,50,"Pilot 11","Pilot 11: bigger feedback + video + socially anxious"
44,"SUPPRF88145",73,1,20,-50,0,40,20,70,"Pilot 11","Pilot 11: bigger feedback + video + socially anxious"
45,"SUPPRF88145",72,3,35,-5,15,0,20,40,"Pilot 11","Pilot 11: bigger feedback + video + socially anxious"
46,"SUPPRF88145",85,12,33,13,-13,60,46,20,"Pilot 11","Pilot 11: bigger feedback + video + socially anxious"
47,"SUPPRF88145",100,1,68,-12,-12,90,80,80,"Pilot 11","Pilot 11: bigger feedback + video + socially anxious"
48,"SUPPRF88145",97,1,55,15,-16,1,71,40,"Pilot 11","Pilot 11: bigger feedback + video + socially anxious"
1,"SUPPRF47953",50,58,19,-11,-1,63,20,30,"Pilot 11","Pilot 11: bigger feedback + video + socially anxious"
2,"SUPPRF47953",45,54,56,-13,-15,58,71,69,"Pilot 11","Pilot 11: bigger feedback + video + socially anxious"
3,"SUPPRF47953",44,50,50,-12,-13,60,63,62,"Pilot 11","Pilot 11: bigger feedback + video + socially anxious"
4,"SUPPRF47953",51,57,71,5,0,54,71,66,"Pilot 11","Pilot 11: bigger feedback + video + socially anxious"
5,"SUPPRF47953",51,53,66,8,12,56,54,58,"Pilot 11","Pilot 11: bigger feedback + video + socially anxious"
6,"SUPPRF47953",52,53,33,-12,-13,64,46,45,"Pilot 11","Pilot 11: bigger feedback + video + socially anxious"
7,"SUPPRF47953",50,46,35,14,15,57,20,21,"Pilot 11","Pilot 11: bigger feedback + video + socially anxious"
8,"SUPPRF47953",63,49,81,11,1,63,80,70,"Pilot 11","Pilot 11: bigger feedback + video + socially anxious"
9,"SUPPRF47953",58,44,62,1,-1,55,63,61,"Pilot 11","Pilot 11: bigger feedback + video + socially anxious"
10,"SUPPRF47953",56,44,68,-1,-12,63,80,69,"Pilot 11","Pilot 11: bigger feedback + video + socially anxious"
11,"SUPPRF47953",61,38,46,26,17,68,29,20,"Pilot 11","Pilot 11: bigger feedback + video + socially anxious"
12,"SUPPRF47953",42,53,6,-11,-14,74,20,17,"Pilot 11","Pilot 11: bigger feedback + video + socially anxious"
13,"SUPPRF47953",59,47,80,10,0,78,80,70,"Pilot 11","Pilot 11: bigger feedback + video + socially anxious"
14,"SUPPRF47953",61,39,94,18,23,84,71,76,"Pilot 11","Pilot 11: bigger feedback + video + socially anxious"
15,"SUPPRF47953",63,32,20,7,0,84,20,13,"Pilot 11","Pilot 11: bigger feedback + video + socially anxious"
16,"SUPPRF47953",21,48,29,-42,0,74,29,71,"Pilot 11","Pilot 11: bigger feedback + video + socially anxious"
17,"SUPPRF47953",63,26,61,51,24,70,37,10,"Pilot 11","Pilot 11: bigger feedback + video + socially anxious"
18,"SUPPRF47953",29,42,22,-15,-15,64,37,37,"Pilot 11","Pilot 11: bigger feedback + video + socially anxious"
19,"SUPPRF47953",75,32,78,32,24,61,54,46,"Pilot 11","Pilot 11: bigger feedback + video + socially anxious"
20,"SUPPRF47953",67,45,63,18,0,78,63,45,"Pilot 11","Pilot 11: bigger feedback + video + socially anxious"
21,"SUPPRF47953",20,36,38,-23,1,64,37,61,"Pilot 11","Pilot 11: bigger feedback + video + socially anxious"
22,"SUPPRF47953",62,27,77,20,14,47,63,57,"Pilot 11","Pilot 11: bigger feedback + video + socially anxious"
23,"SUPPRF47953",14,42,38,-18,-16,51,54,56,"Pilot 11","Pilot 11: bigger feedback + video + socially anxious"
24,"SUPPRF47953",18,38,37,-15,0,49,37,52,"Pilot 11","Pilot 11: bigger feedback + video + socially anxious"
25,"SUPPRF47953",59,44,70,5,-1,64,71,65,"Pilot 11","Pilot 11: bigger feedback + video + socially anxious"
26,"SUPPRF47953",77,32,58,37,29,67,29,21,"Pilot 11","Pilot 11: bigger feedback + video + socially anxious"
27,"SUPPRF47953",80,35,83,14,12,67,71,69,"Pilot 11","Pilot 11: bigger feedback + video + socially anxious"
28,"SUPPRF47953",58,28,16,-2,-13,46,29,18,"Pilot 11","Pilot 11: bigger feedback + video + socially anxious"
29,"SUPPRF47953",59,26,47,-5,-16,69,63,52,"Pilot 11","Pilot 11: bigger feedback + video + socially anxious"
30,"SUPPRF47953",62,35,46,13,0,26,46,33,"Pilot 11","Pilot 11: bigger feedback + video + socially anxious"
31,"SUPPRF47953",61,40,49,4,12,64,37,45,"Pilot 11","Pilot 11: bigger feedback + video + socially anxious"
32,"SUPPRF47953",65,31,45,4,-1,68,46,41,"Pilot 11","Pilot 11: bigger feedback + video + socially anxious"
33,"SUPPRF47953",64,36,28,11,-1,79,29,17,"Pilot 11","Pilot 11: bigger feedback + video + socially anxious"
34,"SUPPRF47953",76,36,75,33,29,78,46,42,"Pilot 11","Pilot 11: bigger feedback + video + socially anxious"
35,"SUPPRF47953",82,34,88,24,25,78,63,64,"Pilot 11","Pilot 11: bigger feedback + video + socially anxious"
36,"SUPPRF47953",72,35,34,-8,-12,68,46,42,"Pilot 11","Pilot 11: bigger feedback + video + socially anxious"
37,"SUPPRF47953",91,25,100,26,20,77,80,74,"Pilot 11","Pilot 11: bigger feedback + video + socially anxious"
38,"SUPPRF47953",60,21,41,-6,-13,80,54,47,"Pilot 11","Pilot 11: bigger feedback + video + socially anxious"
39,"SUPPRF47953",57,29,67,-11,-13,91,80,78,"Pilot 11","Pilot 11: bigger feedback + video + socially anxious"
40,"SUPPRF47953",89,36,47,31,27,89,20,16,"Pilot 11","Pilot 11: bigger feedback + video + socially anxious"
41,"SUPPRF47953",60,43,24,-18,-13,81,37,42,"Pilot 11","Pilot 11: bigger feedback + video + socially anxious"
42,"SUPPRF47953",65,35,58,9,12,75,46,49,"Pilot 11","Pilot 11: bigger feedback + video + socially anxious"
43,"SUPPRF47953",60,49,8,-4,-12,82,20,12,"Pilot 11","Pilot 11: bigger feedback + video + socially anxious"
44,"SUPPRF47953",61,29,55,9,1,68,54,46,"Pilot 11","Pilot 11: bigger feedback + video + socially anxious"
45,"SUPPRF47953",60,41,54,5,0,77,54,49,"Pilot 11","Pilot 11: bigger feedback + video + socially anxious"
46,"SUPPRF47953",41,39,55,-12,-16,87,71,67,"Pilot 11","Pilot 11: bigger feedback + video + socially anxious"
47,"SUPPRF47953",77,41,96,47,16,54,80,49,"Pilot 11","Pilot 11: bigger feedback + video + socially anxious"
48,"SUPPRF47953",56,44,15,1,-14,80,29,14,"Pilot 11","Pilot 11: bigger feedback + video + socially anxious"
1,"SUPPRF80130",21,83,55,-26,-16,32,71,81,"Pilot 11","Pilot 11: bigger feedback + video + socially anxious"
2,"SUPPRF80130",47,87,83,45,12,32,71,38,"Pilot 11","Pilot 11: bigger feedback + video + socially anxious"
3,"SUPPRF80130",61,71,77,26,14,10,63,51,"Pilot 11","Pilot 11: bigger feedback + video + socially anxious"
4,"SUPPRF80130",57,59,62,-7,-1,3,63,69,"Pilot 11","Pilot 11: bigger feedback + video + socially anxious"
5,"SUPPRF80130",35,73,19,-48,-1,56,20,67,"Pilot 11","Pilot 11: bigger feedback + video + socially anxious"
6,"SUPPRF80130",69,49,96,11,16,55,80,85,"Pilot 11","Pilot 11: bigger feedback + video + socially anxious"
7,"SUPPRF80130",56,47,58,14,12,42,46,44,"Pilot 11","Pilot 11: bigger feedback + video + socially anxious"
8,"SUPPRF80130",52,49,50,10,-13,58,63,40,"Pilot 11","Pilot 11: bigger feedback + video + socially anxious"
9,"SUPPRF80130",54,33,46,-7,17,60,29,53,"Pilot 11","Pilot 11: bigger feedback + video + socially anxious"
10,"SUPPRF80130",74,26,47,-9,27,72,20,56,"Pilot 11","Pilot 11: bigger feedback + video + socially anxious"
11,"SUPPRF80130",82,21,47,-9,-16,57,63,56,"Pilot 11","Pilot 11: bigger feedback + video + socially anxious"
12,"SUPPRF80130",35,26,6,-81,-14,17,20,87,"Pilot 11","Pilot 11: bigger feedback + video + socially anxious"
13,"SUPPRF80130",66,25,88,23,25,51,63,65,"Pilot 11","Pilot 11: bigger feedback + video + socially anxious"
14,"SUPPRF80130",75,28,20,-35,0,57,20,55,"Pilot 11","Pilot 11: bigger feedback + video + socially anxious"
15,"SUPPRF80130",60,53,75,17,29,38,46,58,"Pilot 11","Pilot 11: bigger feedback + video + socially anxious"
16,"SUPPRF80130",66,64,66,7,12,43,54,59,"Pilot 11","Pilot 11: bigger feedback + video + socially anxious"
17,"SUPPRF80130",54,38,16,-47,-13,38,29,63,"Pilot 11","Pilot 11: bigger feedback + video + socially anxious"
18,"SUPPRF80130",65,35,22,-34,-15,36,37,56,"Pilot 11","Pilot 11: bigger feedback + video + socially anxious"
19,"SUPPRF80130",64,56,34,-36,-12,45,46,70,"Pilot 11","Pilot 11: bigger feedback + video + socially anxious"
20,"SUPPRF80130",71,54,28,-34,-1,34,29,62,"Pilot 11","Pilot 11: bigger feedback + video + socially anxious"
21,"SUPPRF80130",71,34,94,46,23,51,71,48,"Pilot 11","Pilot 11: bigger feedback + video + socially anxious"
22,"SUPPRF80130",65,40,15,-38,-14,35,29,53,"Pilot 11","Pilot 11: bigger feedback + video + socially anxious"
23,"SUPPRF80130",66,31,38,-23,-16,30,54,61,"Pilot 11","Pilot 11: bigger feedback + video + socially anxious"
24,"SUPPRF80130",67,33,81,13,1,42,80,68,"Pilot 11","Pilot 11: bigger feedback + video + socially anxious"
25,"SUPPRF80130",65,33,78,32,24,47,54,46,"Pilot 11","Pilot 11: bigger feedback + video + socially anxious"
26,"SUPPRF80130",62,35,37,-6,0,56,37,43,"Pilot 11","Pilot 11: bigger feedback + video + socially anxious"
27,"SUPPRF80130",64,30,63,17,0,43,63,46,"Pilot 11","Pilot 11: bigger feedback + video + socially anxious"
28,"SUPPRF80130",59,37,24,-33,-13,56,37,57,"Pilot 11","Pilot 11: bigger feedback + video + socially anxious"
29,"SUPPRF80130",65,37,41,-12,-13,44,54,53,"Pilot 11","Pilot 11: bigger feedback + video + socially anxious"
30,"SUPPRF80130",59,27,49,-13,12,48,37,62,"Pilot 11","Pilot 11: bigger feedback + video + socially anxious"
31,"SUPPRF80130",55,33,33,-19,-13,72,46,52,"Pilot 11","Pilot 11: bigger feedback + video + socially anxious"
32,"SUPPRF80130",67,33,56,3,-15,39,71,53,"Pilot 11","Pilot 11: bigger feedback + video + socially anxious"
33,"SUPPRF80130",72,34,61,2,24,40,37,59,"Pilot 11","Pilot 11: bigger feedback + video + socially anxious"
34,"SUPPRF80130",40,44,100,45,20,50,80,55,"Pilot 11","Pilot 11: bigger feedback + video + socially anxious"
35,"SUPPRF80130",52,38,8,-46,-12,36,20,54,"Pilot 11","Pilot 11: bigger feedback + video + socially anxious"
36,"SUPPRF80130",61,26,70,8,-1,35,71,62,"Pilot 11","Pilot 11: bigger feedback + video + socially anxious"
37,"SUPPRF80130",45,40,54,3,0,41,54,51,"Pilot 11","Pilot 11: bigger feedback + video + socially anxious"
38,"SUPPRF80130",55,27,29,-18,0,33,29,47,"Pilot 11","Pilot 11: bigger feedback + video + socially anxious"
39,"SUPPRF80130",57,34,80,27,0,51,80,53,"Pilot 11","Pilot 11: bigger feedback + video + socially anxious"
40,"SUPPRF80130",66,34,35,-37,15,47,20,72,"Pilot 11","Pilot 11: bigger feedback + video + socially anxious"
41,"SUPPRF80130",55,45,38,-18,1,32,37,56,"Pilot 11","Pilot 11: bigger feedback + video + socially anxious"
42,"SUPPRF80130",65,26,71,33,0,36,71,38,"Pilot 11","Pilot 11: bigger feedback + video + socially anxious"
43,"SUPPRF80130",64,32,68,5,-12,37,80,63,"Pilot 11","Pilot 11: bigger feedback + video + socially anxious"
44,"SUPPRF80130",61,51,58,1,29,33,29,57,"Pilot 11","Pilot 11: bigger feedback + video + socially anxious"
45,"SUPPRF80130",63,46,46,-13,0,39,46,59,"Pilot 11","Pilot 11: bigger feedback + video + socially anxious"
46,"SUPPRF80130",69,32,67,27,-13,36,80,40,"Pilot 11","Pilot 11: bigger feedback + video + socially anxious"
47,"SUPPRF80130",57,31,45,-25,-1,36,46,70,"Pilot 11","Pilot 11: bigger feedback + video + socially anxious"
48,"SUPPRF80130",93,10,55,6,1,30,54,49,"Pilot 11","Pilot 11: bigger feedback + video + socially anxious"
1,"SUPPRF97792",18,91,8,-24,-12,74,20,32,"Pilot 11","Pilot 11: bigger feedback + video + socially anxious"
2,"SUPPRF97792",38,56,58,9,12,77,46,49,"Pilot 11","Pilot 11: bigger feedback + video + socially anxious"
3,"SUPPRF97792",50,47,54,-3,0,83,54,57,"Pilot 11","Pilot 11: bigger feedback + video + socially anxious"
4,"SUPPRF97792",63,35,71,8,0,84,71,63,"Pilot 11","Pilot 11: bigger feedback + video + socially anxious"
5,"SUPPRF97792",36,59,70,10,-1,75,71,60,"Pilot 11","Pilot 11: bigger feedback + video + socially anxious"
6,"SUPPRF97792",67,29,35,16,15,59,20,19,"Pilot 11","Pilot 11: bigger feedback + video + socially anxious"
7,"SUPPRF97792",70,20,61,0,24,79,37,61,"Pilot 11","Pilot 11: bigger feedback + video + socially anxious"
8,"SUPPRF97792",52,47,55,-15,-16,81,71,70,"Pilot 11","Pilot 11: bigger feedback + video + socially anxious"
9,"SUPPRF97792",60,33,83,24,12,76,71,59,"Pilot 11","Pilot 11: bigger feedback + video + socially anxious"
10,"SUPPRF97792",40,56,33,-19,-13,68,46,52,"Pilot 11","Pilot 11: bigger feedback + video + socially anxious"
11,"SUPPRF97792",65,25,46,-22,17,76,29,68,"Pilot 11","Pilot 11: bigger feedback + video + socially anxious"
12,"SUPPRF97792",54,40,63,3,0,70,63,60,"Pilot 11","Pilot 11: bigger feedback + video + socially anxious"
13,"SUPPRF97792",28,68,50,-25,-13,70,63,75,"Pilot 11","Pilot 11: bigger feedback + video + socially anxious"
14,"SUPPRF97792",64,44,19,-44,-1,82,20,63,"Pilot 11","Pilot 11: bigger feedback + video + socially anxious"
15,"SUPPRF97792",62,38,56,-9,-15,80,71,65,"Pilot 11","Pilot 11: bigger feedback + video + socially anxious"
16,"SUPPRF97792",36,54,58,-9,29,83,29,67,"Pilot 11","Pilot 11: bigger feedback + video + socially anxious"
17,"SUPPRF97792",54,50,49,-15,12,74,37,64,"Pilot 11","Pilot 11: bigger feedback + video + socially anxious"
18,"SUPPRF97792",77,32,62,2,-1,70,63,60,"Pilot 11","Pilot 11: bigger feedback + video + socially anxious"
19,"SUPPRF97792",67,30,77,12,14,71,63,65,"Pilot 11","Pilot 11: bigger feedback + video + socially anxious"
20,"SUPPRF97792",67,25,66,0,12,67,54,66,"Pilot 11","Pilot 11: bigger feedback + video + socially anxious"
21,"SUPPRF97792",62,46,55,-9,1,71,54,64,"Pilot 11","Pilot 11: bigger feedback + video + socially anxious"
22,"SUPPRF97792",32,64,38,-30,1,73,37,68,"Pilot 11","Pilot 11: bigger feedback + video + socially anxious"
23,"SUPPRF97792",0,90,34,-34,-12,74,46,68,"Pilot 11","Pilot 11: bigger feedback + video + socially anxious"
24,"SUPPRF97792",78,21,81,-19,1,89,80,100,"Pilot 11","Pilot 11: bigger feedback + video + socially anxious"
25,"SUPPRF97792",80,18,88,18,25,69,63,70,"Pilot 11","Pilot 11: bigger feedback + video + socially anxious"
26,"SUPPRF97792",0,96,37,-35,0,77,37,72,"Pilot 11","Pilot 11: bigger feedback + video + socially anxious"
27,"SUPPRF97792",0,100,68,-21,-12,100,80,89,"Pilot 11","Pilot 11: bigger feedback + video + socially anxious"
28,"SUPPRF97792",29,82,80,-20,0,100,80,100,"Pilot 11","Pilot 11: bigger feedback + video + socially anxious"
29,"SUPPRF97792",89,11,94,23,23,81,71,71,"Pilot 11","Pilot 11: bigger feedback + video + socially anxious"
30,"SUPPRF97792",0,100,22,-53,-15,83,37,75,"Pilot 11","Pilot 11: bigger feedback + video + socially anxious"
31,"SUPPRF97792",0,100,47,-22,27,86,20,69,"Pilot 11","Pilot 11: bigger feedback + video + socially anxious"
32,"SUPPRF97792",59,41,78,7,24,85,54,71,"Pilot 11","Pilot 11: bigger feedback + video + socially anxious"
33,"SUPPRF97792",36,63,41,-25,-13,79,54,66,"Pilot 11","Pilot 11: bigger feedback + video + socially anxious"
34,"SUPPRF97792",14,81,46,-22,0,78,46,68,"Pilot 11","Pilot 11: bigger feedback + video + socially anxious"
35,"SUPPRF97792",91,8,100,32,20,87,80,68,"Pilot 11","Pilot 11: bigger feedback + video + socially anxious"
36,"SUPPRF97792",64,36,15,-60,-14,100,29,75,"Pilot 11","Pilot 11: bigger feedback + video + socially anxious"
37,"SUPPRF97792",18,80,28,-6,-1,70,29,34,"Pilot 11","Pilot 11: bigger feedback + video + socially anxious"
38,"SUPPRF97792",75,17,75,15,29,75,46,60,"Pilot 11","Pilot 11: bigger feedback + video + socially anxious"
39,"SUPPRF97792",0,100,24,-40,-13,83,37,64,"Pilot 11","Pilot 11: bigger feedback + video + socially anxious"
40,"SUPPRF97792",0,100,29,-47,0,87,29,76,"Pilot 11","Pilot 11: bigger feedback + video + socially anxious"
41,"SUPPRF97792",0,100,6,-74,-14,91,20,80,"Pilot 11","Pilot 11: bigger feedback + video + socially anxious"
42,"SUPPRF97792",14,85,45,-24,-1,89,46,69,"Pilot 11","Pilot 11: bigger feedback + video + socially anxious"
43,"SUPPRF97792",10,84,67,-14,-13,91,80,81,"Pilot 11","Pilot 11: bigger feedback + video + socially anxious"
44,"SUPPRF97792",0,98,16,-75,-13,94,29,91,"Pilot 11","Pilot 11: bigger feedback + video + socially anxious"
45,"SUPPRF97792",0,100,38,-31,-16,78,54,69,"Pilot 11","Pilot 11: bigger feedback + video + socially anxious"
46,"SUPPRF97792",56,8,47,-20,-16,83,63,67,"Pilot 11","Pilot 11: bigger feedback + video + socially anxious"
47,"SUPPRF97792",98,0,96,22,16,87,80,74,"Pilot 11","Pilot 11: bigger feedback + video + socially anxious"
48,"SUPPRF97792",22,21,20,-54,0,85,20,74,"Pilot 11","Pilot 11: bigger feedback + video + socially anxious"
1,"SUPPRF09619",68,74,54,-21,0,81,54,75,"Pilot 11","Pilot 11: bigger feedback + video + socially anxious"
2,"SUPPRF09619",76,57,77,13,14,64,63,64,"Pilot 11","Pilot 11: bigger feedback + video + socially anxious"
3,"SUPPRF09619",70,53,80,26,0,65,80,54,"Pilot 11","Pilot 11: bigger feedback + video + socially anxious"
4,"SUPPRF09619",69,78,75,2,29,63,46,73,"Pilot 11","Pilot 11: bigger feedback + video + socially anxious"
5,"SUPPRF09619",59,63,47,9,27,82,20,38,"Pilot 11","Pilot 11: bigger feedback + video + socially anxious"
6,"SUPPRF09619",64,80,88,-10,25,77,63,98,"Pilot 11","Pilot 11: bigger feedback + video + socially anxious"
7,"SUPPRF09619",72,69,81,2,1,85,80,79,"Pilot 11","Pilot 11: bigger feedback + video + socially anxious"
8,"SUPPRF09619",24,36,15,-76,-14,74,29,91,"Pilot 11","Pilot 11: bigger feedback + video + socially anxious"
9,"SUPPRF09619",82,82,46,-22,0,88,46,68,"Pilot 11","Pilot 11: bigger feedback + video + socially anxious"
10,"SUPPRF09619",71,74,38,0,-16,56,54,38,"Pilot 11","Pilot 11: bigger feedback + video + socially anxious"
11,"SUPPRF09619",69,80,67,-8,-13,69,80,75,"Pilot 11","Pilot 11: bigger feedback + video + socially anxious"
12,"SUPPRF09619",74,81,49,-30,12,86,37,79,"Pilot 11","Pilot 11: bigger feedback + video + socially anxious"
13,"SUPPRF09619",51,66,24,-47,-13,63,37,71,"Pilot 11","Pilot 11: bigger feedback + video + socially anxious"
14,"SUPPRF09619",81,96,94,-4,23,83,71,98,"Pilot 11","Pilot 11: bigger feedback + video + socially anxious"
15,"SUPPRF09619",84,82,45,-43,-1,80,46,88,"Pilot 11","Pilot 11: bigger feedback + video + socially anxious"
16,"SUPPRF09619",59,62,68,8,-12,57,80,60,"Pilot 11","Pilot 11: bigger feedback + video + socially anxious"
17,"SUPPRF09619",59,62,56,-34,-15,55,71,90,"Pilot 11","Pilot 11: bigger feedback + video + socially anxious"
18,"SUPPRF09619",75,97,83,40,12,45,71,43,"Pilot 11","Pilot 11: bigger feedback + video + socially anxious"
19,"SUPPRF09619",89,88,6,-72,-14,69,20,78,"Pilot 11","Pilot 11: bigger feedback + video + socially anxious"
20,"SUPPRF09619",69,73,55,-31,1,87,54,86,"Pilot 11","Pilot 11: bigger feedback + video + socially anxious"
21,"SUPPRF09619",80,63,66,-19,12,79,54,85,"Pilot 11","Pilot 11: bigger feedback + video + socially anxious"
22,"SUPPRF09619",54,80,33,-52,-13,87,46,85,"Pilot 11","Pilot 11: bigger feedback + video + socially anxious"
23,"SUPPRF09619",64,58,37,-37,0,69,37,74,"Pilot 11","Pilot 11: bigger feedback + video + socially anxious"
24,"SUPPRF09619",60,70,28,-36,-1,58,29,64,"Pilot 11","Pilot 11: bigger feedback + video + socially anxious"
25,"SUPPRF09619",55,48,41,24,-13,35,54,17,"Pilot 11","Pilot 11: bigger feedback + video + socially anxious"
26,"SUPPRF09619",55,55,46,7,17,46,29,39,"Pilot 11","Pilot 11: bigger feedback + video + socially anxious"
27,"SUPPRF09619",77,49,55,-36,-16,59,71,91,"Pilot 11","Pilot 11: bigger feedback + video + socially anxious"
28,"SUPPRF09619",46,34,58,-11,29,76,29,69,"Pilot 11","Pilot 11: bigger feedback + video + socially anxious"
29,"SUPPRF09619",62,68,70,3,-1,76,71,67,"Pilot 11","Pilot 11: bigger feedback + video + socially anxious"
30,"SUPPRF09619",55,64,78,3,24,73,54,75,"Pilot 11","Pilot 11: bigger feedback + video + socially anxious"
31,"SUPPRF09619",57,74,29,-36,0,64,29,65,"Pilot 11","Pilot 11: bigger feedback + video + socially anxious"
32,"SUPPRF09619",75,71,63,-1,0,70,63,64,"Pilot 11","Pilot 11: bigger feedback + video + socially anxious"
33,"SUPPRF09619",75,55,100,37,20,65,80,63,"Pilot 11","Pilot 11: bigger feedback + video + socially anxious"
34,"SUPPRF09619",44,51,8,-15,-12,53,20,23,"Pilot 11","Pilot 11: bigger feedback + video + socially anxious"
35,"SUPPRF09619",63,74,71,-18,0,84,71,89,"Pilot 11","Pilot 11: bigger feedback + video + socially anxious"
36,"SUPPRF09619",69,60,20,-39,0,54,20,59,"Pilot 11","Pilot 11: bigger feedback + video + socially anxious"
37,"SUPPRF09619",80,81,35,-64,15,85,20,99,"Pilot 11","Pilot 11: bigger feedback + video + socially anxious"
38,"SUPPRF09619",76,74,34,-61,-12,57,46,95,"Pilot 11","Pilot 11: bigger feedback + video + socially anxious"
39,"SUPPRF09619",63,65,62,-32,-1,52,63,94,"Pilot 11","Pilot 11: bigger feedback + video + socially anxious"
40,"SUPPRF09619",51,79,38,-42,1,60,37,80,"Pilot 11","Pilot 11: bigger feedback + video + socially anxious"
41,"SUPPRF09619",64,71,50,-33,-13,82,63,83,"Pilot 11","Pilot 11: bigger feedback + video + socially anxious"
42,"SUPPRF09619",58,60,61,4,24,69,37,57,"Pilot 11","Pilot 11: bigger feedback + video + socially anxious"
43,"SUPPRF09619",66,83,96,7,16,80,80,89,"Pilot 11","Pilot 11: bigger feedback + video + socially anxious"
44,"SUPPRF09619",47,70,47,-50,-16,58,63,97,"Pilot 11","Pilot 11: bigger feedback + video + socially anxious"
45,"SUPPRF09619",62,68,58,-28,12,57,46,86,"Pilot 11","Pilot 11: bigger feedback + video + socially anxious"
46,"SUPPRF09619",77,41,22,-48,-15,74,37,70,"Pilot 11","Pilot 11: bigger feedback + video + socially anxious"
47,"SUPPRF09619",76,74,19,-73,-1,57,20,92,"Pilot 11","Pilot 11: bigger feedback + video + socially anxious"
48,"SUPPRF09619",52,51,16,-69,-13,85,29,85,"Pilot 11","Pilot 11: bigger feedback + video + socially anxious"
1,"SUPPRF96614",35,74,67,28,-13,70,80,39,"Pilot 11","Pilot 11: bigger feedback + video + socially anxious"
2,"SUPPRF96614",39,68,16,-17,-13,41,29,33,"Pilot 11","Pilot 11: bigger feedback + video + socially anxious"
3,"SUPPRF96614",64,43,55,-6,1,54,54,61,"Pilot 11","Pilot 11: bigger feedback + video + socially anxious"
4,"SUPPRF96614",67,19,58,11,12,36,46,47,"Pilot 11","Pilot 11: bigger feedback + video + socially anxious"
5,"SUPPRF96614",55,28,20,-16,0,43,20,36,"Pilot 11","Pilot 11: bigger feedback + video + socially anxious"
6,"SUPPRF96614",65,54,55,-8,-16,65,71,63,"Pilot 11","Pilot 11: bigger feedback + video + socially anxious"
7,"SUPPRF96614",53,56,38,-31,1,51,37,69,"Pilot 11","Pilot 11: bigger feedback + video + socially anxious"
8,"SUPPRF96614",32,37,34,-29,-12,59,46,63,"Pilot 11","Pilot 11: bigger feedback + video + socially anxious"
9,"SUPPRF96614",54,55,62,-1,-1,57,63,63,"Pilot 11","Pilot 11: bigger feedback + video + socially anxious"
10,"SUPPRF96614",57,55,50,-8,-13,56,63,58,"Pilot 11","Pilot 11: bigger feedback + video + socially anxious"
11,"SUPPRF96614",55,52,38,-18,-16,55,54,56,"Pilot 11","Pilot 11: bigger feedback + video + socially anxious"
12,"SUPPRF96614",69,38,41,-28,-13,58,54,69,"Pilot 11","Pilot 11: bigger feedback + video + socially anxious"
13,"SUPPRF96614",33,45,19,-8,-1,61,20,27,"Pilot 11","Pilot 11: bigger feedback + video + socially anxious"
14,"SUPPRF96614",51,47,61,4,24,61,37,57,"Pilot 11","Pilot 11: bigger feedback + video + socially anxious"
15,"SUPPRF96614",47,57,81,6,1,57,80,75,"Pilot 11","Pilot 11: bigger feedback + video + socially anxious"
16,"SUPPRF96614",64,40,78,26,24,35,54,52,"Pilot 11","Pilot 11: bigger feedback + video + socially anxious"
17,"SUPPRF96614",43,24,47,21,27,47,20,26,"Pilot 11","Pilot 11: bigger feedback + video + socially anxious"
18,"SUPPRF96614",59,41,75,32,29,46,46,43,"Pilot 11","Pilot 11: bigger feedback + video + socially anxious"
19,"SUPPRF96614",44,44,22,-33,-15,57,37,55,"Pilot 11","Pilot 11: bigger feedback + video + socially anxious"
20,"SUPPRF96614",69,53,35,0,15,29,20,35,"Pilot 11","Pilot 11: bigger feedback + video + socially anxious"
21,"SUPPRF96614",8,28,6,-36,-14,38,20,42,"Pilot 11","Pilot 11: bigger feedback + video + socially anxious"
22,"SUPPRF96614",51,51,49,11,12,46,37,38,"Pilot 11","Pilot 11: bigger feedback + video + socially anxious"
23,"SUPPRF96614",62,23,46,-3,17,50,29,49,"Pilot 11","Pilot 11: bigger feedback + video + socially anxious"
24,"SUPPRF96614",80,17,83,-1,12,58,71,84,"Pilot 11","Pilot 11: bigger feedback + video + socially anxious"
25,"SUPPRF96614",77,9,77,40,14,34,63,37,"Pilot 11","Pilot 11: bigger feedback + video + socially anxious"
26,"SUPPRF96614",86,9,46,2,0,78,46,44,"Pilot 11","Pilot 11: bigger feedback + video + socially anxious"
27,"SUPPRF96614",74,23,63,3,0,41,63,60,"Pilot 11","Pilot 11: bigger feedback + video + socially anxious"
28,"SUPPRF96614",20,9,28,-15,-1,55,29,43,"Pilot 11","Pilot 11: bigger feedback + video + socially anxious"
29,"SUPPRF96614",69,16,71,-4,0,72,71,75,"Pilot 11","Pilot 11: bigger feedback + video + socially anxious"
30,"SUPPRF96614",85,14,58,7,29,39,29,51,"Pilot 11","Pilot 11: bigger feedback + video + socially anxious"
31,"SUPPRF96614",30,17,56,-15,-15,66,71,71,"Pilot 11","Pilot 11: bigger feedback + video + socially anxious"
32,"SUPPRF96614",6,19,15,-34,-14,52,29,49,"Pilot 11","Pilot 11: bigger feedback + video + socially anxious"
33,"SUPPRF96614",80,6,80,31,0,38,80,49,"Pilot 11","Pilot 11: bigger feedback + video + socially anxious"
34,"SUPPRF96614",51,16,33,-21,-13,39,46,54,"Pilot 11","Pilot 11: bigger feedback + video + socially anxious"
35,"SUPPRF96614",94,5,96,46,16,48,80,50,"Pilot 11","Pilot 11: bigger feedback + video + socially anxious"
36,"SUPPRF96614",82,23,68,-20,-12,76,80,88,"Pilot 11","Pilot 11: bigger feedback + video + socially anxious"
37,"SUPPRF96614",82,9,70,-4,-1,41,71,74,"Pilot 11","Pilot 11: bigger feedback + video + socially anxious"
38,"SUPPRF96614",74,20,45,0,-1,68,46,45,"Pilot 11","Pilot 11: bigger feedback + video + socially anxious"
39,"SUPPRF96614",16,20,24,-36,-13,30,37,60,"Pilot 11","Pilot 11: bigger feedback + video + socially anxious"
40,"SUPPRF96614",73,18,29,1,0,33,29,28,"Pilot 11","Pilot 11: bigger feedback + video + socially anxious"
41,"SUPPRF96614",8,13,8,-45,-12,49,20,53,"Pilot 11","Pilot 11: bigger feedback + video + socially anxious"
42,"SUPPRF96614",75,29,66,13,12,49,54,53,"Pilot 11","Pilot 11: bigger feedback + video + socially anxious"
43,"SUPPRF96614",68,16,47,-12,-16,29,63,59,"Pilot 11","Pilot 11: bigger feedback + video + socially anxious"
44,"SUPPRF96614",85,13,88,22,25,73,63,66,"Pilot 11","Pilot 11: bigger feedback + video + socially anxious"
45,"SUPPRF96614",98,3,100,27,20,65,80,73,"Pilot 11","Pilot 11: bigger feedback + video + socially anxious"
46,"SUPPRF96614",68,2,37,4,0,57,37,33,"Pilot 11","Pilot 11: bigger feedback + video + socially anxious"
47,"SUPPRF96614",63,13,54,-5,0,35,54,59,"Pilot 11","Pilot 11: bigger feedback + video + socially anxious"
48,"SUPPRF96614",97,6,94,19,23,20,71,75,"Pilot 11","Pilot 11: bigger feedback + video + socially anxious"
1,"SUPPRF47214",15,87,37,-5,0,1,37,42,"Pilot 11","Pilot 11: bigger feedback + video + socially anxious"
2,"SUPPRF47214",37,89,38,-2,-16,1,54,40,"Pilot 11","Pilot 11: bigger feedback + video + socially anxious"
3,"SUPPRF47214",62,89,63,0,0,1,63,63,"Pilot 11","Pilot 11: bigger feedback + video + socially anxious"
4,"SUPPRF47214",50,96,55,-14,-16,0,71,69,"Pilot 11","Pilot 11: bigger feedback + video + socially anxious"
5,"SUPPRF47214",38,96,50,-36,-13,0,63,86,"Pilot 11","Pilot 11: bigger feedback + video + socially anxious"
6,"SUPPRF47214",28,91,47,3,-16,1,63,44,"Pilot 11","Pilot 11: bigger feedback + video + socially anxious"
7,"SUPPRF47214",45,95,66,25,12,1,54,41,"Pilot 11","Pilot 11: bigger feedback + video + socially anxious"
8,"SUPPRF47214",44,94,58,14,12,5,46,44,"Pilot 11","Pilot 11: bigger feedback + video + socially anxious"
9,"SUPPRF47214",50,96,78,29,24,2,54,49,"Pilot 11","Pilot 11: bigger feedback + video + socially anxious"
10,"SUPPRF47214",35,96,46,1,0,1,46,45,"Pilot 11","Pilot 11: bigger feedback + video + socially anxious"
11,"SUPPRF47214",22,95,22,-16,-15,2,37,38,"Pilot 11","Pilot 11: bigger feedback + video + socially anxious"
12,"SUPPRF47214",61,96,100,63,20,2,80,37,"Pilot 11","Pilot 11: bigger feedback + video + socially anxious"
13,"SUPPRF47214",50,77,58,32,29,2,29,26,"Pilot 11","Pilot 11: bigger feedback + video + socially anxious"
14,"SUPPRF47214",40,91,33,7,-13,3,46,26,"Pilot 11","Pilot 11: bigger feedback + video + socially anxious"
15,"SUPPRF47214",42,84,15,-8,-14,6,29,23,"Pilot 11","Pilot 11: bigger feedback + video + socially anxious"
16,"SUPPRF47214",41,85,83,59,12,4,71,24,"Pilot 11","Pilot 11: bigger feedback + video + socially anxious"
17,"SUPPRF47214",47,79,81,41,1,4,80,40,"Pilot 11","Pilot 11: bigger feedback + video + socially anxious"
18,"SUPPRF47214",47,95,8,3,-12,3,20,5,"Pilot 11","Pilot 11: bigger feedback + video + socially anxious"
19,"SUPPRF47214",41,76,45,21,-1,4,46,24,"Pilot 11","Pilot 11: bigger feedback + video + socially anxious"
20,"SUPPRF47214",57,85,80,56,0,3,80,24,"Pilot 11","Pilot 11: bigger feedback + video + socially anxious"
21,"SUPPRF47214",54,82,41,18,-13,4,54,23,"Pilot 11","Pilot 11: bigger feedback + video + socially anxious"
22,"SUPPRF47214",57,83,61,40,24,6,37,21,"Pilot 11","Pilot 11: bigger feedback + video + socially anxious"
23,"SUPPRF47214",64,87,47,39,27,0,20,8,"Pilot 11","Pilot 11: bigger feedback + video + socially anxious"
24,"SUPPRF47214",47,82,38,-3,1,6,37,41,"Pilot 11","Pilot 11: bigger feedback + video + socially anxious"
25,"SUPPRF47214",50,82,24,-7,-13,6,37,31,"Pilot 11","Pilot 11: bigger feedback + video + socially anxious"
26,"SUPPRF47214",53,88,88,65,25,2,63,23,"Pilot 11","Pilot 11: bigger feedback + video + socially anxious"
27,"SUPPRF47214",50,81,71,50,0,5,71,21,"Pilot 11","Pilot 11: bigger feedback + video + socially anxious"
28,"SUPPRF47214",52,89,55,36,1,3,54,19,"Pilot 11","Pilot 11: bigger feedback + video + socially anxious"
29,"SUPPRF47214",45,90,75,57,29,2,46,18,"Pilot 11","Pilot 11: bigger feedback + video + socially anxious"
30,"SUPPRF47214",45,82,46,27,17,7,29,19,"Pilot 11","Pilot 11: bigger feedback + video + socially anxious"
31,"SUPPRF47214",45,85,77,63,14,5,63,14,"Pilot 11","Pilot 11: bigger feedback + video + socially anxious"
32,"SUPPRF47214",50,84,20,4,0,3,20,16,"Pilot 11","Pilot 11: bigger feedback + video + socially anxious"
33,"SUPPRF47214",52,79,68,59,-12,6,80,9,"Pilot 11","Pilot 11: bigger feedback + video + socially anxious"
34,"SUPPRF47214",49,71,94,63,23,8,71,31,"Pilot 11","Pilot 11: bigger feedback + video + socially anxious"
35,"SUPPRF47214",56,82,62,41,-1,6,63,21,"Pilot 11","Pilot 11: bigger feedback + video + socially anxious"
36,"SUPPRF47214",33,92,6,-8,-14,5,20,14,"Pilot 11","Pilot 11: bigger feedback + video + socially anxious"
37,"SUPPRF47214",38,89,34,10,-12,7,46,24,"Pilot 11","Pilot 11: bigger feedback + video + socially anxious"
38,"SUPPRF47214",43,90,19,14,-1,3,20,5,"Pilot 11","Pilot 11: bigger feedback + video + socially anxious"
39,"SUPPRF47214",49,83,56,34,-15,3,71,22,"Pilot 11","Pilot 11: bigger feedback + video + socially anxious"
40,"SUPPRF47214",50,80,96,83,16,5,80,13,"Pilot 11","Pilot 11: bigger feedback + video + socially anxious"
41,"SUPPRF47214",50,84,49,31,12,6,37,18,"Pilot 11","Pilot 11: bigger feedback + video + socially anxious"
42,"SUPPRF47214",57,80,35,26,15,2,20,9,"Pilot 11","Pilot 11: bigger feedback + video + socially anxious"
43,"SUPPRF47214",46,81,29,16,0,8,29,13,"Pilot 11","Pilot 11: bigger feedback + video + socially anxious"
44,"SUPPRF47214",47,85,28,12,-1,5,29,16,"Pilot 11","Pilot 11: bigger feedback + video + socially anxious"
45,"SUPPRF47214",44,76,67,48,-13,3,80,19,"Pilot 11","Pilot 11: bigger feedback + video + socially anxious"
46,"SUPPRF47214",50,75,16,4,-13,3,29,12,"Pilot 11","Pilot 11: bigger feedback + video + socially anxious"
47,"SUPPRF47214",43,82,54,45,0,2,54,9,"Pilot 11","Pilot 11: bigger feedback + video + socially anxious"
48,"SUPPRF47214",50,81,70,61,-1,4,71,9,"Pilot 11","Pilot 11: bigger feedback + video + socially anxious"
1,"SUPPRF23161",51,74,47,1,-16,68,63,46,"Pilot 11","Pilot 11: bigger feedback + video + socially anxious"
2,"SUPPRF23161",17,81,16,-10,-13,79,29,26,"Pilot 11","Pilot 11: bigger feedback + video + socially anxious"
3,"SUPPRF23161",20,79,55,11,-16,23,71,44,"Pilot 11","Pilot 11: bigger feedback + video + socially anxious"
4,"SUPPRF23161",22,80,54,27,0,26,54,27,"Pilot 11","Pilot 11: bigger feedback + video + socially anxious"
5,"SUPPRF23161",20,75,38,-3,-16,77,54,41,"Pilot 11","Pilot 11: bigger feedback + video + socially anxious"
6,"SUPPRF23161",20,77,20,5,0,58,20,15,"Pilot 11","Pilot 11: bigger feedback + video + socially anxious"
7,"SUPPRF23161",28,78,56,34,-15,52,71,22,"Pilot 11","Pilot 11: bigger feedback + video + socially anxious"
8,"SUPPRF23161",18,67,83,50,12,58,71,33,"Pilot 11","Pilot 11: bigger feedback + video + socially anxious"
9,"SUPPRF23161",36,74,63,10,0,29,63,53,"Pilot 11","Pilot 11: bigger feedback + video + socially anxious"
10,"SUPPRF23161",20,79,62,27,-1,32,63,35,"Pilot 11","Pilot 11: bigger feedback + video + socially anxious"
11,"SUPPRF23161",8,81,37,-26,0,61,37,63,"Pilot 11","Pilot 11: bigger feedback + video + socially anxious"
12,"SUPPRF23161",22,85,77,30,14,59,63,47,"Pilot 11","Pilot 11: bigger feedback + video + socially anxious"
13,"SUPPRF23161",17,81,8,-13,-12,21,20,21,"Pilot 11","Pilot 11: bigger feedback + video + socially anxious"
14,"SUPPRF23161",22,83,78,22,24,38,54,56,"Pilot 11","Pilot 11: bigger feedback + video + socially anxious"
15,"SUPPRF23161",15,76,15,-18,-14,55,29,33,"Pilot 11","Pilot 11: bigger feedback + video + socially anxious"
16,"SUPPRF23161",12,88,70,40,-1,40,71,30,"Pilot 11","Pilot 11: bigger feedback + video + socially anxious"
17,"SUPPRF23161",14,83,75,24,29,25,46,51,"Pilot 11","Pilot 11: bigger feedback + video + socially anxious"
18,"SUPPRF23161",25,70,38,8,1,87,37,30,"Pilot 11","Pilot 11: bigger feedback + video + socially anxious"
19,"SUPPRF23161",16,83,67,33,-13,28,80,34,"Pilot 11","Pilot 11: bigger feedback + video + socially anxious"
20,"SUPPRF23161",27,85,58,6,12,23,46,52,"Pilot 11","Pilot 11: bigger feedback + video + socially anxious"
21,"SUPPRF23161",11,91,28,9,-1,81,29,19,"Pilot 11","Pilot 11: bigger feedback + video + socially anxious"
22,"SUPPRF23161",11,91,6,-30,-14,11,20,36,"Pilot 11","Pilot 11: bigger feedback + video + socially anxious"
23,"SUPPRF23161",12,85,33,1,-13,64,46,32,"Pilot 11","Pilot 11: bigger feedback + video + socially anxious"
24,"SUPPRF23161",20,91,55,13,1,53,54,42,"Pilot 11","Pilot 11: bigger feedback + video + socially anxious"
25,"SUPPRF23161",14,93,46,37,17,85,29,9,"Pilot 11","Pilot 11: bigger feedback + video + socially anxious"
26,"SUPPRF23161",20,85,96,80,16,14,80,16,"Pilot 11","Pilot 11: bigger feedback + video + socially anxious"
27,"SUPPRF23161",12,90,88,45,25,10,63,43,"Pilot 11","Pilot 11: bigger feedback + video + socially anxious"
28,"SUPPRF23161",37,91,71,41,0,48,71,30,"Pilot 11","Pilot 11: bigger feedback + video + socially anxious"
29,"SUPPRF23161",18,84,66,10,12,34,54,56,"Pilot 11","Pilot 11: bigger feedback + video + socially anxious"
30,"SUPPRF23161",7,92,19,-36,-1,11,20,55,"Pilot 11","Pilot 11: bigger feedback + video + socially anxious"
31,"SUPPRF23161",6,95,58,39,29,12,29,19,"Pilot 11","Pilot 11: bigger feedback + video + socially anxious"
32,"SUPPRF23161",9,84,47,28,27,71,20,19,"Pilot 11","Pilot 11: bigger feedback + video + socially anxious"
33,"SUPPRF23161",26,89,80,58,0,24,80,22,"Pilot 11","Pilot 11: bigger feedback + video + socially anxious"
34,"SUPPRF23161",20,94,94,38,23,63,71,56,"Pilot 11","Pilot 11: bigger feedback + video + socially anxious"
35,"SUPPRF23161",16,90,61,11,24,29,37,50,"Pilot 11","Pilot 11: bigger feedback + video + socially anxious"
36,"SUPPRF23161",15,84,45,-9,-1,64,46,54,"Pilot 11","Pilot 11: bigger feedback + video + socially anxious"
37,"SUPPRF23161",19,88,100,55,20,22,80,45,"Pilot 11","Pilot 11: bigger feedback + video + socially anxious"
38,"SUPPRF23161",18,82,81,7,1,58,80,74,"Pilot 11","Pilot 11: bigger feedback + video + socially anxious"
39,"SUPPRF23161",11,90,68,10,-12,54,80,58,"Pilot 11","Pilot 11: bigger feedback + video + socially anxious"
40,"SUPPRF23161",14,89,49,22,12,50,37,27,"Pilot 11","Pilot 11: bigger feedback + video + socially anxious"
41,"SUPPRF23161",22,80,35,-16,15,27,20,51,"Pilot 11","Pilot 11: bigger feedback + video + socially anxious"
42,"SUPPRF23161",13,94,22,-14,-15,71,37,36,"Pilot 11","Pilot 11: bigger feedback + video + socially anxious"
43,"SUPPRF23161",9,90,50,-8,-13,44,63,58,"Pilot 11","Pilot 11: bigger feedback + video + socially anxious"
44,"SUPPRF23161",25,90,34,-10,-12,19,46,44,"Pilot 11","Pilot 11: bigger feedback + video + socially anxious"
45,"SUPPRF23161",10,96,41,13,-13,17,54,28,"Pilot 11","Pilot 11: bigger feedback + video + socially anxious"
46,"SUPPRF23161",6,91,29,9,0,71,29,20,"Pilot 11","Pilot 11: bigger feedback + video + socially anxious"
47,"SUPPRF23161",11,86,24,-35,-13,24,37,59,"Pilot 11","Pilot 11: bigger feedback + video + socially anxious"
48,"SUPPRF23161",14,91,46,6,0,25,46,40,"Pilot 11","Pilot 11: bigger feedback + video + socially anxious"
1,"SUPPRF13297",3,100,34,0,-12,28,46,34,"Pilot 11","Pilot 11: bigger feedback + video + socially anxious"
2,"SUPPRF13297",0,100,20,12,0,87,20,8,"Pilot 11","Pilot 11: bigger feedback + video + socially anxious"
3,"SUPPRF13297",0,100,56,-16,-15,37,71,72,"Pilot 11","Pilot 11: bigger feedback + video + socially anxious"
4,"SUPPRF13297",0,100,41,-12,-13,38,54,53,"Pilot 11","Pilot 11: bigger feedback + video + socially anxious"
5,"SUPPRF13297",35,78,83,40,12,2,71,43,"Pilot 11","Pilot 11: bigger feedback + video + socially anxious"
6,"SUPPRF13297",50,41,77,8,14,0,63,69,"Pilot 11","Pilot 11: bigger feedback + video + socially anxious"
7,"SUPPRF13297",85,17,47,47,27,76,20,0,"Pilot 11","Pilot 11: bigger feedback + video + socially anxious"
8,"SUPPRF13297",9,95,8,-5,-12,80,20,13,"Pilot 11","Pilot 11: bigger feedback + video + socially anxious"
9,"SUPPRF13297",0,100,6,-8,-14,100,20,14,"Pilot 11","Pilot 11: bigger feedback + video + socially anxious"
10,"SUPPRF13297",12,82,19,18,-1,99,20,1,"Pilot 11","Pilot 11: bigger feedback + video + socially anxious"
11,"SUPPRF13297",6,100,50,-23,-13,89,63,73,"Pilot 11","Pilot 11: bigger feedback + video + socially anxious"
12,"SUPPRF13297",100,0,100,0,20,92,80,100,"Pilot 11","Pilot 11: bigger feedback + video + socially anxious"
13,"SUPPRF13297",81,26,46,21,17,73,29,25,"Pilot 11","Pilot 11: bigger feedback + video + socially anxious"
14,"SUPPRF13297",3,100,16,-30,-13,34,29,46,"Pilot 11","Pilot 11: bigger feedback + video + socially anxious"
15,"SUPPRF13297",19,85,35,32,15,94,20,3,"Pilot 11","Pilot 11: bigger feedback + video + socially anxious"
16,"SUPPRF13297",1,98,58,-24,12,92,46,82,"Pilot 11","Pilot 11: bigger feedback + video + socially anxious"
17,"SUPPRF13297",9,84,45,2,-1,74,46,43,"Pilot 11","Pilot 11: bigger feedback + video + socially anxious"
18,"SUPPRF13297",0,100,55,-21,-16,97,71,76,"Pilot 11","Pilot 11: bigger feedback + video + socially anxious"
19,"SUPPRF13297",18,95,67,-9,-13,92,80,76,"Pilot 11","Pilot 11: bigger feedback + video + socially anxious"
20,"SUPPRF13297",36,81,70,-3,-1,42,71,73,"Pilot 11","Pilot 11: bigger feedback + video + socially anxious"
21,"SUPPRF13297",0,100,15,-44,-14,23,29,59,"Pilot 11","Pilot 11: bigger feedback + video + socially anxious"
22,"SUPPRF13297",0,100,68,-18,-12,99,80,86,"Pilot 11","Pilot 11: bigger feedback + video + socially anxious"
23,"SUPPRF13297",76,49,78,4,24,36,54,74,"Pilot 11","Pilot 11: bigger feedback + video + socially anxious"
24,"SUPPRF13297",15,93,37,8,0,94,37,29,"Pilot 11","Pilot 11: bigger feedback + video + socially anxious"
25,"SUPPRF13297",84,37,62,13,-1,24,63,49,"Pilot 11","Pilot 11: bigger feedback + video + socially anxious"
26,"SUPPRF13297",92,6,94,35,23,72,71,59,"Pilot 11","Pilot 11: bigger feedback + video + socially anxious"
27,"SUPPRF13297",0,100,38,-33,-16,56,54,71,"Pilot 11","Pilot 11: bigger feedback + video + socially anxious"
28,"SUPPRF13297",14,84,29,-29,0,35,29,58,"Pilot 11","Pilot 11: bigger feedback + video + socially anxious"
29,"SUPPRF13297",0,100,22,-33,-15,36,37,55,"Pilot 11","Pilot 11: bigger feedback + video + socially anxious"
30,"SUPPRF13297",34,70,49,15,12,95,37,34,"Pilot 11","Pilot 11: bigger feedback + video + socially anxious"
31,"SUPPRF13297",10,85,28,2,-1,9,29,26,"Pilot 11","Pilot 11: bigger feedback + video + socially anxious"
32,"SUPPRF13297",66,33,63,19,0,32,63,44,"Pilot 11","Pilot 11: bigger feedback + video + socially anxious"
33,"SUPPRF13297",42,47,46,-6,0,23,46,52,"Pilot 11","Pilot 11: bigger feedback + video + socially anxious"
34,"SUPPRF13297",55,35,75,6,29,56,46,69,"Pilot 11","Pilot 11: bigger feedback + video + socially anxious"
35,"SUPPRF13297",0,97,24,-44,-13,39,37,68,"Pilot 11","Pilot 11: bigger feedback + video + socially anxious"
36,"SUPPRF13297",91,21,96,19,16,79,80,77,"Pilot 11","Pilot 11: bigger feedback + video + socially anxious"
37,"SUPPRF13297",85,21,80,15,0,79,80,65,"Pilot 11","Pilot 11: bigger feedback + video + socially anxious"
38,"SUPPRF13297",67,35,58,21,29,90,29,37,"Pilot 11","Pilot 11: bigger feedback + video + socially anxious"
39,"SUPPRF13297",79,33,66,14,12,18,54,52,"Pilot 11","Pilot 11: bigger feedback + video + socially anxious"
40,"SUPPRF13297",49,44,47,-10,-16,25,63,57,"Pilot 11","Pilot 11: bigger feedback + video + socially anxious"
41,"SUPPRF13297",77,26,81,-7,1,97,80,88,"Pilot 11","Pilot 11: bigger feedback + video + socially anxious"
42,"SUPPRF13297",71,6,88,36,25,37,63,52,"Pilot 11","Pilot 11: bigger feedback + video + socially anxious"
43,"SUPPRF13297",63,36,61,2,24,31,37,59,"Pilot 11","Pilot 11: bigger feedback + video + socially anxious"
44,"SUPPRF13297",32,76,38,14,1,8,37,24,"Pilot 11","Pilot 11: bigger feedback + video + socially anxious"
45,"SUPPRF13297",68,28,54,-7,0,16,54,61,"Pilot 11","Pilot 11: bigger feedback + video + socially anxious"
46,"SUPPRF13297",67,40,55,-2,1,25,54,57,"Pilot 11","Pilot 11: bigger feedback + video + socially anxious"
47,"SUPPRF13297",25,91,33,-22,-13,35,46,55,"Pilot 11","Pilot 11: bigger feedback + video + socially anxious"
48,"SUPPRF13297",63,48,71,11,0,18,71,60,"Pilot 11","Pilot 11: bigger feedback + video + socially anxious"
1,"SUPPRF71413",94,5,70,40,-1,13,71,30,"Pilot 11","Pilot 11: bigger feedback + video + socially anxious"
2,"SUPPRF71413",88,5,80,30,0,21,80,50,"Pilot 11","Pilot 11: bigger feedback + video + socially anxious"
3,"SUPPRF71413",100,4,75,45,29,4,46,30,"Pilot 11","Pilot 11: bigger feedback + video + socially anxious"
4,"SUPPRF71413",97,2,77,17,14,37,63,60,"Pilot 11","Pilot 11: bigger feedback + video + socially anxious"
5,"SUPPRF71413",41,4,45,19,-1,79,46,26,"Pilot 11","Pilot 11: bigger feedback + video + socially anxious"
6,"SUPPRF71413",83,87,88,38,25,33,63,50,"Pilot 11","Pilot 11: bigger feedback + video + socially anxious"
7,"SUPPRF71413",18,38,41,-9,-13,54,54,50,"Pilot 11","Pilot 11: bigger feedback + video + socially anxious"
8,"SUPPRF71413",58,10,66,36,12,36,54,30,"Pilot 11","Pilot 11: bigger feedback + video + socially anxious"
9,"SUPPRF71413",43,11,68,38,-12,38,80,30,"Pilot 11","Pilot 11: bigger feedback + video + socially anxious"
10,"SUPPRF71413",87,2,81,29,1,45,80,52,"Pilot 11","Pilot 11: bigger feedback + video + socially anxious"
11,"SUPPRF71413",1,41,19,-39,-1,39,20,58,"Pilot 11","Pilot 11: bigger feedback + video + socially anxious"
12,"SUPPRF71413",11,52,34,7,-12,88,46,27,"Pilot 11","Pilot 11: bigger feedback + video + socially anxious"
13,"SUPPRF71413",3,69,16,2,-13,70,29,14,"Pilot 11","Pilot 11: bigger feedback + video + socially anxious"
14,"SUPPRF71413",97,0,96,39,16,27,80,57,"Pilot 11","Pilot 11: bigger feedback + video + socially anxious"
15,"SUPPRF71413",49,3,67,-15,-13,3,80,82,"Pilot 11","Pilot 11: bigger feedback + video + socially anxious"
16,"SUPPRF71413",46,17,54,5,0,5,54,49,"Pilot 11","Pilot 11: bigger feedback + video + socially anxious"
17,"SUPPRF71413",38,7,56,13,-15,37,71,43,"Pilot 11","Pilot 11: bigger feedback + video + socially anxious"
18,"SUPPRF71413",52,20,58,53,12,31,46,5,"Pilot 11","Pilot 11: bigger feedback + video + socially anxious"
19,"SUPPRF71413",6,56,24,18,-13,26,37,6,"Pilot 11","Pilot 11: bigger feedback + video + socially anxious"
20,"SUPPRF71413",99,1,100,73,20,30,80,27,"Pilot 11","Pilot 11: bigger feedback + video + socially anxious"
21,"SUPPRF71413",54,6,61,41,24,21,37,20,"Pilot 11","Pilot 11: bigger feedback + video + socially anxious"
22,"SUPPRF71413",32,30,28,18,-1,76,29,10,"Pilot 11","Pilot 11: bigger feedback + video + socially anxious"
23,"SUPPRF71413",98,2,94,69,23,27,71,25,"Pilot 11","Pilot 11: bigger feedback + video + socially anxious"
24,"SUPPRF71413",0,1,8,-22,-12,74,20,30,"Pilot 11","Pilot 11: bigger feedback + video + socially anxious"
25,"SUPPRF71413",2,54,38,-7,-16,33,54,45,"Pilot 11","Pilot 11: bigger feedback + video + socially anxious"
26,"SUPPRF71413",37,60,22,-3,-15,37,37,25,"Pilot 11","Pilot 11: bigger feedback + video + socially anxious"
27,"SUPPRF71413",32,30,47,5,-16,43,63,42,"Pilot 11","Pilot 11: bigger feedback + video + socially anxious"
28,"SUPPRF71413",23,37,58,25,29,34,29,33,"Pilot 11","Pilot 11: bigger feedback + video + socially anxious"
29,"SUPPRF71413",79,16,71,28,0,54,71,43,"Pilot 11","Pilot 11: bigger feedback + video + socially anxious"
30,"SUPPRF71413",86,10,83,9,12,67,71,74,"Pilot 11","Pilot 11: bigger feedback + video + socially anxious"
31,"SUPPRF71413",37,25,55,0,1,52,54,55,"Pilot 11","Pilot 11: bigger feedback + video + socially anxious"
32,"SUPPRF71413",37,26,49,0,12,43,37,49,"Pilot 11","Pilot 11: bigger feedback + video + socially anxious"
33,"SUPPRF71413",3,60,6,-2,-14,41,20,8,"Pilot 11","Pilot 11: bigger feedback + video + socially anxious"
34,"SUPPRF71413",99,12,78,50,24,53,54,28,"Pilot 11","Pilot 11: bigger feedback + video + socially anxious"
35,"SUPPRF71413",40,15,55,19,-16,38,71,36,"Pilot 11","Pilot 11: bigger feedback + video + socially anxious"
36,"SUPPRF71413",25,48,37,33,0,78,37,4,"Pilot 11","Pilot 11: bigger feedback + video + socially anxious"
37,"SUPPRF71413",26,31,46,24,17,35,29,22,"Pilot 11","Pilot 11: bigger feedback + video + socially anxious"
38,"SUPPRF71413",53,22,38,11,1,46,37,27,"Pilot 11","Pilot 11: bigger feedback + video + socially anxious"
39,"SUPPRF71413",40,20,46,4,0,44,46,42,"Pilot 11","Pilot 11: bigger feedback + video + socially anxious"
40,"SUPPRF71413",2,4,50,0,-13,50,63,50,"Pilot 11","Pilot 11: bigger feedback + video + socially anxious"
41,"SUPPRF71413",55,43,47,38,27,87,20,9,"Pilot 11","Pilot 11: bigger feedback + video + socially anxious"
42,"SUPPRF71413",34,35,20,5,0,67,20,15,"Pilot 11","Pilot 11: bigger feedback + video + socially anxious"
43,"SUPPRF71413",6,94,29,-11,0,44,29,40,"Pilot 11","Pilot 11: bigger feedback + video + socially anxious"
44,"SUPPRF71413",4,32,15,4,-14,44,29,11,"Pilot 11","Pilot 11: bigger feedback + video + socially anxious"
45,"SUPPRF71413",33,27,62,-4,-1,74,63,66,"Pilot 11","Pilot 11: bigger feedback + video + socially anxious"
46,"SUPPRF71413",19,35,35,22,15,68,20,13,"Pilot 11","Pilot 11: bigger feedback + video + socially anxious"
47,"SUPPRF71413",25,40,33,-2,-13,57,46,35,"Pilot 11","Pilot 11: bigger feedback + video + socially anxious"
48,"SUPPRF71413",44,46,63,19,0,56,63,44,"Pilot 11","Pilot 11: bigger feedback + video + socially anxious"
1,"SUPPRF54929",59,57,35,1,15,82,20,34,"Pilot 11","Pilot 11: bigger feedback + video + socially anxious"
2,"SUPPRF54929",22,26,6,-34,-14,75,20,40,"Pilot 11","Pilot 11: bigger feedback + video + socially anxious"
3,"SUPPRF54929",32,68,61,26,24,71,37,35,"Pilot 11","Pilot 11: bigger feedback + video + socially anxious"
4,"SUPPRF54929",69,62,78,28,24,65,54,50,"Pilot 11","Pilot 11: bigger feedback + video + socially anxious"
5,"SUPPRF54929",82,27,83,1,12,89,71,82,"Pilot 11","Pilot 11: bigger feedback + video + socially anxious"
6,"SUPPRF54929",57,67,20,6,0,19,20,14,"Pilot 11","Pilot 11: bigger feedback + video + socially anxious"
7,"SUPPRF54929",19,27,16,-6,-13,38,29,22,"Pilot 11","Pilot 11: bigger feedback + video + socially anxious"
8,"SUPPRF54929",66,30,71,9,0,65,71,62,"Pilot 11","Pilot 11: bigger feedback + video + socially anxious"
9,"SUPPRF54929",57,23,22,-3,-15,70,37,25,"Pilot 11","Pilot 11: bigger feedback + video + socially anxious"
10,"SUPPRF54929",58,18,49,33,12,21,37,16,"Pilot 11","Pilot 11: bigger feedback + video + socially anxious"
11,"SUPPRF54929",22,33,56,-10,-15,87,71,66,"Pilot 11","Pilot 11: bigger feedback + video + socially anxious"
12,"SUPPRF54929",32,18,38,-17,-16,34,54,55,"Pilot 11","Pilot 11: bigger feedback + video + socially anxious"
13,"SUPPRF54929",89,19,24,-1,-13,34,37,25,"Pilot 11","Pilot 11: bigger feedback + video + socially anxious"
14,"SUPPRF54929",22,12,77,35,14,7,63,42,"Pilot 11","Pilot 11: bigger feedback + video + socially anxious"
15,"SUPPRF54929",74,17,66,24,12,29,54,42,"Pilot 11","Pilot 11: bigger feedback + video + socially anxious"
16,"SUPPRF54929",73,15,94,24,23,19,71,70,"Pilot 11","Pilot 11: bigger feedback + video + socially anxious"
17,"SUPPRF54929",62,20,55,15,1,80,54,40,"Pilot 11","Pilot 11: bigger feedback + video + socially anxious"
18,"SUPPRF54929",17,30,8,-8,-12,16,20,16,"Pilot 11","Pilot 11: bigger feedback + video + socially anxious"
19,"SUPPRF54929",34,26,33,-7,-13,68,46,40,"Pilot 11","Pilot 11: bigger feedback + video + socially anxious"
20,"SUPPRF54929",95,23,100,18,20,92,80,82,"Pilot 11","Pilot 11: bigger feedback + video + socially anxious"
21,"SUPPRF54929",37,33,67,-14,-13,26,80,81,"Pilot 11","Pilot 11: bigger feedback + video + socially anxious"
22,"SUPPRF54929",72,25,45,10,-1,59,46,35,"Pilot 11","Pilot 11: bigger feedback + video + socially anxious"
23,"SUPPRF54929",70,28,29,-6,0,72,29,35,"Pilot 11","Pilot 11: bigger feedback + video + socially anxious"
24,"SUPPRF54929",90,17,28,-2,-1,84,29,30,"Pilot 11","Pilot 11: bigger feedback + video + socially anxious"
25,"SUPPRF54929",90,19,37,-3,0,82,37,40,"Pilot 11","Pilot 11: bigger feedback + video + socially anxious"
26,"SUPPRF54929",69,13,34,-11,-12,80,46,45,"Pilot 11","Pilot 11: bigger feedback + video + socially anxious"
27,"SUPPRF54929",39,27,15,-18,-14,83,29,33,"Pilot 11","Pilot 11: bigger feedback + video + socially anxious"
28,"SUPPRF54929",64,16,46,26,0,48,46,20,"Pilot 11","Pilot 11: bigger feedback + video + socially anxious"
29,"SUPPRF54929",75,12,62,7,-1,84,63,55,"Pilot 11","Pilot 11: bigger feedback + video + socially anxious"
30,"SUPPRF54929",47,32,80,-16,0,87,80,96,"Pilot 11","Pilot 11: bigger feedback + video + socially anxious"
31,"SUPPRF54929",54,20,47,30,27,83,20,17,"Pilot 11","Pilot 11: bigger feedback + video + socially anxious"
32,"SUPPRF54929",78,11,68,-2,-12,35,80,70,"Pilot 11","Pilot 11: bigger feedback + video + socially anxious"
33,"SUPPRF54929",92,4,70,-3,-1,88,71,73,"Pilot 11","Pilot 11: bigger feedback + video + socially anxious"
34,"SUPPRF54929",80,18,54,9,0,24,54,45,"Pilot 11","Pilot 11: bigger feedback + video + socially anxious"
35,"SUPPRF54929",94,9,81,1,1,70,80,80,"Pilot 11","Pilot 11: bigger feedback + video + socially anxious"
36,"SUPPRF54929",59,33,55,-15,-16,28,71,70,"Pilot 11","Pilot 11: bigger feedback + video + socially anxious"
37,"SUPPRF54929",70,17,46,15,17,20,29,31,"Pilot 11","Pilot 11: bigger feedback + video + socially anxious"
38,"SUPPRF54929",72,75,88,54,25,67,63,34,"Pilot 11","Pilot 11: bigger feedback + video + socially anxious"
39,"SUPPRF54929",53,73,58,38,29,68,29,20,"Pilot 11","Pilot 11: bigger feedback + video + socially anxious"
40,"SUPPRF54929",67,25,50,-15,-13,67,63,65,"Pilot 11","Pilot 11: bigger feedback + video + socially anxious"
41,"SUPPRF54929",74,16,58,3,12,66,46,55,"Pilot 11","Pilot 11: bigger feedback + video + socially anxious"
42,"SUPPRF54929",66,17,63,14,0,68,63,49,"Pilot 11","Pilot 11: bigger feedback + video + socially anxious"
43,"SUPPRF54929",24,80,41,14,-13,20,54,27,"Pilot 11","Pilot 11: bigger feedback + video + socially anxious"
44,"SUPPRF54929",27,72,47,-8,-16,58,63,55,"Pilot 11","Pilot 11: bigger feedback + video + socially anxious"
45,"SUPPRF54929",72,68,19,0,-1,76,20,19,"Pilot 11","Pilot 11: bigger feedback + video + socially anxious"
46,"SUPPRF54929",28,81,75,33,29,67,46,42,"Pilot 11","Pilot 11: bigger feedback + video + socially anxious"
47,"SUPPRF54929",75,18,96,23,16,83,80,73,"Pilot 11","Pilot 11: bigger feedback + video + socially anxious"
48,"SUPPRF54929",40,61,38,-7,1,67,37,45,"Pilot 11","Pilot 11: bigger feedback + video + socially anxious"
1,"SUPPRF74387",31,76,58,29,29,82,29,29,"Pilot 11","Pilot 11: bigger feedback + video + socially anxious"
2,"SUPPRF74387",43,52,75,35,29,76,46,40,"Pilot 11","Pilot 11: bigger feedback + video + socially anxious"
3,"SUPPRF74387",58,42,55,4,1,81,54,51,"Pilot 11","Pilot 11: bigger feedback + video + socially anxious"
4,"SUPPRF74387",63,39,88,19,25,92,63,69,"Pilot 11","Pilot 11: bigger feedback + video + socially anxious"
5,"SUPPRF74387",77,36,83,1,12,79,71,82,"Pilot 11","Pilot 11: bigger feedback + video + socially anxious"
6,"SUPPRF74387",9,77,15,-53,-14,59,29,68,"Pilot 11","Pilot 11: bigger feedback + video + socially anxious"
7,"SUPPRF74387",75,44,50,-24,-13,74,63,74,"Pilot 11","Pilot 11: bigger feedback + video + socially anxious"
8,"SUPPRF74387",95,9,100,52,20,30,80,48,"Pilot 11","Pilot 11: bigger feedback + video + socially anxious"
9,"SUPPRF74387",53,33,54,-21,0,82,54,75,"Pilot 11","Pilot 11: bigger feedback + video + socially anxious"
10,"SUPPRF74387",27,64,22,-43,-15,36,37,65,"Pilot 11","Pilot 11: bigger feedback + video + socially anxious"
11,"SUPPRF74387",57,36,37,6,0,64,37,31,"Pilot 11","Pilot 11: bigger feedback + video + socially anxious"
12,"SUPPRF74387",84,23,49,16,12,75,37,33,"Pilot 11","Pilot 11: bigger feedback + video + socially anxious"
13,"SUPPRF74387",92,18,78,7,24,58,54,71,"Pilot 11","Pilot 11: bigger feedback + video + socially anxious"
14,"SUPPRF74387",94,2,63,0,0,69,63,63,"Pilot 11","Pilot 11: bigger feedback + video + socially anxious"
15,"SUPPRF74387",14,75,6,-15,-14,86,20,21,"Pilot 11","Pilot 11: bigger feedback + video + socially anxious"
16,"SUPPRF74387",82,8,81,51,1,76,80,30,"Pilot 11","Pilot 11: bigger feedback + video + socially anxious"
17,"SUPPRF74387",85,29,46,-3,17,32,29,49,"Pilot 11","Pilot 11: bigger feedback + video + socially anxious"
18,"SUPPRF74387",83,27,38,-17,1,72,37,55,"Pilot 11","Pilot 11: bigger feedback + video + socially anxious"
19,"SUPPRF74387",39,32,41,-25,-13,77,54,66,"Pilot 11","Pilot 11: bigger feedback + video + socially anxious"
20,"SUPPRF74387",64,13,35,17,15,85,20,18,"Pilot 11","Pilot 11: bigger feedback + video + socially anxious"
21,"SUPPRF74387",82,24,28,-1,-1,70,29,29,"Pilot 11","Pilot 11: bigger feedback + video + socially anxious"
22,"SUPPRF74387",83,24,47,-2,-16,59,63,49,"Pilot 11","Pilot 11: bigger feedback + video + socially anxious"
23,"SUPPRF74387",83,14,80,-11,0,81,80,91,"Pilot 11","Pilot 11: bigger feedback + video + socially anxious"
24,"SUPPRF74387",95,12,47,33,27,92,20,14,"Pilot 11","Pilot 11: bigger feedback + video + socially anxious"
25,"SUPPRF74387",89,17,29,1,0,85,29,28,"Pilot 11","Pilot 11: bigger feedback + video + socially anxious"
26,"SUPPRF74387",91,11,46,10,0,68,46,36,"Pilot 11","Pilot 11: bigger feedback + video + socially anxious"
27,"SUPPRF74387",31,65,55,-34,-16,91,71,89,"Pilot 11","Pilot 11: bigger feedback + video + socially anxious"
28,"SUPPRF74387",68,28,67,7,-13,69,80,60,"Pilot 11","Pilot 11: bigger feedback + video + socially anxious"
29,"SUPPRF74387",14,64,33,-46,-13,72,46,79,"Pilot 11","Pilot 11: bigger feedback + video + socially anxious"
30,"SUPPRF74387",33,65,56,-11,-15,83,71,67,"Pilot 11","Pilot 11: bigger feedback + video + socially anxious"
31,"SUPPRF74387",13,70,24,-16,-13,72,37,40,"Pilot 11","Pilot 11: bigger feedback + video + socially anxious"
32,"SUPPRF74387",12,80,16,-32,-13,58,29,48,"Pilot 11","Pilot 11: bigger feedback + video + socially anxious"
33,"SUPPRF74387",73,26,8,-1,-12,77,20,9,"Pilot 11","Pilot 11: bigger feedback + video + socially anxious"
34,"SUPPRF74387",92,4,94,21,23,69,71,73,"Pilot 11","Pilot 11: bigger feedback + video + socially anxious"
35,"SUPPRF74387",75,22,58,-4,12,56,46,62,"Pilot 11","Pilot 11: bigger feedback + video + socially anxious"
36,"SUPPRF74387",84,13,20,0,0,78,20,20,"Pilot 11","Pilot 11: bigger feedback + video + socially anxious"
37,"SUPPRF74387",15,77,38,-25,-16,28,54,63,"Pilot 11","Pilot 11: bigger feedback + video + socially anxious"
38,"SUPPRF74387",84,31,96,36,16,75,80,60,"Pilot 11","Pilot 11: bigger feedback + video + socially anxious"
39,"SUPPRF74387",95,11,77,43,14,61,63,34,"Pilot 11","Pilot 11: bigger feedback + video + socially anxious"
40,"SUPPRF74387",94,8,66,-2,12,76,54,68,"Pilot 11","Pilot 11: bigger feedback + video + socially anxious"
41,"SUPPRF74387",91,12,34,1,-12,64,46,33,"Pilot 11","Pilot 11: bigger feedback + video + socially anxious"
42,"SUPPRF74387",89,10,19,9,-1,81,20,10,"Pilot 11","Pilot 11: bigger feedback + video + socially anxious"
43,"SUPPRF74387",87,3,68,4,-12,84,80,64,"Pilot 11","Pilot 11: bigger feedback + video + socially anxious"
44,"SUPPRF74387",95,10,45,29,-1,74,46,16,"Pilot 11","Pilot 11: bigger feedback + video + socially anxious"
45,"SUPPRF74387",86,12,62,22,-1,75,63,40,"Pilot 11","Pilot 11: bigger feedback + video + socially anxious"
46,"SUPPRF74387",98,2,70,15,-1,79,71,55,"Pilot 11","Pilot 11: bigger feedback + video + socially anxious"
47,"SUPPRF74387",91,16,71,1,0,73,71,70,"Pilot 11","Pilot 11: bigger feedback + video + socially anxious"
48,"SUPPRF74387",88,12,61,25,24,72,37,36,"Pilot 11","Pilot 11: bigger feedback + video + socially anxious"
1,"SUPPRF03254",50,30,47,4,-16,21,63,43,"Pilot 11","Pilot 11: bigger feedback + video + socially anxious"
2,"SUPPRF03254",57,29,94,26,23,39,71,68,"Pilot 11","Pilot 11: bigger feedback + video + socially anxious"
3,"SUPPRF03254",57,26,29,-24,0,36,29,53,"Pilot 11","Pilot 11: bigger feedback + video + socially anxious"
4,"SUPPRF03254",60,33,34,-9,-12,45,46,43,"Pilot 11","Pilot 11: bigger feedback + video + socially anxious"
5,"SUPPRF03254",65,41,46,16,0,45,46,30,"Pilot 11","Pilot 11: bigger feedback + video + socially anxious"
6,"SUPPRF03254",61,34,83,16,12,57,71,67,"Pilot 11","Pilot 11: bigger feedback + video + socially anxious"
7,"SUPPRF03254",64,27,62,18,-1,29,63,44,"Pilot 11","Pilot 11: bigger feedback + video + socially anxious"
8,"SUPPRF03254",61,34,37,3,0,31,37,34,"Pilot 11","Pilot 11: bigger feedback + video + socially anxious"
9,"SUPPRF03254",70,28,68,17,-12,31,80,51,"Pilot 11","Pilot 11: bigger feedback + video + socially anxious"
10,"SUPPRF03254",62,32,61,21,24,29,37,40,"Pilot 11","Pilot 11: bigger feedback + video + socially anxious"
11,"SUPPRF03254",58,21,63,9,0,27,63,54,"Pilot 11","Pilot 11: bigger feedback + video + socially anxious"
12,"SUPPRF03254",42,23,33,-13,-13,25,46,46,"Pilot 11","Pilot 11: bigger feedback + video + socially anxious"
13,"SUPPRF03254",65,27,19,9,-1,66,20,10,"Pilot 11","Pilot 11: bigger feedback + video + socially anxious"
14,"SUPPRF03254",52,31,46,2,17,28,29,44,"Pilot 11","Pilot 11: bigger feedback + video + socially anxious"
15,"SUPPRF03254",68,19,55,24,-16,40,71,31,"Pilot 11","Pilot 11: bigger feedback + video + socially anxious"
16,"SUPPRF03254",67,32,100,38,20,45,80,62,"Pilot 11","Pilot 11: bigger feedback + video + socially anxious"
17,"SUPPRF03254",58,39,38,-18,-16,35,54,56,"Pilot 11","Pilot 11: bigger feedback + video + socially anxious"
18,"SUPPRF03254",79,21,56,-15,-15,14,71,71,"Pilot 11","Pilot 11: bigger feedback + video + socially anxious"
19,"SUPPRF03254",76,21,78,41,24,54,54,37,"Pilot 11","Pilot 11: bigger feedback + video + socially anxious"
20,"SUPPRF03254",60,26,45,1,-1,53,46,44,"Pilot 11","Pilot 11: bigger feedback + video + socially anxious"
21,"SUPPRF03254",64,22,49,10,12,45,37,39,"Pilot 11","Pilot 11: bigger feedback + video + socially anxious"
22,"SUPPRF03254",64,26,81,33,1,18,80,48,"Pilot 11","Pilot 11: bigger feedback + video + socially anxious"
23,"SUPPRF03254",75,26,54,-13,0,30,54,67,"Pilot 11","Pilot 11: bigger feedback + video + socially anxious"
24,"SUPPRF03254",69,20,38,-21,1,33,37,59,"Pilot 11","Pilot 11: bigger feedback + video + socially anxious"
25,"SUPPRF03254",75,12,67,16,-13,8,80,51,"Pilot 11","Pilot 11: bigger feedback + video + socially anxious"
26,"SUPPRF03254",77,15,80,5,0,30,80,75,"Pilot 11","Pilot 11: bigger feedback + video + socially anxious"
27,"SUPPRF03254",78,19,71,6,0,18,71,65,"Pilot 11","Pilot 11: bigger feedback + video + socially anxious"
28,"SUPPRF03254",69,29,35,4,15,11,20,31,"Pilot 11","Pilot 11: bigger feedback + video + socially anxious"
29,"SUPPRF03254",72,25,58,28,29,27,29,30,"Pilot 11","Pilot 11: bigger feedback + video + socially anxious"
30,"SUPPRF03254",69,24,66,5,12,31,54,61,"Pilot 11","Pilot 11: bigger feedback + video + socially anxious"
31,"SUPPRF03254",79,31,88,27,25,24,63,61,"Pilot 11","Pilot 11: bigger feedback + video + socially anxious"
32,"SUPPRF03254",74,23,77,32,14,25,63,45,"Pilot 11","Pilot 11: bigger feedback + video + socially anxious"
33,"SUPPRF03254",78,21,6,-36,-14,23,20,42,"Pilot 11","Pilot 11: bigger feedback + video + socially anxious"
34,"SUPPRF03254",62,22,41,-13,-13,17,54,54,"Pilot 11","Pilot 11: bigger feedback + video + socially anxious"
35,"SUPPRF03254",73,32,47,36,27,58,20,11,"Pilot 11","Pilot 11: bigger feedback + video + socially anxious"
36,"SUPPRF03254",74,21,75,24,29,51,46,51,"Pilot 11","Pilot 11: bigger feedback + video + socially anxious"
37,"SUPPRF03254",71,20,55,6,1,28,54,49,"Pilot 11","Pilot 11: bigger feedback + video + socially anxious"
38,"SUPPRF03254",68,12,15,-40,-14,21,29,55,"Pilot 11","Pilot 11: bigger feedback + video + socially anxious"
39,"SUPPRF03254",58,38,24,2,-13,32,37,22,"Pilot 11","Pilot 11: bigger feedback + video + socially anxious"
40,"SUPPRF03254",54,28,20,-3,0,22,20,23,"Pilot 11","Pilot 11: bigger feedback + video + socially anxious"
41,"SUPPRF03254",65,19,58,43,12,30,46,15,"Pilot 11","Pilot 11: bigger feedback + video + socially anxious"
42,"SUPPRF03254",72,22,28,-31,-1,41,29,59,"Pilot 11","Pilot 11: bigger feedback + video + socially anxious"
43,"SUPPRF03254",49,21,16,-34,-13,25,29,50,"Pilot 11","Pilot 11: bigger feedback + video + socially anxious"
44,"SUPPRF03254",57,31,22,-13,-15,23,37,35,"Pilot 11","Pilot 11: bigger feedback + video + socially anxious"
45,"SUPPRF03254",68,19,70,-2,-1,14,71,72,"Pilot 11","Pilot 11: bigger feedback + video + socially anxious"
46,"SUPPRF03254",43,35,8,-29,-12,25,20,37,"Pilot 11","Pilot 11: bigger feedback + video + socially anxious"
47,"SUPPRF03254",67,23,50,4,-13,30,63,46,"Pilot 11","Pilot 11: bigger feedback + video + socially anxious"
48,"SUPPRF03254",69,32,96,53,16,25,80,43,"Pilot 11","Pilot 11: bigger feedback + video + socially anxious"
1,"SUPPRF95208",93,7,28,-46,-1,22,29,74,"Pilot 11","Pilot 11: bigger feedback + video + socially anxious"
2,"SUPPRF95208",90,9,94,21,23,18,71,73,"Pilot 11","Pilot 11: bigger feedback + video + socially anxious"
3,"SUPPRF95208",95,3,41,-24,-13,4,54,65,"Pilot 11","Pilot 11: bigger feedback + video + socially anxious"
4,"SUPPRF95208",98,1,67,-10,-13,10,80,77,"Pilot 11","Pilot 11: bigger feedback + video + socially anxious"
5,"SUPPRF95208",97,3,71,1,0,3,71,70,"Pilot 11","Pilot 11: bigger feedback + video + socially anxious"
6,"SUPPRF95208",95,6,47,22,27,9,20,25,"Pilot 11","Pilot 11: bigger feedback + video + socially anxious"
7,"SUPPRF95208",92,5,38,-16,1,33,37,54,"Pilot 11","Pilot 11: bigger feedback + video + socially anxious"
8,"SUPPRF95208",95,5,96,7,16,20,80,89,"Pilot 11","Pilot 11: bigger feedback + video + socially anxious"
9,"SUPPRF95208",94,5,58,21,29,31,29,37,"Pilot 11","Pilot 11: bigger feedback + video + socially anxious"
10,"SUPPRF95208",97,5,77,22,14,24,63,55,"Pilot 11","Pilot 11: bigger feedback + video + socially anxious"
11,"SUPPRF95208",97,3,8,-32,-12,15,20,40,"Pilot 11","Pilot 11: bigger feedback + video + socially anxious"
12,"SUPPRF95208",95,5,83,11,12,18,71,72,"Pilot 11","Pilot 11: bigger feedback + video + socially anxious"
13,"SUPPRF95208",98,3,56,-20,-15,74,71,76,"Pilot 11","Pilot 11: bigger feedback + video + socially anxious"
14,"SUPPRF95208",98,2,62,4,-1,20,63,58,"Pilot 11","Pilot 11: bigger feedback + video + socially anxious"
15,"SUPPRF95208",99,1,46,14,17,5,29,32,"Pilot 11","Pilot 11: bigger feedback + video + socially anxious"
16,"SUPPRF95208",99,2,68,-21,-12,55,80,89,"Pilot 11","Pilot 11: bigger feedback + video + socially anxious"
17,"SUPPRF95208",95,1,33,-12,-13,68,46,45,"Pilot 11","Pilot 11: bigger feedback + video + socially anxious"
18,"SUPPRF95208",98,2,47,-4,-16,67,63,51,"Pilot 11","Pilot 11: bigger feedback + video + socially anxious"
19,"SUPPRF95208",97,3,58,5,12,79,46,53,"Pilot 11","Pilot 11: bigger feedback + video + socially anxious"
20,"SUPPRF95208",94,4,20,-2,0,83,20,22,"Pilot 11","Pilot 11: bigger feedback + video + socially anxious"
21,"SUPPRF95208",94,4,80,-6,0,74,80,86,"Pilot 11","Pilot 11: bigger feedback + video + socially anxious"
22,"SUPPRF95208",98,4,49,-2,12,73,37,51,"Pilot 11","Pilot 11: bigger feedback + video + socially anxious"
23,"SUPPRF95208",97,2,100,17,20,75,80,83,"Pilot 11","Pilot 11: bigger feedback + video + socially anxious"
24,"SUPPRF95208",97,2,55,-25,-16,57,71,80,"Pilot 11","Pilot 11: bigger feedback + video + socially anxious"
25,"SUPPRF95208",94,3,50,-5,-13,71,63,55,"Pilot 11","Pilot 11: bigger feedback + video + socially anxious"
26,"SUPPRF95208",95,3,24,-20,-13,90,37,44,"Pilot 11","Pilot 11: bigger feedback + video + socially anxious"
27,"SUPPRF95208",93,3,88,22,25,76,63,66,"Pilot 11","Pilot 11: bigger feedback + video + socially anxious"
28,"SUPPRF95208",96,4,22,-27,-15,47,37,49,"Pilot 11","Pilot 11: bigger feedback + video + socially anxious"
29,"SUPPRF95208",96,2,55,0,1,71,54,55,"Pilot 11","Pilot 11: bigger feedback + video + socially anxious"
30,"SUPPRF95208",97,3,34,-22,-12,57,46,56,"Pilot 11","Pilot 11: bigger feedback + video + socially anxious"
31,"SUPPRF95208",99,2,19,-38,-1,14,20,57,"Pilot 11","Pilot 11: bigger feedback + video + socially anxious"
32,"SUPPRF95208",98,1,70,-1,-1,64,71,71,"Pilot 11","Pilot 11: bigger feedback + video + socially anxious"
33,"SUPPRF95208",96,5,6,-16,-14,73,20,22,"Pilot 11","Pilot 11: bigger feedback + video + socially anxious"
34,"SUPPRF95208",99,4,16,-1,-13,18,29,17,"Pilot 11","Pilot 11: bigger feedback + video + socially anxious"
35,"SUPPRF95208",99,1,81,47,1,51,80,34,"Pilot 11","Pilot 11: bigger feedback + video + socially anxious"
36,"SUPPRF95208",97,6,29,15,0,94,29,14,"Pilot 11","Pilot 11: bigger feedback + video + socially anxious"
37,"SUPPRF95208",99,2,54,-3,0,8,54,57,"Pilot 11","Pilot 11: bigger feedback + video + socially anxious"
38,"SUPPRF95208",97,6,61,19,24,69,37,42,"Pilot 11","Pilot 11: bigger feedback + video + socially anxious"
39,"SUPPRF95208",99,5,35,18,15,91,20,17,"Pilot 11","Pilot 11: bigger feedback + video + socially anxious"
40,"SUPPRF95208",99,3,46,-8,0,66,46,54,"Pilot 11","Pilot 11: bigger feedback + video + socially anxious"
41,"SUPPRF95208",97,5,66,10,12,63,54,56,"Pilot 11","Pilot 11: bigger feedback + video + socially anxious"
42,"SUPPRF95208",97,1,75,17,29,71,46,58,"Pilot 11","Pilot 11: bigger feedback + video + socially anxious"
43,"SUPPRF95208",97,2,15,-8,-14,59,29,23,"Pilot 11","Pilot 11: bigger feedback + video + socially anxious"
44,"SUPPRF95208",98,0,38,-14,-16,64,54,52,"Pilot 11","Pilot 11: bigger feedback + video + socially anxious"
45,"SUPPRF95208",97,4,37,5,0,83,37,32,"Pilot 11","Pilot 11: bigger feedback + video + socially anxious"
46,"SUPPRF95208",96,2,45,-10,-1,85,46,55,"Pilot 11","Pilot 11: bigger feedback + video + socially anxious"
47,"SUPPRF95208",97,2,78,25,24,90,54,53,"Pilot 11","Pilot 11: bigger feedback + video + socially anxious"
48,"SUPPRF95208",96,3,63,13,0,75,63,50,"Pilot 11","Pilot 11: bigger feedback + video + socially anxious"
1,"SUPPRF98797",37,70,6,-23,-14,41,20,29,"Pilot 11","Pilot 11: bigger feedback + video + socially anxious"
2,"SUPPRF98797",37,62,88,50,25,25,63,38,"Pilot 11","Pilot 11: bigger feedback + video + socially anxious"
3,"SUPPRF98797",47,48,71,6,0,65,71,65,"Pilot 11","Pilot 11: bigger feedback + video + socially anxious"
4,"SUPPRF98797",46,51,49,24,12,50,37,25,"Pilot 11","Pilot 11: bigger feedback + video + socially anxious"
5,"SUPPRF98797",46,45,78,24,24,62,54,54,"Pilot 11","Pilot 11: bigger feedback + video + socially anxious"
6,"SUPPRF98797",44,48,35,13,15,48,20,22,"Pilot 11","Pilot 11: bigger feedback + video + socially anxious"
7,"SUPPRF98797",50,50,75,41,29,49,46,34,"Pilot 11","Pilot 11: bigger feedback + video + socially anxious"
8,"SUPPRF98797",48,48,50,8,-13,37,63,42,"Pilot 11","Pilot 11: bigger feedback + video + socially anxious"
9,"SUPPRF98797",46,48,29,-14,0,44,29,43,"Pilot 11","Pilot 11: bigger feedback + video + socially anxious"
10,"SUPPRF98797",46,50,16,-18,-13,49,29,34,"Pilot 11","Pilot 11: bigger feedback + video + socially anxious"
11,"SUPPRF98797",46,49,77,21,14,51,63,56,"Pilot 11","Pilot 11: bigger feedback + video + socially anxious"
12,"SUPPRF98797",47,47,94,32,23,47,71,62,"Pilot 11","Pilot 11: bigger feedback + video + socially anxious"
13,"SUPPRF98797",48,48,41,-5,-13,33,54,46,"Pilot 11","Pilot 11: bigger feedback + video + socially anxious"
14,"SUPPRF98797",48,45,63,16,0,55,63,47,"Pilot 11","Pilot 11: bigger feedback + video + socially anxious"
15,"SUPPRF98797",47,45,22,-6,-15,33,37,28,"Pilot 11","Pilot 11: bigger feedback + video + socially anxious"
16,"SUPPRF98797",49,50,96,32,16,45,80,64,"Pilot 11","Pilot 11: bigger feedback + video + socially anxious"
17,"SUPPRF98797",47,51,19,2,-1,41,20,17,"Pilot 11","Pilot 11: bigger feedback + video + socially anxious"
18,"SUPPRF98797",46,47,81,17,1,58,80,64,"Pilot 11","Pilot 11: bigger feedback + video + socially anxious"
19,"SUPPRF98797",39,43,83,14,12,55,71,69,"Pilot 11","Pilot 11: bigger feedback + video + socially anxious"
20,"SUPPRF98797",35,37,15,-5,-14,54,29,20,"Pilot 11","Pilot 11: bigger feedback + video + socially anxious"
21,"SUPPRF98797",39,27,46,15,17,37,29,31,"Pilot 11","Pilot 11: bigger feedback + video + socially anxious"
22,"SUPPRF98797",35,28,38,-21,-16,31,54,59,"Pilot 11","Pilot 11: bigger feedback + video + socially anxious"
23,"SUPPRF98797",32,25,66,20,12,39,54,46,"Pilot 11","Pilot 11: bigger feedback + video + socially anxious"
24,"SUPPRF98797",42,26,47,1,-16,28,63,46,"Pilot 11","Pilot 11: bigger feedback + video + socially anxious"
25,"SUPPRF98797",48,24,58,21,12,46,46,37,"Pilot 11","Pilot 11: bigger feedback + video + socially anxious"
26,"SUPPRF98797",50,27,55,14,1,50,54,41,"Pilot 11","Pilot 11: bigger feedback + video + socially anxious"
27,"SUPPRF98797",46,25,56,-10,-15,44,71,66,"Pilot 11","Pilot 11: bigger feedback + video + socially anxious"
28,"SUPPRF98797",36,24,58,30,29,52,29,28,"Pilot 11","Pilot 11: bigger feedback + video + socially anxious"
29,"SUPPRF98797",42,24,46,6,0,59,46,40,"Pilot 11","Pilot 11: bigger feedback + video + socially anxious"
30,"SUPPRF98797",41,27,54,12,0,45,54,42,"Pilot 11","Pilot 11: bigger feedback + video + socially anxious"
31,"SUPPRF98797",36,24,47,24,27,59,20,23,"Pilot 11","Pilot 11: bigger feedback + video + socially anxious"
32,"SUPPRF98797",39,24,61,37,24,58,37,24,"Pilot 11","Pilot 11: bigger feedback + video + socially anxious"
33,"SUPPRF98797",36,20,20,-2,0,69,20,22,"Pilot 11","Pilot 11: bigger feedback + video + socially anxious"
34,"SUPPRF98797",30,24,37,14,0,63,37,23,"Pilot 11","Pilot 11: bigger feedback + video + socially anxious"
35,"SUPPRF98797",35,22,45,14,-1,55,46,31,"Pilot 11","Pilot 11: bigger feedback + video + socially anxious"
36,"SUPPRF98797",37,20,8,-12,-12,64,20,20,"Pilot 11","Pilot 11: bigger feedback + video + socially anxious"
37,"SUPPRF98797",23,25,67,1,-13,57,80,66,"Pilot 11","Pilot 11: bigger feedback + video + socially anxious"
38,"SUPPRF98797",30,20,24,-6,-13,26,37,30,"Pilot 11","Pilot 11: bigger feedback + video + socially anxious"
39,"SUPPRF98797",29,44,100,34,20,68,80,66,"Pilot 11","Pilot 11: bigger feedback + video + socially anxious"
40,"SUPPRF98797",36,37,38,11,1,66,37,27,"Pilot 11","Pilot 11: bigger feedback + video + socially anxious"
41,"SUPPRF98797",33,44,55,-7,-16,40,71,62,"Pilot 11","Pilot 11: bigger feedback + video + socially anxious"
42,"SUPPRF98797",39,45,80,22,0,41,80,58,"Pilot 11","Pilot 11: bigger feedback + video + socially anxious"
43,"SUPPRF98797",36,53,62,19,-1,57,63,43,"Pilot 11","Pilot 11: bigger feedback + video + socially anxious"
44,"SUPPRF98797",39,56,34,5,-12,25,46,29,"Pilot 11","Pilot 11: bigger feedback + video + socially anxious"
45,"SUPPRF98797",34,59,28,-1,-1,58,29,29,"Pilot 11","Pilot 11: bigger feedback + video + socially anxious"
46,"SUPPRF98797",36,49,68,5,-12,59,80,63,"Pilot 11","Pilot 11: bigger feedback + video + socially anxious"
47,"SUPPRF98797",34,64,70,17,-1,50,71,53,"Pilot 11","Pilot 11: bigger feedback + video + socially anxious"
48,"SUPPRF98797",67,49,33,0,-13,48,46,33,"Pilot 11","Pilot 11: bigger feedback + video + socially anxious"
1,"SUPPRF06127",91,9,81,-11,1,80,80,92,"Pilot 11","Pilot 11: bigger feedback + video + socially anxious"
2,"SUPPRF06127",81,10,15,-10,-14,81,29,25,"Pilot 11","Pilot 11: bigger feedback + video + socially anxious"
3,"SUPPRF06127",84,10,41,-29,-13,72,54,70,"Pilot 11","Pilot 11: bigger feedback + video + socially anxious"
4,"SUPPRF06127",92,8,34,1,-12,72,46,33,"Pilot 11","Pilot 11: bigger feedback + video + socially anxious"
5,"SUPPRF06127",93,8,38,5,1,81,37,33,"Pilot 11","Pilot 11: bigger feedback + video + socially anxious"
6,"SUPPRF06127",89,8,71,-2,0,71,71,73,"Pilot 11","Pilot 11: bigger feedback + video + socially anxious"
7,"SUPPRF06127",92,7,80,-5,0,74,80,85,"Pilot 11","Pilot 11: bigger feedback + video + socially anxious"
8,"SUPPRF06127",91,11,50,21,-13,53,63,29,"Pilot 11","Pilot 11: bigger feedback + video + socially anxious"
9,"SUPPRF06127",91,6,70,3,-1,46,71,67,"Pilot 11","Pilot 11: bigger feedback + video + socially anxious"
10,"SUPPRF06127",89,8,38,-29,-16,48,54,67,"Pilot 11","Pilot 11: bigger feedback + video + socially anxious"
11,"SUPPRF06127",93,4,83,40,12,50,71,43,"Pilot 11","Pilot 11: bigger feedback + video + socially anxious"
12,"SUPPRF06127",92,6,66,40,12,21,54,26,"Pilot 11","Pilot 11: bigger feedback + video + socially anxious"
13,"SUPPRF06127",95,5,37,5,0,42,37,32,"Pilot 11","Pilot 11: bigger feedback + video + socially anxious"
14,"SUPPRF06127",93,4,47,-13,-16,48,63,60,"Pilot 11","Pilot 11: bigger feedback + video + socially anxious"
15,"SUPPRF06127",91,4,16,-39,-13,77,29,55,"Pilot 11","Pilot 11: bigger feedback + video + socially anxious"
16,"SUPPRF06127",90,4,45,9,-1,62,46,36,"Pilot 11","Pilot 11: bigger feedback + video + socially anxious"
17,"SUPPRF06127",89,8,56,-4,-15,66,71,60,"Pilot 11","Pilot 11: bigger feedback + video + socially anxious"
18,"SUPPRF06127",94,8,68,-11,-12,84,80,79,"Pilot 11","Pilot 11: bigger feedback + video + socially anxious"
19,"SUPPRF06127",90,5,46,-1,0,44,46,47,"Pilot 11","Pilot 11: bigger feedback + video + socially anxious"
20,"SUPPRF06127",96,7,24,4,-13,18,37,20,"Pilot 11","Pilot 11: bigger feedback + video + socially anxious"
21,"SUPPRF06127",90,6,33,4,-13,76,46,29,"Pilot 11","Pilot 11: bigger feedback + video + socially anxious"
22,"SUPPRF06127",96,3,94,33,23,66,71,61,"Pilot 11","Pilot 11: bigger feedback + video + socially anxious"
23,"SUPPRF06127",97,6,8,-9,-12,75,20,17,"Pilot 11","Pilot 11: bigger feedback + video + socially anxious"
24,"SUPPRF06127",95,2,28,20,-1,90,29,8,"Pilot 11","Pilot 11: bigger feedback + video + socially anxious"
25,"SUPPRF06127",96,3,46,16,17,68,29,30,"Pilot 11","Pilot 11: bigger feedback + video + socially anxious"
26,"SUPPRF06127",95,4,78,18,24,76,54,60,"Pilot 11","Pilot 11: bigger feedback + video + socially anxious"
27,"SUPPRF06127",96,2,49,23,12,76,37,26,"Pilot 11","Pilot 11: bigger feedback + video + socially anxious"
28,"SUPPRF06127",95,7,77,31,14,40,63,46,"Pilot 11","Pilot 11: bigger feedback + video + socially anxious"
29,"SUPPRF06127",95,5,20,0,0,82,20,20,"Pilot 11","Pilot 11: bigger feedback + video + socially anxious"
30,"SUPPRF06127",94,6,58,34,29,45,29,24,"Pilot 11","Pilot 11: bigger feedback + video + socially anxious"
31,"SUPPRF06127",96,4,19,-15,-1,76,20,34,"Pilot 11","Pilot 11: bigger feedback + video + socially anxious"
32,"SUPPRF06127",95,5,61,33,24,74,37,28,"Pilot 11","Pilot 11: bigger feedback + video + socially anxious"
33,"SUPPRF06127",93,4,58,24,12,24,46,34,"Pilot 11","Pilot 11: bigger feedback + video + socially anxious"
34,"SUPPRF06127",96,5,96,13,16,86,80,83,"Pilot 11","Pilot 11: bigger feedback + video + socially anxious"
35,"SUPPRF06127",96,5,55,-19,-16,73,71,74,"Pilot 11","Pilot 11: bigger feedback + video + socially anxious"
36,"SUPPRF06127",95,2,22,-21,-15,51,37,43,"Pilot 11","Pilot 11: bigger feedback + video + socially anxious"
37,"SUPPRF06127",96,4,88,62,25,16,63,26,"Pilot 11","Pilot 11: bigger feedback + video + socially anxious"
38,"SUPPRF06127",96,5,47,27,27,79,20,20,"Pilot 11","Pilot 11: bigger feedback + video + socially anxious"
39,"SUPPRF06127",94,4,35,5,15,74,20,30,"Pilot 11","Pilot 11: bigger feedback + video + socially anxious"
40,"SUPPRF06127",89,7,55,-15,1,74,54,70,"Pilot 11","Pilot 11: bigger feedback + video + socially anxious"
41,"SUPPRF06127",91,3,6,-21,-14,38,20,27,"Pilot 11","Pilot 11: bigger feedback + video + socially anxious"
42,"SUPPRF06127",94,13,63,4,0,65,63,59,"Pilot 11","Pilot 11: bigger feedback + video + socially anxious"
43,"SUPPRF06127",91,6,29,9,0,76,29,20,"Pilot 11","Pilot 11: bigger feedback + video + socially anxious"
44,"SUPPRF06127",95,6,100,26,20,84,80,74,"Pilot 11","Pilot 11: bigger feedback + video + socially anxious"
45,"SUPPRF06127",94,8,67,-13,-13,79,80,80,"Pilot 11","Pilot 11: bigger feedback + video + socially anxious"
46,"SUPPRF06127",93,8,75,15,29,77,46,60,"Pilot 11","Pilot 11: bigger feedback + video + socially anxious"
47,"SUPPRF06127",93,4,62,4,-1,74,63,58,"Pilot 11","Pilot 11: bigger feedback + video + socially anxious"
48,"SUPPRF06127",94,9,54,10,0,70,54,44,"Pilot 11","Pilot 11: bigger feedback + video + socially anxious"
1,"SUPPRF84309",59,44,22,-19,-15,72,37,41,"Pilot 11","Pilot 11: bigger feedback + video + socially anxious"
2,"SUPPRF84309",52,51,58,32,29,65,29,26,"Pilot 11","Pilot 11: bigger feedback + video + socially anxious"
3,"SUPPRF84309",55,48,38,5,1,72,37,33,"Pilot 11","Pilot 11: bigger feedback + video + socially anxious"
4,"SUPPRF84309",68,41,68,0,-12,70,80,68,"Pilot 11","Pilot 11: bigger feedback + video + socially anxious"
5,"SUPPRF84309",55,51,58,-1,12,35,46,59,"Pilot 11","Pilot 11: bigger feedback + video + socially anxious"
6,"SUPPRF84309",55,37,70,6,-1,68,71,64,"Pilot 11","Pilot 11: bigger feedback + video + socially anxious"
7,"SUPPRF84309",24,46,38,-26,-16,49,54,64,"Pilot 11","Pilot 11: bigger feedback + video + socially anxious"
8,"SUPPRF84309",43,45,15,-11,-14,70,29,26,"Pilot 11","Pilot 11: bigger feedback + video + socially anxious"
9,"SUPPRF84309",49,46,55,10,1,28,54,45,"Pilot 11","Pilot 11: bigger feedback + video + socially anxious"
10,"SUPPRF84309",47,54,28,-19,-1,64,29,47,"Pilot 11","Pilot 11: bigger feedback + video + socially anxious"
11,"SUPPRF84309",46,49,24,-31,-13,22,37,55,"Pilot 11","Pilot 11: bigger feedback + video + socially anxious"
12,"SUPPRF84309",63,37,81,-2,1,69,80,83,"Pilot 11","Pilot 11: bigger feedback + video + socially anxious"
13,"SUPPRF84309",35,67,6,-7,-14,76,20,13,"Pilot 11","Pilot 11: bigger feedback + video + socially anxious"
14,"SUPPRF84309",49,46,54,0,0,69,54,54,"Pilot 11","Pilot 11: bigger feedback + video + socially anxious"
15,"SUPPRF84309",63,36,77,2,14,16,63,75,"Pilot 11","Pilot 11: bigger feedback + video + socially anxious"
16,"SUPPRF84309",44,63,33,-17,-13,61,46,50,"Pilot 11","Pilot 11: bigger feedback + video + socially anxious"
17,"SUPPRF84309",56,35,63,6,0,71,63,57,"Pilot 11","Pilot 11: bigger feedback + video + socially anxious"
18,"SUPPRF84309",47,43,71,27,0,45,71,44,"Pilot 11","Pilot 11: bigger feedback + video + socially anxious"
19,"SUPPRF84309",55,41,49,-7,12,57,37,56,"Pilot 11","Pilot 11: bigger feedback + video + socially anxious"
20,"SUPPRF84309",59,42,50,-10,-13,70,63,60,"Pilot 11","Pilot 11: bigger feedback + video + socially anxious"
21,"SUPPRF84309",66,51,80,-4,0,75,80,84,"Pilot 11","Pilot 11: bigger feedback + video + socially anxious"
22,"SUPPRF84309",35,62,19,-10,-1,54,20,29,"Pilot 11","Pilot 11: bigger feedback + video + socially anxious"
23,"SUPPRF84309",56,45,62,-21,-1,46,63,83,"Pilot 11","Pilot 11: bigger feedback + video + socially anxious"
24,"SUPPRF84309",79,24,88,26,25,89,63,62,"Pilot 11","Pilot 11: bigger feedback + video + socially anxious"
25,"SUPPRF84309",87,18,100,16,20,82,80,84,"Pilot 11","Pilot 11: bigger feedback + video + socially anxious"
26,"SUPPRF84309",23,60,45,-13,-1,67,46,58,"Pilot 11","Pilot 11: bigger feedback + video + socially anxious"
27,"SUPPRF84309",70,39,47,36,27,74,20,11,"Pilot 11","Pilot 11: bigger feedback + video + socially anxious"
28,"SUPPRF84309",29,21,34,-24,-12,59,46,58,"Pilot 11","Pilot 11: bigger feedback + video + socially anxious"
29,"SUPPRF84309",9,9,29,-22,0,55,29,51,"Pilot 11","Pilot 11: bigger feedback + video + socially anxious"
30,"SUPPRF84309",13,12,35,13,15,76,20,22,"Pilot 11","Pilot 11: bigger feedback + video + socially anxious"
31,"SUPPRF84309",15,19,37,-2,0,72,37,39,"Pilot 11","Pilot 11: bigger feedback + video + socially anxious"
32,"SUPPRF84309",17,13,16,-4,-13,78,29,20,"Pilot 11","Pilot 11: bigger feedback + video + socially anxious"
33,"SUPPRF84309",14,10,8,-12,-12,76,20,20,"Pilot 11","Pilot 11: bigger feedback + video + socially anxious"
34,"SUPPRF84309",22,17,78,38,24,72,54,40,"Pilot 11","Pilot 11: bigger feedback + video + socially anxious"
35,"SUPPRF84309",27,14,94,34,23,69,71,60,"Pilot 11","Pilot 11: bigger feedback + video + socially anxious"
36,"SUPPRF84309",38,14,75,27,29,56,46,48,"Pilot 11","Pilot 11: bigger feedback + video + socially anxious"
37,"SUPPRF84309",20,18,56,0,-15,67,71,56,"Pilot 11","Pilot 11: bigger feedback + video + socially anxious"
38,"SUPPRF84309",34,14,83,21,12,64,71,62,"Pilot 11","Pilot 11: bigger feedback + video + socially anxious"
39,"SUPPRF84309",27,13,66,21,12,70,54,45,"Pilot 11","Pilot 11: bigger feedback + video + socially anxious"
40,"SUPPRF84309",15,15,67,-12,-13,66,80,79,"Pilot 11","Pilot 11: bigger feedback + video + socially anxious"
41,"SUPPRF84309",14,13,47,-7,-16,63,63,54,"Pilot 11","Pilot 11: bigger feedback + video + socially anxious"
42,"SUPPRF84309",23,12,46,-5,0,62,46,51,"Pilot 11","Pilot 11: bigger feedback + video + socially anxious"
43,"SUPPRF84309",16,11,55,-12,-16,65,71,67,"Pilot 11","Pilot 11: bigger feedback + video + socially anxious"
44,"SUPPRF84309",34,10,41,-18,-13,28,54,59,"Pilot 11","Pilot 11: bigger feedback + video + socially anxious"
45,"SUPPRF84309",14,14,61,20,24,46,37,41,"Pilot 11","Pilot 11: bigger feedback + video + socially anxious"
46,"SUPPRF84309",17,16,46,35,17,77,29,11,"Pilot 11","Pilot 11: bigger feedback + video + socially anxious"
47,"SUPPRF84309",38,12,96,10,16,84,80,86,"Pilot 11","Pilot 11: bigger feedback + video + socially anxious"
48,"SUPPRF84309",9,12,20,4,0,84,20,16,"Pilot 11","Pilot 11: bigger feedback + video + socially anxious"
1,"SUPPRF93936",32,98,29,-3,0,60,29,32,"Pilot 11","Pilot 11: bigger feedback + video + socially anxious"
2,"SUPPRF93936",32,98,38,-10,-16,83,54,48,"Pilot 11","Pilot 11: bigger feedback + video + socially anxious"
3,"SUPPRF93936",29,98,22,-21,-15,55,37,43,"Pilot 11","Pilot 11: bigger feedback + video + socially anxious"
4,"SUPPRF93936",26,98,20,19,0,99,20,1,"Pilot 11","Pilot 11: bigger feedback + video + socially anxious"
5,"SUPPRF93936",24,98,16,-8,-13,98,29,24,"Pilot 11","Pilot 11: bigger feedback + video + socially anxious"
6,"SUPPRF93936",42,90,83,44,12,84,71,39,"Pilot 11","Pilot 11: bigger feedback + video + socially anxious"
7,"SUPPRF93936",32,99,77,52,14,79,63,25,"Pilot 11","Pilot 11: bigger feedback + video + socially anxious"
8,"SUPPRF93936",66,86,100,62,20,31,80,38,"Pilot 11","Pilot 11: bigger feedback + video + socially anxious"
9,"SUPPRF93936",45,75,55,16,1,52,54,39,"Pilot 11","Pilot 11: bigger feedback + video + socially anxious"
10,"SUPPRF93936",25,81,63,22,0,50,63,41,"Pilot 11","Pilot 11: bigger feedback + video + socially anxious"
11,"SUPPRF93936",27,88,71,37,0,49,71,34,"Pilot 11","Pilot 11: bigger feedback + video + socially anxious"
12,"SUPPRF93936",27,94,58,22,12,45,46,36,"Pilot 11","Pilot 11: bigger feedback + video + socially anxious"
13,"SUPPRF93936",26,93,47,0,-16,47,63,47,"Pilot 11","Pilot 11: bigger feedback + video + socially anxious"
14,"SUPPRF93936",30,93,50,9,-13,51,63,41,"Pilot 11","Pilot 11: bigger feedback + video + socially anxious"
15,"SUPPRF93936",23,92,8,-3,-12,67,20,11,"Pilot 11","Pilot 11: bigger feedback + video + socially anxious"
16,"SUPPRF93936",28,94,38,14,1,84,37,24,"Pilot 11","Pilot 11: bigger feedback + video + socially anxious"
17,"SUPPRF93936",33,88,47,39,27,86,20,8,"Pilot 11","Pilot 11: bigger feedback + video + socially anxious"
18,"SUPPRF93936",39,92,35,12,15,72,20,23,"Pilot 11","Pilot 11: bigger feedback + video + socially anxious"
19,"SUPPRF93936",40,75,54,13,0,59,54,41,"Pilot 11","Pilot 11: bigger feedback + video + socially anxious"
20,"SUPPRF93936",49,71,46,9,0,52,46,37,"Pilot 11","Pilot 11: bigger feedback + video + socially anxious"
21,"SUPPRF93936",49,75,66,34,12,38,54,32,"Pilot 11","Pilot 11: bigger feedback + video + socially anxious"
22,"SUPPRF93936",48,72,41,20,-13,78,54,21,"Pilot 11","Pilot 11: bigger feedback + video + socially anxious"
23,"SUPPRF93936",50,72,28,11,-1,68,29,17,"Pilot 11","Pilot 11: bigger feedback + video + socially anxious"
24,"SUPPRF93936",50,74,15,-12,-14,75,29,27,"Pilot 11","Pilot 11: bigger feedback + video + socially anxious"
25,"SUPPRF93936",49,74,55,34,-16,74,71,21,"Pilot 11","Pilot 11: bigger feedback + video + socially anxious"
26,"SUPPRF93936",47,67,19,-2,-1,67,20,21,"Pilot 11","Pilot 11: bigger feedback + video + socially anxious"
27,"SUPPRF93936",50,79,34,5,-12,49,46,29,"Pilot 11","Pilot 11: bigger feedback + video + socially anxious"
28,"SUPPRF93936",48,62,94,45,23,69,71,49,"Pilot 11","Pilot 11: bigger feedback + video + socially anxious"
29,"SUPPRF93936",50,67,96,53,16,27,80,43,"Pilot 11","Pilot 11: bigger feedback + video + socially anxious"
30,"SUPPRF93936",50,81,67,25,-13,28,80,42,"Pilot 11","Pilot 11: bigger feedback + video + socially anxious"
31,"SUPPRF93936",50,78,78,38,24,61,54,40,"Pilot 11","Pilot 11: bigger feedback + video + socially anxious"
32,"SUPPRF93936",49,45,56,-14,-15,70,71,70,"Pilot 11","Pilot 11: bigger feedback + video + socially anxious"
33,"SUPPRF93936",49,66,88,57,25,39,63,31,"Pilot 11","Pilot 11: bigger feedback + video + socially anxious"
34,"SUPPRF93936",51,83,6,-10,-14,78,20,16,"Pilot 11","Pilot 11: bigger feedback + video + socially anxious"
35,"SUPPRF93936",45,65,68,38,-12,30,80,30,"Pilot 11","Pilot 11: bigger feedback + video + socially anxious"
36,"SUPPRF93936",48,87,58,33,29,49,29,25,"Pilot 11","Pilot 11: bigger feedback + video + socially anxious"
37,"SUPPRF93936",46,70,45,14,-1,43,46,31,"Pilot 11","Pilot 11: bigger feedback + video + socially anxious"
38,"SUPPRF93936",42,71,80,30,0,62,80,50,"Pilot 11","Pilot 11: bigger feedback + video + socially anxious"
39,"SUPPRF93936",48,73,70,31,-1,30,71,39,"Pilot 11","Pilot 11: bigger feedback + video + socially anxious"
40,"SUPPRF93936",44,69,37,-3,0,34,37,40,"Pilot 11","Pilot 11: bigger feedback + video + socially anxious"
41,"SUPPRF93936",45,68,62,20,-1,51,63,42,"Pilot 11","Pilot 11: bigger feedback + video + socially anxious"
42,"SUPPRF93936",48,74,46,14,17,70,29,32,"Pilot 11","Pilot 11: bigger feedback + video + socially anxious"
43,"SUPPRF93936",41,67,33,-10,-13,38,46,43,"Pilot 11","Pilot 11: bigger feedback + video + socially anxious"
44,"SUPPRF93936",48,66,61,27,24,27,37,34,"Pilot 11","Pilot 11: bigger feedback + video + socially anxious"
45,"SUPPRF93936",42,54,81,58,1,29,80,23,"Pilot 11","Pilot 11: bigger feedback + video + socially anxious"
46,"SUPPRF93936",48,51,75,41,29,42,46,34,"Pilot 11","Pilot 11: bigger feedback + video + socially anxious"
47,"SUPPRF93936",50,51,24,-5,-13,67,37,29,"Pilot 11","Pilot 11: bigger feedback + video + socially anxious"
48,"SUPPRF93936",48,53,49,29,12,47,37,20,"Pilot 11","Pilot 11: bigger feedback + video + socially anxious"
1,"SUPPRF78461_p11",77,19,37,7,0,68,37,30,"Pilot 11","Pilot 11: bigger feedback + video + socially anxious"
2,"SUPPRF78461_p11",68,27,56,-16,-15,70,71,72,"Pilot 11","Pilot 11: bigger feedback + video + socially anxious"
3,"SUPPRF78461_p11",70,33,24,-13,-13,65,37,37,"Pilot 11","Pilot 11: bigger feedback + video + socially anxious"
4,"SUPPRF78461_p11",69,33,41,-2,-13,69,54,43,"Pilot 11","Pilot 11: bigger feedback + video + socially anxious"
5,"SUPPRF78461_p11",63,30,34,-5,-12,72,46,39,"Pilot 11","Pilot 11: bigger feedback + video + socially anxious"
6,"SUPPRF78461_p11",83,15,96,19,16,81,80,77,"Pilot 11","Pilot 11: bigger feedback + video + socially anxious"
7,"SUPPRF78461_p11",50,49,80,28,0,51,80,52,"Pilot 11","Pilot 11: bigger feedback + video + socially anxious"
8,"SUPPRF78461_p11",67,35,45,2,-1,78,46,43,"Pilot 11","Pilot 11: bigger feedback + video + socially anxious"
9,"SUPPRF78461_p11",58,43,55,-23,-16,77,71,78,"Pilot 11","Pilot 11: bigger feedback + video + socially anxious"
10,"SUPPRF78461_p11",66,31,83,5,12,76,71,78,"Pilot 11","Pilot 11: bigger feedback + video + socially anxious"
11,"SUPPRF78461_p11",64,34,38,5,1,66,37,33,"Pilot 11","Pilot 11: bigger feedback + video + socially anxious"
12,"SUPPRF78461_p11",60,39,50,-17,-13,63,63,67,"Pilot 11","Pilot 11: bigger feedback + video + socially anxious"
13,"SUPPRF78461_p11",54,42,49,13,12,59,37,36,"Pilot 11","Pilot 11: bigger feedback + video + socially anxious"
14,"SUPPRF78461_p11",61,39,47,29,27,70,20,18,"Pilot 11","Pilot 11: bigger feedback + video + socially anxious"
15,"SUPPRF78461_p11",69,33,75,33,29,62,46,42,"Pilot 11","Pilot 11: bigger feedback + video + socially anxious"
16,"SUPPRF78461_p11",46,54,38,-25,-16,64,54,63,"Pilot 11","Pilot 11: bigger feedback + video + socially anxious"
17,"SUPPRF78461_p11",55,42,20,-3,0,71,20,23,"Pilot 11","Pilot 11: bigger feedback + video + socially anxious"
18,"SUPPRF78461_p11",50,52,22,-11,-15,67,37,33,"Pilot 11","Pilot 11: bigger feedback + video + socially anxious"
19,"SUPPRF78461_p11",59,35,94,19,23,60,71,75,"Pilot 11","Pilot 11: bigger feedback + video + socially anxious"
20,"SUPPRF78461_p11",56,38,66,15,12,48,54,51,"Pilot 11","Pilot 11: bigger feedback + video + socially anxious"
21,"SUPPRF78461_p11",60,40,58,35,29,68,29,23,"Pilot 11","Pilot 11: bigger feedback + video + socially anxious"
22,"SUPPRF78461_p11",57,41,55,-2,1,73,54,57,"Pilot 11","Pilot 11: bigger feedback + video + socially anxious"
23,"SUPPRF78461_p11",68,32,46,27,17,63,29,19,"Pilot 11","Pilot 11: bigger feedback + video + socially anxious"
24,"SUPPRF78461_p11",63,31,71,-4,0,81,71,75,"Pilot 11","Pilot 11: bigger feedback + video + socially anxious"
25,"SUPPRF78461_p11",70,22,88,52,25,60,63,36,"Pilot 11","Pilot 11: bigger feedback + video + socially anxious"
26,"SUPPRF78461_p11",62,36,61,26,24,69,37,35,"Pilot 11","Pilot 11: bigger feedback + video + socially anxious"
27,"SUPPRF78461_p11",56,37,33,0,-13,64,46,33,"Pilot 11","Pilot 11: bigger feedback + video + socially anxious"
28,"SUPPRF78461_p11",56,43,19,2,-1,63,20,17,"Pilot 11","Pilot 11: bigger feedback + video + socially anxious"
29,"SUPPRF78461_p11",58,36,78,34,24,70,54,44,"Pilot 11","Pilot 11: bigger feedback + video + socially anxious"
30,"SUPPRF78461_p11",69,27,81,8,1,78,80,73,"Pilot 11","Pilot 11: bigger feedback + video + socially anxious"
31,"SUPPRF78461_p11",66,35,77,3,14,71,63,74,"Pilot 11","Pilot 11: bigger feedback + video + socially anxious"
32,"SUPPRF78461_p11",70,32,62,-6,-1,66,63,68,"Pilot 11","Pilot 11: bigger feedback + video + socially anxious"
33,"SUPPRF78461_p11",36,60,8,-11,-12,68,20,19,"Pilot 11","Pilot 11: bigger feedback + video + socially anxious"
34,"SUPPRF78461_p11",56,45,63,-5,0,71,63,68,"Pilot 11","Pilot 11: bigger feedback + video + socially anxious"
35,"SUPPRF78461_p11",52,44,35,15,15,63,20,20,"Pilot 11","Pilot 11: bigger feedback + video + socially anxious"
36,"SUPPRF78461_p11",54,44,58,17,12,74,46,41,"Pilot 11","Pilot 11: bigger feedback + video + socially anxious"
37,"SUPPRF78461_p11",52,45,70,-4,-1,79,71,74,"Pilot 11","Pilot 11: bigger feedback + video + socially anxious"
38,"SUPPRF78461_p11",55,45,29,3,0,69,29,26,"Pilot 11","Pilot 11: bigger feedback + video + socially anxious"
39,"SUPPRF78461_p11",24,63,6,-12,-14,66,20,18,"Pilot 11","Pilot 11: bigger feedback + video + socially anxious"
40,"SUPPRF78461_p11",63,33,46,12,0,21,46,34,"Pilot 11","Pilot 11: bigger feedback + video + socially anxious"
41,"SUPPRF78461_p11",34,59,47,-21,-16,28,63,68,"Pilot 11","Pilot 11: bigger feedback + video + socially anxious"
42,"SUPPRF78461_p11",57,45,28,3,-1,67,29,25,"Pilot 11","Pilot 11: bigger feedback + video + socially anxious"
43,"SUPPRF78461_p11",35,64,67,-17,-13,69,80,84,"Pilot 11","Pilot 11: bigger feedback + video + socially anxious"
44,"SUPPRF78461_p11",28,75,15,-13,-14,63,29,28,"Pilot 11","Pilot 11: bigger feedback + video + socially anxious"
45,"SUPPRF78461_p11",25,68,68,-16,-12,66,80,84,"Pilot 11","Pilot 11: bigger feedback + video + socially anxious"
46,"SUPPRF78461_p11",41,63,54,-3,0,37,54,57,"Pilot 11","Pilot 11: bigger feedback + video + socially anxious"
47,"SUPPRF78461_p11",75,24,100,19,20,60,80,81,"Pilot 11","Pilot 11: bigger feedback + video + socially anxious"
48,"SUPPRF78461_p11",31,65,16,-14,-13,60,29,30,"Pilot 11","Pilot 11: bigger feedback + video + socially anxious"
1,"SUPPRF00216",54,60,19,-33,-1,49,20,52,"Pilot 11","Pilot 11: bigger feedback + video + socially anxious"
2,"SUPPRF00216",68,29,45,-5,-1,56,46,50,"Pilot 11","Pilot 11: bigger feedback + video + socially anxious"
3,"SUPPRF00216",63,35,22,-28,-15,67,37,50,"Pilot 11","Pilot 11: bigger feedback + video + socially anxious"
4,"SUPPRF00216",51,41,66,42,12,66,54,24,"Pilot 11","Pilot 11: bigger feedback + video + socially anxious"
5,"SUPPRF00216",69,33,75,54,29,66,46,21,"Pilot 11","Pilot 11: bigger feedback + video + socially anxious"
6,"SUPPRF00216",65,38,78,23,24,68,54,55,"Pilot 11","Pilot 11: bigger feedback + video + socially anxious"
7,"SUPPRF00216",65,35,49,1,12,64,37,48,"Pilot 11","Pilot 11: bigger feedback + video + socially anxious"
8,"SUPPRF00216",69,49,96,46,16,60,80,50,"Pilot 11","Pilot 11: bigger feedback + video + socially anxious"
9,"SUPPRF00216",60,32,67,17,-13,51,80,50,"Pilot 11","Pilot 11: bigger feedback + video + socially anxious"
10,"SUPPRF00216",66,28,47,-4,-16,51,63,51,"Pilot 11","Pilot 11: bigger feedback + video + socially anxious"
11,"SUPPRF00216",62,25,29,-26,0,70,29,55,"Pilot 11","Pilot 11: bigger feedback + video + socially anxious"
12,"SUPPRF00216",66,34,37,-13,0,52,37,50,"Pilot 11","Pilot 11: bigger feedback + video + socially anxious"
13,"SUPPRF00216",48,56,58,4,12,54,46,54,"Pilot 11","Pilot 11: bigger feedback + video + socially anxious"
14,"SUPPRF00216",57,30,68,18,-12,56,80,50,"Pilot 11","Pilot 11: bigger feedback + video + socially anxious"
15,"SUPPRF00216",61,38,55,-9,1,70,54,64,"Pilot 11","Pilot 11: bigger feedback + video + socially anxious"
16,"SUPPRF00216",68,29,100,41,20,49,80,59,"Pilot 11","Pilot 11: bigger feedback + video + socially anxious"
17,"SUPPRF00216",67,32,81,28,1,54,80,53,"Pilot 11","Pilot 11: bigger feedback + video + socially anxious"
18,"SUPPRF00216",64,23,70,-3,-1,62,71,73,"Pilot 11","Pilot 11: bigger feedback + video + socially anxious"
19,"SUPPRF00216",66,25,63,5,0,61,63,58,"Pilot 11","Pilot 11: bigger feedback + video + socially anxious"
20,"SUPPRF00216",51,60,55,-2,-16,65,71,57,"Pilot 11","Pilot 11: bigger feedback + video + socially anxious"
21,"SUPPRF00216",61,35,88,31,25,65,63,57,"Pilot 11","Pilot 11: bigger feedback + video + socially anxious"
22,"SUPPRF00216",68,24,28,-53,-1,75,29,81,"Pilot 11","Pilot 11: bigger feedback + video + socially anxious"
23,"SUPPRF00216",70,32,71,11,0,66,71,60,"Pilot 11","Pilot 11: bigger feedback + video + socially anxious"
24,"SUPPRF00216",66,30,6,-57,-14,61,20,63,"Pilot 11","Pilot 11: bigger feedback + video + socially anxious"
25,"SUPPRF00216",63,28,24,-37,-13,62,37,61,"Pilot 11","Pilot 11: bigger feedback + video + socially anxious"
26,"SUPPRF00216",67,31,35,-31,15,64,20,66,"Pilot 11","Pilot 11: bigger feedback + video + socially anxious"
27,"SUPPRF00216",64,29,58,-5,29,62,29,63,"Pilot 11","Pilot 11: bigger feedback + video + socially anxious"
28,"SUPPRF00216",68,27,46,-20,17,67,29,66,"Pilot 11","Pilot 11: bigger feedback + video + socially anxious"
29,"SUPPRF00216",64,27,33,-26,-13,70,46,59,"Pilot 11","Pilot 11: bigger feedback + video + socially anxious"
30,"SUPPRF00216",70,25,83,19,12,67,71,64,"Pilot 11","Pilot 11: bigger feedback + video + socially anxious"
31,"SUPPRF00216",69,31,15,-52,-14,68,29,67,"Pilot 11","Pilot 11: bigger feedback + video + socially anxious"
32,"SUPPRF00216",66,28,61,11,24,59,37,50,"Pilot 11","Pilot 11: bigger feedback + video + socially anxious"
33,"SUPPRF00216",64,25,80,7,0,63,80,73,"Pilot 11","Pilot 11: bigger feedback + video + socially anxious"
34,"SUPPRF00216",68,30,34,-47,-12,75,46,81,"Pilot 11","Pilot 11: bigger feedback + video + socially anxious"
35,"SUPPRF00216",71,24,47,-18,27,70,20,65,"Pilot 11","Pilot 11: bigger feedback + video + socially anxious"
36,"SUPPRF00216",70,25,54,-24,0,74,54,78,"Pilot 11","Pilot 11: bigger feedback + video + socially anxious"
37,"SUPPRF00216",71,23,46,-25,0,72,46,71,"Pilot 11","Pilot 11: bigger feedback + video + socially anxious"
38,"SUPPRF00216",69,21,38,-29,1,70,37,67,"Pilot 11","Pilot 11: bigger feedback + video + socially anxious"
39,"SUPPRF00216",77,28,20,-42,0,63,20,62,"Pilot 11","Pilot 11: bigger feedback + video + socially anxious"
40,"SUPPRF00216",72,52,16,-57,-13,76,29,73,"Pilot 11","Pilot 11: bigger feedback + video + socially anxious"
41,"SUPPRF00216",70,30,38,-32,-16,71,54,70,"Pilot 11","Pilot 11: bigger feedback + video + socially anxious"
42,"SUPPRF00216",73,48,77,-2,14,68,63,79,"Pilot 11","Pilot 11: bigger feedback + video + socially anxious"
43,"SUPPRF00216",69,47,50,-36,-13,71,63,86,"Pilot 11","Pilot 11: bigger feedback + video + socially anxious"
44,"SUPPRF00216",68,29,56,-18,-15,58,71,74,"Pilot 11","Pilot 11: bigger feedback + video + socially anxious"
45,"SUPPRF00216",72,31,94,21,23,75,71,73,"Pilot 11","Pilot 11: bigger feedback + video + socially anxious"
46,"SUPPRF00216",76,26,62,-15,-1,77,63,77,"Pilot 11","Pilot 11: bigger feedback + video + socially anxious"
47,"SUPPRF00216",70,48,41,-26,-13,75,54,67,"Pilot 11","Pilot 11: bigger feedback + video + socially anxious"
48,"SUPPRF00216",52,28,8,-63,-12,75,20,71,"Pilot 11","Pilot 11: bigger feedback + video + socially anxious"
1,"SUPPRF79304",52,46,83,16,12,60,71,67,"Pilot 11","Pilot 11: bigger feedback + video + socially anxious"
2,"SUPPRF79304",50,39,61,31,24,50,37,30,"Pilot 11","Pilot 11: bigger feedback + video + socially anxious"
3,"SUPPRF79304",50,32,28,-9,-1,53,29,37,"Pilot 11","Pilot 11: bigger feedback + video + socially anxious"
4,"SUPPRF79304",51,37,77,38,14,37,63,39,"Pilot 11","Pilot 11: bigger feedback + video + socially anxious"
5,"SUPPRF79304",47,35,33,-7,-13,19,46,40,"Pilot 11","Pilot 11: bigger feedback + video + socially anxious"
6,"SUPPRF79304",37,37,55,27,1,20,54,28,"Pilot 11","Pilot 11: bigger feedback + video + socially anxious"
7,"SUPPRF79304",51,26,8,-25,-12,10,20,33,"Pilot 11","Pilot 11: bigger feedback + video + socially anxious"
8,"SUPPRF79304",46,43,49,12,12,10,37,37,"Pilot 11","Pilot 11: bigger feedback + video + socially anxious"
9,"SUPPRF79304",43,23,75,37,29,21,46,38,"Pilot 11","Pilot 11: bigger feedback + video + socially anxious"
10,"SUPPRF79304",51,23,50,-9,-13,9,63,59,"Pilot 11","Pilot 11: bigger feedback + video + socially anxious"
11,"SUPPRF79304",52,38,41,10,-13,45,54,31,"Pilot 11","Pilot 11: bigger feedback + video + socially anxious"
12,"SUPPRF79304",30,25,24,-25,-13,25,37,49,"Pilot 11","Pilot 11: bigger feedback + video + socially anxious"
13,"SUPPRF79304",46,31,19,-5,-1,64,20,24,"Pilot 11","Pilot 11: bigger feedback + video + socially anxious"
14,"SUPPRF79304",43,31,15,-17,-14,55,29,32,"Pilot 11","Pilot 11: bigger feedback + video + socially anxious"
15,"SUPPRF79304",30,41,35,25,15,67,20,10,"Pilot 11","Pilot 11: bigger feedback + video + socially anxious"
16,"SUPPRF79304",48,32,80,12,0,66,80,68,"Pilot 11","Pilot 11: bigger feedback + video + socially anxious"
17,"SUPPRF79304",28,33,46,-17,17,28,29,63,"Pilot 11","Pilot 11: bigger feedback + video + socially anxious"
18,"SUPPRF79304",31,25,54,15,0,46,54,39,"Pilot 11","Pilot 11: bigger feedback + video + socially anxious"
19,"SUPPRF79304",21,30,68,39,-12,4,80,29,"Pilot 11","Pilot 11: bigger feedback + video + socially anxious"
20,"SUPPRF79304",32,23,56,20,-15,6,71,36,"Pilot 11","Pilot 11: bigger feedback + video + socially anxious"
21,"SUPPRF79304",27,28,37,12,0,57,37,25,"Pilot 11","Pilot 11: bigger feedback + video + socially anxious"
22,"SUPPRF79304",26,21,29,1,0,65,29,28,"Pilot 11","Pilot 11: bigger feedback + video + socially anxious"
23,"SUPPRF79304",26,32,55,16,-16,63,71,39,"Pilot 11","Pilot 11: bigger feedback + video + socially anxious"
24,"SUPPRF79304",28,26,6,-33,-14,63,20,39,"Pilot 11","Pilot 11: bigger feedback + video + socially anxious"
25,"SUPPRF79304",27,24,16,-3,-13,48,29,19,"Pilot 11","Pilot 11: bigger feedback + video + socially anxious"
26,"SUPPRF79304",31,19,70,40,-1,51,71,30,"Pilot 11","Pilot 11: bigger feedback + video + socially anxious"
27,"SUPPRF79304",19,30,96,46,16,34,80,50,"Pilot 11","Pilot 11: bigger feedback + video + socially anxious"
28,"SUPPRF79304",31,28,66,10,12,49,54,56,"Pilot 11","Pilot 11: bigger feedback + video + socially anxious"
29,"SUPPRF79304",22,17,67,-3,-13,70,80,70,"Pilot 11","Pilot 11: bigger feedback + video + socially anxious"
30,"SUPPRF79304",27,27,46,14,0,52,46,32,"Pilot 11","Pilot 11: bigger feedback + video + socially anxious"
31,"SUPPRF79304",27,18,34,1,-12,47,46,33,"Pilot 11","Pilot 11: bigger feedback + video + socially anxious"
32,"SUPPRF79304",29,28,88,18,25,60,63,70,"Pilot 11","Pilot 11: bigger feedback + video + socially anxious"
33,"SUPPRF79304",17,21,45,-6,-1,42,46,51,"Pilot 11","Pilot 11: bigger feedback + video + socially anxious"
34,"SUPPRF79304",33,27,71,4,0,45,71,67,"Pilot 11","Pilot 11: bigger feedback + video + socially anxious"
35,"SUPPRF79304",43,28,81,11,1,60,80,70,"Pilot 11","Pilot 11: bigger feedback + video + socially anxious"
36,"SUPPRF79304",28,26,58,12,12,68,46,46,"Pilot 11","Pilot 11: bigger feedback + video + socially anxious"
37,"SUPPRF79304",32,24,47,30,27,51,20,17,"Pilot 11","Pilot 11: bigger feedback + video + socially anxious"
38,"SUPPRF79304",29,29,78,43,24,43,54,35,"Pilot 11","Pilot 11: bigger feedback + video + socially anxious"
39,"SUPPRF79304",36,23,62,16,-1,43,63,46,"Pilot 11","Pilot 11: bigger feedback + video + socially anxious"
40,"SUPPRF79304",32,21,94,54,23,29,71,40,"Pilot 11","Pilot 11: bigger feedback + video + socially anxious"
41,"SUPPRF79304",23,24,58,42,29,48,29,16,"Pilot 11","Pilot 11: bigger feedback + video + socially anxious"
42,"SUPPRF79304",23,17,20,5,0,44,20,15,"Pilot 11","Pilot 11: bigger feedback + video + socially anxious"
43,"SUPPRF79304",30,13,100,70,20,48,80,30,"Pilot 11","Pilot 11: bigger feedback + video + socially anxious"
44,"SUPPRF79304",25,26,47,-20,-16,63,63,67,"Pilot 11","Pilot 11: bigger feedback + video + socially anxious"
45,"SUPPRF79304",21,30,38,12,1,34,37,26,"Pilot 11","Pilot 11: bigger feedback + video + socially anxious"
46,"SUPPRF79304",18,22,22,0,-15,36,37,22,"Pilot 11","Pilot 11: bigger feedback + video + socially anxious"
47,"SUPPRF79304",27,18,63,26,0,41,63,37,"Pilot 11","Pilot 11: bigger feedback + video + socially anxious"
48,"SUPPRF79304",25,19,38,-17,-16,40,54,55,"Pilot 11","Pilot 11: bigger feedback + video + socially anxious"
1,"SUPPRF73458",54,89,58,17,12,34,46,41,"Pilot 11","Pilot 11: bigger feedback + video + socially anxious"
2,"SUPPRF73458",40,84,15,-52,-14,29,29,67,"Pilot 11","Pilot 11: bigger feedback + video + socially anxious"
3,"SUPPRF73458",44,90,45,0,-1,22,46,45,"Pilot 11","Pilot 11: bigger feedback + video + socially anxious"
4,"SUPPRF73458",47,79,47,37,27,10,20,10,"Pilot 11","Pilot 11: bigger feedback + video + socially anxious"
5,"SUPPRF73458",52,68,96,18,16,47,80,78,"Pilot 11","Pilot 11: bigger feedback + video + socially anxious"
6,"SUPPRF73458",46,73,58,41,29,48,29,17,"Pilot 11","Pilot 11: bigger feedback + video + socially anxious"
7,"SUPPRF73458",48,46,55,11,1,23,54,44,"Pilot 11","Pilot 11: bigger feedback + video + socially anxious"
8,"SUPPRF73458",37,69,63,15,0,34,63,48,"Pilot 11","Pilot 11: bigger feedback + video + socially anxious"
9,"SUPPRF73458",45,34,6,-49,-14,30,20,55,"Pilot 11","Pilot 11: bigger feedback + video + socially anxious"
10,"SUPPRF73458",56,49,71,30,0,41,71,41,"Pilot 11","Pilot 11: bigger feedback + video + socially anxious"
11,"SUPPRF73458",49,59,37,-5,0,20,37,42,"Pilot 11","Pilot 11: bigger feedback + video + socially anxious"
12,"SUPPRF73458",48,62,78,32,24,30,54,46,"Pilot 11","Pilot 11: bigger feedback + video + socially anxious"
13,"SUPPRF73458",46,58,88,61,25,31,63,27,"Pilot 11","Pilot 11: bigger feedback + video + socially anxious"
14,"SUPPRF73458",52,50,83,44,12,27,71,39,"Pilot 11","Pilot 11: bigger feedback + video + socially anxious"
15,"SUPPRF73458",58,23,75,68,29,13,46,7,"Pilot 11","Pilot 11: bigger feedback + video + socially anxious"
16,"SUPPRF73458",47,47,46,19,0,16,46,27,"Pilot 11","Pilot 11: bigger feedback + video + socially anxious"
17,"SUPPRF73458",27,55,24,-23,-13,34,37,47,"Pilot 11","Pilot 11: bigger feedback + video + socially anxious"
18,"SUPPRF73458",45,49,19,14,-1,9,20,5,"Pilot 11","Pilot 11: bigger feedback + video + socially anxious"
19,"SUPPRF73458",48,30,80,72,0,5,80,8,"Pilot 11","Pilot 11: bigger feedback + video + socially anxious"
20,"SUPPRF73458",37,51,68,33,-12,23,80,35,"Pilot 11","Pilot 11: bigger feedback + video + socially anxious"
21,"SUPPRF73458",32,33,38,8,-16,19,54,30,"Pilot 11","Pilot 11: bigger feedback + video + socially anxious"
22,"SUPPRF73458",51,42,20,18,0,11,20,2,"Pilot 11","Pilot 11: bigger feedback + video + socially anxious"
23,"SUPPRF73458",48,54,41,11,-13,24,54,30,"Pilot 11","Pilot 11: bigger feedback + video + socially anxious"
24,"SUPPRF73458",53,47,61,27,24,28,37,34,"Pilot 11","Pilot 11: bigger feedback + video + socially anxious"
25,"SUPPRF73458",42,54,56,-11,-15,40,71,67,"Pilot 11","Pilot 11: bigger feedback + video + socially anxious"
26,"SUPPRF73458",55,44,34,23,-12,15,46,11,"Pilot 11","Pilot 11: bigger feedback + video + socially anxious"
27,"SUPPRF73458",30,49,81,51,1,35,80,30,"Pilot 11","Pilot 11: bigger feedback + video + socially anxious"
28,"SUPPRF73458",41,63,55,16,-16,39,71,39,"Pilot 11","Pilot 11: bigger feedback + video + socially anxious"
29,"SUPPRF73458",42,46,47,0,-16,24,63,47,"Pilot 11","Pilot 11: bigger feedback + video + socially anxious"
30,"SUPPRF73458",52,37,49,4,12,30,37,45,"Pilot 11","Pilot 11: bigger feedback + video + socially anxious"
31,"SUPPRF73458",39,56,38,6,1,36,37,32,"Pilot 11","Pilot 11: bigger feedback + video + socially anxious"
32,"SUPPRF73458",30,62,16,-15,-13,24,29,31,"Pilot 11","Pilot 11: bigger feedback + video + socially anxious"
33,"SUPPRF73458",47,65,46,14,17,24,29,32,"Pilot 11","Pilot 11: bigger feedback + video + socially anxious"
34,"SUPPRF73458",41,53,29,-3,0,62,29,32,"Pilot 11","Pilot 11: bigger feedback + video + socially anxious"
35,"SUPPRF73458",49,36,35,4,15,19,20,31,"Pilot 11","Pilot 11: bigger feedback + video + socially anxious"
36,"SUPPRF73458",38,66,54,24,0,27,54,30,"Pilot 11","Pilot 11: bigger feedback + video + socially anxious"
37,"SUPPRF73458",52,47,50,21,-13,18,63,29,"Pilot 11","Pilot 11: bigger feedback + video + socially anxious"
38,"SUPPRF73458",45,51,70,39,-1,32,71,31,"Pilot 11","Pilot 11: bigger feedback + video + socially anxious"
39,"SUPPRF73458",52,43,77,36,14,25,63,41,"Pilot 11","Pilot 11: bigger feedback + video + socially anxious"
40,"SUPPRF73458",49,59,28,-20,-1,27,29,48,"Pilot 11","Pilot 11: bigger feedback + video + socially anxious"
41,"SUPPRF73458",43,45,66,44,12,44,54,22,"Pilot 11","Pilot 11: bigger feedback + video + socially anxious"
42,"SUPPRF73458",47,49,67,38,-13,34,80,29,"Pilot 11","Pilot 11: bigger feedback + video + socially anxious"
43,"SUPPRF73458",37,58,8,-29,-12,31,20,37,"Pilot 11","Pilot 11: bigger feedback + video + socially anxious"
44,"SUPPRF73458",49,51,62,22,-1,26,63,40,"Pilot 11","Pilot 11: bigger feedback + video + socially anxious"
45,"SUPPRF73458",39,42,22,-23,-15,39,37,45,"Pilot 11","Pilot 11: bigger feedback + video + socially anxious"
46,"SUPPRF73458",50,46,33,-5,-13,37,46,38,"Pilot 11","Pilot 11: bigger feedback + video + socially anxious"
47,"SUPPRF73458",64,33,94,78,23,34,71,16,"Pilot 11","Pilot 11: bigger feedback + video + socially anxious"
48,"SUPPRF73458",90,3,100,56,20,44,80,44,"Pilot 11","Pilot 11: bigger feedback + video + socially anxious"
1,"SUPPRF99862",55,52,24,-20,-13,44,37,44,"Pilot 11","Pilot 11: bigger feedback + video + socially anxious"
2,"SUPPRF99862",58,42,38,4,1,62,37,34,"Pilot 11","Pilot 11: bigger feedback + video + socially anxious"
3,"SUPPRF99862",52,44,28,-4,-1,52,29,32,"Pilot 11","Pilot 11: bigger feedback + video + socially anxious"
4,"SUPPRF99862",50,49,33,7,-13,42,46,26,"Pilot 11","Pilot 11: bigger feedback + video + socially anxious"
5,"SUPPRF99862",50,39,71,7,0,70,71,64,"Pilot 11","Pilot 11: bigger feedback + video + socially anxious"
6,"SUPPRF99862",48,40,6,-18,-14,70,20,24,"Pilot 11","Pilot 11: bigger feedback + video + socially anxious"
7,"SUPPRF99862",38,34,34,7,-12,42,46,27,"Pilot 11","Pilot 11: bigger feedback + video + socially anxious"
8,"SUPPRF99862",62,40,100,22,20,84,80,78,"Pilot 11","Pilot 11: bigger feedback + video + socially anxious"
9,"SUPPRF99862",53,38,77,13,14,78,63,64,"Pilot 11","Pilot 11: bigger feedback + video + socially anxious"
10,"SUPPRF99862",50,46,62,18,-1,45,63,44,"Pilot 11","Pilot 11: bigger feedback + video + socially anxious"
11,"SUPPRF99862",44,50,75,25,29,73,46,50,"Pilot 11","Pilot 11: bigger feedback + video + socially anxious"
12,"SUPPRF99862",58,51,68,-7,-12,85,80,75,"Pilot 11","Pilot 11: bigger feedback + video + socially anxious"
13,"SUPPRF99862",53,58,83,30,12,73,71,53,"Pilot 11","Pilot 11: bigger feedback + video + socially anxious"
14,"SUPPRF99862",50,58,54,23,0,72,54,31,"Pilot 11","Pilot 11: bigger feedback + video + socially anxious"
15,"SUPPRF99862",47,59,66,30,12,66,54,36,"Pilot 11","Pilot 11: bigger feedback + video + socially anxious"
16,"SUPPRF99862",41,66,22,-13,-15,64,37,35,"Pilot 11","Pilot 11: bigger feedback + video + socially anxious"
17,"SUPPRF99862",38,68,15,-33,-14,24,29,48,"Pilot 11","Pilot 11: bigger feedback + video + socially anxious"
18,"SUPPRF99862",38,73,35,16,15,76,20,19,"Pilot 11","Pilot 11: bigger feedback + video + socially anxious"
19,"SUPPRF99862",40,64,70,34,-1,49,71,36,"Pilot 11","Pilot 11: bigger feedback + video + socially anxious"
20,"SUPPRF99862",37,75,63,-22,0,82,63,85,"Pilot 11","Pilot 11: bigger feedback + video + socially anxious"
21,"SUPPRF99862",40,76,37,6,0,77,37,31,"Pilot 11","Pilot 11: bigger feedback + video + socially anxious"
22,"SUPPRF99862",45,67,47,29,27,82,20,18,"Pilot 11","Pilot 11: bigger feedback + video + socially anxious"
23,"SUPPRF99862",49,64,78,41,24,83,54,37,"Pilot 11","Pilot 11: bigger feedback + video + socially anxious"
24,"SUPPRF99862",44,66,8,-8,-12,48,20,16,"Pilot 11","Pilot 11: bigger feedback + video + socially anxious"
25,"SUPPRF99862",49,65,55,10,1,68,54,45,"Pilot 11","Pilot 11: bigger feedback + video + socially anxious"
26,"SUPPRF99862",52,60,96,16,16,93,80,80,"Pilot 11","Pilot 11: bigger feedback + video + socially anxious"
27,"SUPPRF99862",52,58,49,14,12,68,37,35,"Pilot 11","Pilot 11: bigger feedback + video + socially anxious"
28,"SUPPRF99862",50,61,47,15,-16,73,63,32,"Pilot 11","Pilot 11: bigger feedback + video + socially anxious"
29,"SUPPRF99862",56,56,46,23,17,75,29,23,"Pilot 11","Pilot 11: bigger feedback + video + socially anxious"
30,"SUPPRF99862",57,55,80,-1,0,86,80,81,"Pilot 11","Pilot 11: bigger feedback + video + socially anxious"
31,"SUPPRF99862",54,56,61,35,24,50,37,26,"Pilot 11","Pilot 11: bigger feedback + video + socially anxious"
32,"SUPPRF99862",48,60,94,56,23,68,71,38,"Pilot 11","Pilot 11: bigger feedback + video + socially anxious"
33,"SUPPRF99862",56,53,58,17,12,75,46,41,"Pilot 11","Pilot 11: bigger feedback + video + socially anxious"
34,"SUPPRF99862",46,49,29,-7,0,74,29,36,"Pilot 11","Pilot 11: bigger feedback + video + socially anxious"
35,"SUPPRF99862",50,46,41,-20,-13,63,54,61,"Pilot 11","Pilot 11: bigger feedback + video + socially anxious"
36,"SUPPRF99862",44,52,50,23,-13,74,63,27,"Pilot 11","Pilot 11: bigger feedback + video + socially anxious"
37,"SUPPRF99862",54,45,38,-5,-16,69,54,43,"Pilot 11","Pilot 11: bigger feedback + video + socially anxious"
38,"SUPPRF99862",52,46,19,-4,-1,53,20,23,"Pilot 11","Pilot 11: bigger feedback + video + socially anxious"
39,"SUPPRF99862",37,62,88,54,25,79,63,34,"Pilot 11","Pilot 11: bigger feedback + video + socially anxious"
40,"SUPPRF99862",51,55,56,3,-15,65,71,53,"Pilot 11","Pilot 11: bigger feedback + video + socially anxious"
41,"SUPPRF99862",49,55,58,43,29,83,29,15,"Pilot 11","Pilot 11: bigger feedback + video + socially anxious"
42,"SUPPRF99862",54,50,46,8,0,79,46,38,"Pilot 11","Pilot 11: bigger feedback + video + socially anxious"
43,"SUPPRF99862",70,42,81,0,1,98,80,81,"Pilot 11","Pilot 11: bigger feedback + video + socially anxious"
44,"SUPPRF99862",54,50,20,2,0,84,20,18,"Pilot 11","Pilot 11: bigger feedback + video + socially anxious"
45,"SUPPRF99862",56,49,67,-22,-13,95,80,89,"Pilot 11","Pilot 11: bigger feedback + video + socially anxious"
46,"SUPPRF99862",47,49,16,8,-13,96,29,8,"Pilot 11","Pilot 11: bigger feedback + video + socially anxious"
47,"SUPPRF99862",56,52,55,-36,-16,94,71,91,"Pilot 11","Pilot 11: bigger feedback + video + socially anxious"
48,"SUPPRF99862",45,67,45,20,-1,73,46,25,"Pilot 11","Pilot 11: bigger feedback + video + socially anxious"
1,"SUPPRF53834",57,50,28,13,-1,98,29,15,"Pilot 11","Pilot 11: bigger feedback + video + socially anxious"
2,"SUPPRF53834",51,31,35,18,15,88,20,17,"Pilot 11","Pilot 11: bigger feedback + video + socially anxious"
3,"SUPPRF53834",53,32,37,4,0,44,37,33,"Pilot 11","Pilot 11: bigger feedback + video + socially anxious"
4,"SUPPRF53834",60,18,100,51,20,60,80,49,"Pilot 11","Pilot 11: bigger feedback + video + socially anxious"
5,"SUPPRF53834",54,24,62,4,-1,67,63,58,"Pilot 11","Pilot 11: bigger feedback + video + socially anxious"
6,"SUPPRF53834",55,10,75,33,29,80,46,42,"Pilot 11","Pilot 11: bigger feedback + video + socially anxious"
7,"SUPPRF53834",58,8,94,57,23,75,71,37,"Pilot 11","Pilot 11: bigger feedback + video + socially anxious"
8,"SUPPRF53834",62,6,54,-10,0,29,54,64,"Pilot 11","Pilot 11: bigger feedback + video + socially anxious"
9,"SUPPRF53834",59,11,67,-12,-13,80,80,79,"Pilot 11","Pilot 11: bigger feedback + video + socially anxious"
10,"SUPPRF53834",60,7,19,5,-1,92,20,14,"Pilot 11","Pilot 11: bigger feedback + video + socially anxious"
11,"SUPPRF53834",69,3,88,49,25,78,63,39,"Pilot 11","Pilot 11: bigger feedback + video + socially anxious"
12,"SUPPRF53834",63,4,16,-5,-13,92,29,21,"Pilot 11","Pilot 11: bigger feedback + video + socially anxious"
13,"SUPPRF53834",56,5,8,-16,-12,78,20,24,"Pilot 11","Pilot 11: bigger feedback + video + socially anxious"
14,"SUPPRF53834",53,3,46,15,0,76,46,31,"Pilot 11","Pilot 11: bigger feedback + video + socially anxious"
15,"SUPPRF53834",60,11,38,-13,-16,89,54,51,"Pilot 11","Pilot 11: bigger feedback + video + socially anxious"
16,"SUPPRF53834",48,5,61,20,24,59,37,41,"Pilot 11","Pilot 11: bigger feedback + video + socially anxious"
17,"SUPPRF53834",54,2,22,-13,-15,89,37,35,"Pilot 11","Pilot 11: bigger feedback + video + socially anxious"
18,"SUPPRF53834",60,1,47,-8,-16,49,63,55,"Pilot 11","Pilot 11: bigger feedback + video + socially anxious"
19,"SUPPRF53834",65,1,77,11,14,64,63,66,"Pilot 11","Pilot 11: bigger feedback + video + socially anxious"
20,"SUPPRF53834",51,1,38,-12,1,84,37,50,"Pilot 11","Pilot 11: bigger feedback + video + socially anxious"
21,"SUPPRF53834",58,4,34,-12,-12,26,46,46,"Pilot 11","Pilot 11: bigger feedback + video + socially anxious"
22,"SUPPRF53834",60,2,47,21,27,91,20,26,"Pilot 11","Pilot 11: bigger feedback + video + socially anxious"
23,"SUPPRF53834",51,0,56,-20,-15,75,71,76,"Pilot 11","Pilot 11: bigger feedback + video + socially anxious"
24,"SUPPRF53834",49,0,6,-15,-14,91,20,21,"Pilot 11","Pilot 11: bigger feedback + video + socially anxious"
25,"SUPPRF53834",53,0,70,-8,-1,63,71,78,"Pilot 11","Pilot 11: bigger feedback + video + socially anxious"
26,"SUPPRF53834",56,0,71,1,0,72,71,70,"Pilot 11","Pilot 11: bigger feedback + video + socially anxious"
27,"SUPPRF53834",57,2,45,-10,-1,50,46,55,"Pilot 11","Pilot 11: bigger feedback + video + socially anxious"
28,"SUPPRF53834",58,1,49,21,12,87,37,28,"Pilot 11","Pilot 11: bigger feedback + video + socially anxious"
29,"SUPPRF53834",52,4,24,-5,-13,90,37,29,"Pilot 11","Pilot 11: bigger feedback + video + socially anxious"
30,"SUPPRF53834",55,1,41,-3,-13,61,54,44,"Pilot 11","Pilot 11: bigger feedback + video + socially anxious"
31,"SUPPRF53834",52,32,46,12,17,39,29,34,"Pilot 11","Pilot 11: bigger feedback + video + socially anxious"
32,"SUPPRF53834",51,15,66,26,12,22,54,40,"Pilot 11","Pilot 11: bigger feedback + video + socially anxious"
33,"SUPPRF53834",56,5,58,30,29,82,29,28,"Pilot 11","Pilot 11: bigger feedback + video + socially anxious"
34,"SUPPRF53834",57,3,15,-7,-14,66,29,22,"Pilot 11","Pilot 11: bigger feedback + video + socially anxious"
35,"SUPPRF53834",50,2,50,-1,-13,72,63,51,"Pilot 11","Pilot 11: bigger feedback + video + socially anxious"
36,"SUPPRF53834",45,7,63,8,0,69,63,55,"Pilot 11","Pilot 11: bigger feedback + video + socially anxious"
37,"SUPPRF53834",51,11,55,-15,-16,59,71,70,"Pilot 11","Pilot 11: bigger feedback + video + socially anxious"
38,"SUPPRF53834",56,5,80,12,0,18,80,68,"Pilot 11","Pilot 11: bigger feedback + video + socially anxious"
39,"SUPPRF53834",48,8,33,-22,-13,7,46,55,"Pilot 11","Pilot 11: bigger feedback + video + socially anxious"
40,"SUPPRF53834",51,6,29,-1,0,32,29,30,"Pilot 11","Pilot 11: bigger feedback + video + socially anxious"
41,"SUPPRF53834",41,9,20,9,0,93,20,11,"Pilot 11","Pilot 11: bigger feedback + video + socially anxious"
42,"SUPPRF53834",49,18,96,25,16,62,80,71,"Pilot 11","Pilot 11: bigger feedback + video + socially anxious"
43,"SUPPRF53834",47,17,58,29,12,12,46,29,"Pilot 11","Pilot 11: bigger feedback + video + socially anxious"
44,"SUPPRF53834",47,13,83,23,12,78,71,60,"Pilot 11","Pilot 11: bigger feedback + video + socially anxious"
45,"SUPPRF53834",59,10,78,8,24,88,54,70,"Pilot 11","Pilot 11: bigger feedback + video + socially anxious"
46,"SUPPRF53834",59,4,81,-7,1,77,80,88,"Pilot 11","Pilot 11: bigger feedback + video + socially anxious"
47,"SUPPRF53834",47,11,55,-9,1,24,54,64,"Pilot 11","Pilot 11: bigger feedback + video + socially anxious"
48,"SUPPRF53834",50,6,68,0,-12,75,80,68,"Pilot 11","Pilot 11: bigger feedback + video + socially anxious"
1,"SUPPRF08067",48,46,55,5,1,50,54,50,"Pilot 11","Pilot 11: bigger feedback + video + socially anxious"
2,"SUPPRF08067",51,40,63,7,0,49,63,56,"Pilot 11","Pilot 11: bigger feedback + video + socially anxious"
3,"SUPPRF08067",28,29,6,-23,-14,70,20,29,"Pilot 11","Pilot 11: bigger feedback + video + socially anxious"
4,"SUPPRF08067",72,22,96,12,16,77,80,84,"Pilot 11","Pilot 11: bigger feedback + video + socially anxious"
5,"SUPPRF08067",49,11,46,-11,0,48,46,57,"Pilot 11","Pilot 11: bigger feedback + video + socially anxious"
6,"SUPPRF08067",46,14,29,-38,0,48,29,67,"Pilot 11","Pilot 11: bigger feedback + video + socially anxious"
7,"SUPPRF08067",50,12,67,20,-13,48,80,47,"Pilot 11","Pilot 11: bigger feedback + video + socially anxious"
8,"SUPPRF08067",49,7,77,27,14,46,63,50,"Pilot 11","Pilot 11: bigger feedback + video + socially anxious"
9,"SUPPRF08067",60,5,54,7,0,48,54,47,"Pilot 11","Pilot 11: bigger feedback + video + socially anxious"
10,"SUPPRF08067",59,10,38,-11,-16,48,54,49,"Pilot 11","Pilot 11: bigger feedback + video + socially anxious"
11,"SUPPRF08067",51,10,45,15,-1,53,46,30,"Pilot 11","Pilot 11: bigger feedback + video + socially anxious"
12,"SUPPRF08067",20,2,24,-28,-13,43,37,52,"Pilot 11","Pilot 11: bigger feedback + video + socially anxious"
13,"SUPPRF08067",28,0,35,-16,15,48,20,51,"Pilot 11","Pilot 11: bigger feedback + video + socially anxious"
14,"SUPPRF08067",25,1,62,29,-1,37,63,33,"Pilot 11","Pilot 11: bigger feedback + video + socially anxious"
15,"SUPPRF08067",23,0,20,-1,0,49,20,21,"Pilot 11","Pilot 11: bigger feedback + video + socially anxious"
16,"SUPPRF08067",31,1,37,7,0,69,37,30,"Pilot 11","Pilot 11: bigger feedback + video + socially anxious"
17,"SUPPRF08067",24,0,41,-16,-13,73,54,57,"Pilot 11","Pilot 11: bigger feedback + video + socially anxious"
18,"SUPPRF08067",36,1,28,3,-1,51,29,25,"Pilot 11","Pilot 11: bigger feedback + video + socially anxious"
19,"SUPPRF08067",51,1,70,30,-1,50,71,40,"Pilot 11","Pilot 11: bigger feedback + video + socially anxious"
20,"SUPPRF08067",32,0,15,-5,-14,62,29,20,"Pilot 11","Pilot 11: bigger feedback + video + socially anxious"
21,"SUPPRF08067",61,1,58,26,29,46,29,32,"Pilot 11","Pilot 11: bigger feedback + video + socially anxious"
22,"SUPPRF08067",51,2,83,43,12,50,71,40,"Pilot 11","Pilot 11: bigger feedback + video + socially anxious"
23,"SUPPRF08067",69,0,47,40,27,50,20,7,"Pilot 11","Pilot 11: bigger feedback + video + socially anxious"
24,"SUPPRF08067",60,0,68,29,-12,43,80,39,"Pilot 11","Pilot 11: bigger feedback + video + socially anxious"
25,"SUPPRF08067",52,0,46,-2,17,46,29,48,"Pilot 11","Pilot 11: bigger feedback + video + socially anxious"
26,"SUPPRF08067",33,5,50,15,-13,13,63,35,"Pilot 11","Pilot 11: bigger feedback + video + socially anxious"
27,"SUPPRF08067",78,0,100,28,20,76,80,72,"Pilot 11","Pilot 11: bigger feedback + video + socially anxious"
28,"SUPPRF08067",73,2,8,-21,-12,63,20,29,"Pilot 11","Pilot 11: bigger feedback + video + socially anxious"
29,"SUPPRF08067",60,0,33,-16,-13,49,46,49,"Pilot 11","Pilot 11: bigger feedback + video + socially anxious"
30,"SUPPRF08067",35,1,16,-33,-13,49,29,49,"Pilot 11","Pilot 11: bigger feedback + video + socially anxious"
31,"SUPPRF08067",53,0,71,22,0,37,71,49,"Pilot 11","Pilot 11: bigger feedback + video + socially anxious"
32,"SUPPRF08067",65,1,81,31,1,36,80,50,"Pilot 11","Pilot 11: bigger feedback + video + socially anxious"
33,"SUPPRF08067",71,0,61,22,24,66,37,39,"Pilot 11","Pilot 11: bigger feedback + video + socially anxious"
34,"SUPPRF08067",52,0,75,25,29,49,46,50,"Pilot 11","Pilot 11: bigger feedback + video + socially anxious"
35,"SUPPRF08067",40,1,49,5,12,46,37,44,"Pilot 11","Pilot 11: bigger feedback + video + socially anxious"
36,"SUPPRF08067",59,0,34,-15,-12,49,46,49,"Pilot 11","Pilot 11: bigger feedback + video + socially anxious"
37,"SUPPRF08067",50,1,55,7,-16,49,71,48,"Pilot 11","Pilot 11: bigger feedback + video + socially anxious"
38,"SUPPRF08067",47,1,94,38,23,34,71,56,"Pilot 11","Pilot 11: bigger feedback + video + socially anxious"
39,"SUPPRF08067",48,1,56,6,-15,49,71,50,"Pilot 11","Pilot 11: bigger feedback + video + socially anxious"
40,"SUPPRF08067",37,0,19,-10,-1,61,20,29,"Pilot 11","Pilot 11: bigger feedback + video + socially anxious"
41,"SUPPRF08067",51,0,80,31,0,47,80,49,"Pilot 11","Pilot 11: bigger feedback + video + socially anxious"
42,"SUPPRF08067",55,0,66,5,12,54,54,61,"Pilot 11","Pilot 11: bigger feedback + video + socially anxious"
43,"SUPPRF08067",53,0,47,3,-16,31,63,44,"Pilot 11","Pilot 11: bigger feedback + video + socially anxious"
44,"SUPPRF08067",52,0,78,17,24,68,54,61,"Pilot 11","Pilot 11: bigger feedback + video + socially anxious"
45,"SUPPRF08067",57,0,58,9,12,39,46,49,"Pilot 11","Pilot 11: bigger feedback + video + socially anxious"
46,"SUPPRF08067",56,0,38,0,1,46,37,38,"Pilot 11","Pilot 11: bigger feedback + video + socially anxious"
47,"SUPPRF08067",76,0,88,42,25,66,63,46,"Pilot 11","Pilot 11: bigger feedback + video + socially anxious"
48,"SUPPRF08067",54,0,22,-25,-15,47,37,47,"Pilot 11","Pilot 11: bigger feedback + video + socially anxious"
1,"SUPPRF54483",64,74,77,52,14,79,63,25,"Pilot 11","Pilot 11: bigger feedback + video + socially anxious"
2,"SUPPRF54483",63,75,66,30,12,84,54,36,"Pilot 11","Pilot 11: bigger feedback + video + socially anxious"
3,"SUPPRF54483",54,46,75,38,29,67,46,37,"Pilot 11","Pilot 11: bigger feedback + video + socially anxious"
4,"SUPPRF54483",70,10,96,92,16,98,80,4,"Pilot 11","Pilot 11: bigger feedback + video + socially anxious"
5,"SUPPRF54483",50,27,68,39,-12,57,80,29,"Pilot 11","Pilot 11: bigger feedback + video + socially anxious"
6,"SUPPRF54483",65,24,46,-13,17,14,29,59,"Pilot 11","Pilot 11: bigger feedback + video + socially anxious"
7,"SUPPRF54483",59,16,15,0,-14,98,29,15,"Pilot 11","Pilot 11: bigger feedback + video + socially anxious"
8,"SUPPRF54483",57,11,83,37,12,78,71,46,"Pilot 11","Pilot 11: bigger feedback + video + socially anxious"
9,"SUPPRF54483",54,33,41,-13,-13,78,54,54,"Pilot 11","Pilot 11: bigger feedback + video + socially anxious"
10,"SUPPRF54483",68,74,20,2,0,11,20,18,"Pilot 11","Pilot 11: bigger feedback + video + socially anxious"
11,"SUPPRF54483",59,62,88,25,25,13,63,63,"Pilot 11","Pilot 11: bigger feedback + video + socially anxious"
12,"SUPPRF54483",53,34,46,13,0,88,46,33,"Pilot 11","Pilot 11: bigger feedback + video + socially anxious"
13,"SUPPRF54483",46,30,8,-15,-12,99,20,23,"Pilot 11","Pilot 11: bigger feedback + video + socially anxious"
14,"SUPPRF54483",52,64,28,6,-1,70,29,22,"Pilot 11","Pilot 11: bigger feedback + video + socially anxious"
15,"SUPPRF54483",58,37,55,13,1,72,54,42,"Pilot 11","Pilot 11: bigger feedback + video + socially anxious"
16,"SUPPRF54483",58,58,19,16,-1,98,20,3,"Pilot 11","Pilot 11: bigger feedback + video + socially anxious"
17,"SUPPRF54483",52,68,55,2,-16,84,71,53,"Pilot 11","Pilot 11: bigger feedback + video + socially anxious"
18,"SUPPRF54483",67,31,100,42,20,37,80,58,"Pilot 11","Pilot 11: bigger feedback + video + socially anxious"
19,"SUPPRF54483",63,30,62,-6,-1,63,63,68,"Pilot 11","Pilot 11: bigger feedback + video + socially anxious"
20,"SUPPRF54483",56,36,16,1,-13,95,29,15,"Pilot 11","Pilot 11: bigger feedback + video + socially anxious"
21,"SUPPRF54483",51,57,94,28,23,31,71,66,"Pilot 11","Pilot 11: bigger feedback + video + socially anxious"
22,"SUPPRF54483",50,39,47,-1,-16,73,63,48,"Pilot 11","Pilot 11: bigger feedback + video + socially anxious"
23,"SUPPRF54483",48,34,56,-7,-15,98,71,63,"Pilot 11","Pilot 11: bigger feedback + video + socially anxious"
24,"SUPPRF54483",23,57,6,-10,-14,97,20,16,"Pilot 11","Pilot 11: bigger feedback + video + socially anxious"
25,"SUPPRF54483",57,27,71,27,0,8,71,44,"Pilot 11","Pilot 11: bigger feedback + video + socially anxious"
26,"SUPPRF54483",67,33,58,6,12,32,46,52,"Pilot 11","Pilot 11: bigger feedback + video + socially anxious"
27,"SUPPRF54483",43,49,34,19,-12,93,46,15,"Pilot 11","Pilot 11: bigger feedback + video + socially anxious"
28,"SUPPRF54483",71,13,38,35,1,93,37,3,"Pilot 11","Pilot 11: bigger feedback + video + socially anxious"
29,"SUPPRF54483",88,32,80,9,0,85,80,71,"Pilot 11","Pilot 11: bigger feedback + video + socially anxious"
30,"SUPPRF54483",61,20,70,45,-1,76,71,25,"Pilot 11","Pilot 11: bigger feedback + video + socially anxious"
31,"SUPPRF54483",80,26,67,6,-13,88,80,61,"Pilot 11","Pilot 11: bigger feedback + video + socially anxious"
32,"SUPPRF54483",54,39,37,-11,0,24,37,48,"Pilot 11","Pilot 11: bigger feedback + video + socially anxious"
33,"SUPPRF54483",70,23,58,34,29,94,29,24,"Pilot 11","Pilot 11: bigger feedback + video + socially anxious"
34,"SUPPRF54483",68,25,47,31,27,65,20,16,"Pilot 11","Pilot 11: bigger feedback + video + socially anxious"
35,"SUPPRF54483",83,24,81,71,1,94,80,10,"Pilot 11","Pilot 11: bigger feedback + video + socially anxious"
36,"SUPPRF54483",13,47,24,-41,-13,96,37,65,"Pilot 11","Pilot 11: bigger feedback + video + socially anxious"
37,"SUPPRF54483",71,32,50,48,-13,98,63,2,"Pilot 11","Pilot 11: bigger feedback + video + socially anxious"
38,"SUPPRF54483",60,24,63,8,0,29,63,55,"Pilot 11","Pilot 11: bigger feedback + video + socially anxious"
39,"SUPPRF54483",52,17,78,37,24,85,54,41,"Pilot 11","Pilot 11: bigger feedback + video + socially anxious"
40,"SUPPRF54483",52,19,45,19,-1,93,46,26,"Pilot 11","Pilot 11: bigger feedback + video + socially anxious"
41,"SUPPRF54483",61,23,61,33,24,57,37,28,"Pilot 11","Pilot 11: bigger feedback + video + socially anxious"
42,"SUPPRF54483",39,16,22,-34,-15,8,37,56,"Pilot 11","Pilot 11: bigger feedback + video + socially anxious"
43,"SUPPRF54483",57,30,35,23,15,78,20,12,"Pilot 11","Pilot 11: bigger feedback + video + socially anxious"
44,"SUPPRF54483",52,29,38,-16,-16,62,54,54,"Pilot 11","Pilot 11: bigger feedback + video + socially anxious"
45,"SUPPRF54483",38,32,49,-1,12,89,37,50,"Pilot 11","Pilot 11: bigger feedback + video + socially anxious"
46,"SUPPRF54483",52,34,54,0,0,86,54,54,"Pilot 11","Pilot 11: bigger feedback + video + socially anxious"
47,"SUPPRF54483",50,24,29,6,0,27,29,23,"Pilot 11","Pilot 11: bigger feedback + video + socially anxious"
48,"SUPPRF54483",33,55,33,-14,-13,76,46,47,"Pilot 11","Pilot 11: bigger feedback + video + socially anxious"
1,"SUPPRF76395",61,61,100,38,20,38,80,62,"Pilot 11","Pilot 11: bigger feedback + video + socially anxious"
2,"SUPPRF76395",63,57,80,-4,0,61,80,84,"Pilot 11","Pilot 11: bigger feedback + video + socially anxious"
3,"SUPPRF76395",62,60,20,-42,0,27,20,62,"Pilot 11","Pilot 11: bigger feedback + video + socially anxious"
4,"SUPPRF76395",63,61,50,4,-13,38,63,46,"Pilot 11","Pilot 11: bigger feedback + video + socially anxious"
5,"SUPPRF76395",79,56,58,47,29,30,29,11,"Pilot 11","Pilot 11: bigger feedback + video + socially anxious"
6,"SUPPRF76395",61,54,29,-7,0,20,29,36,"Pilot 11","Pilot 11: bigger feedback + video + socially anxious"
7,"SUPPRF76395",62,52,63,43,0,22,63,20,"Pilot 11","Pilot 11: bigger feedback + video + socially anxious"
8,"SUPPRF76395",50,52,35,-2,15,29,20,37,"Pilot 11","Pilot 11: bigger feedback + video + socially anxious"
9,"SUPPRF76395",66,60,56,-8,-15,40,71,64,"Pilot 11","Pilot 11: bigger feedback + video + socially anxious"
10,"SUPPRF76395",56,65,8,-15,-12,4,20,23,"Pilot 11","Pilot 11: bigger feedback + video + socially anxious"
11,"SUPPRF76395",48,64,33,15,-13,6,46,18,"Pilot 11","Pilot 11: bigger feedback + video + socially anxious"
12,"SUPPRF76395",53,68,47,35,-16,24,63,12,"Pilot 11","Pilot 11: bigger feedback + video + socially anxious"
13,"SUPPRF76395",56,69,81,66,1,5,80,15,"Pilot 11","Pilot 11: bigger feedback + video + socially anxious"
14,"SUPPRF76395",71,61,77,24,14,41,63,53,"Pilot 11","Pilot 11: bigger feedback + video + socially anxious"
15,"SUPPRF76395",59,49,88,53,25,41,63,35,"Pilot 11","Pilot 11: bigger feedback + video + socially anxious"
16,"SUPPRF76395",58,54,46,29,0,40,46,17,"Pilot 11","Pilot 11: bigger feedback + video + socially anxious"
17,"SUPPRF76395",60,52,6,-7,-14,3,20,13,"Pilot 11","Pilot 11: bigger feedback + video + socially anxious"
18,"SUPPRF76395",68,55,62,46,-1,25,63,16,"Pilot 11","Pilot 11: bigger feedback + video + socially anxious"
19,"SUPPRF76395",61,65,15,-19,-14,30,29,34,"Pilot 11","Pilot 11: bigger feedback + video + socially anxious"
20,"SUPPRF76395",75,58,70,36,-1,37,71,34,"Pilot 11","Pilot 11: bigger feedback + video + socially anxious"
21,"SUPPRF76395",86,64,28,-12,-1,30,29,40,"Pilot 11","Pilot 11: bigger feedback + video + socially anxious"
22,"SUPPRF76395",48,69,16,-26,-13,11,29,42,"Pilot 11","Pilot 11: bigger feedback + video + socially anxious"
23,"SUPPRF76395",84,67,54,47,0,14,54,7,"Pilot 11","Pilot 11: bigger feedback + video + socially anxious"
24,"SUPPRF76395",46,65,19,16,-1,52,20,3,"Pilot 11","Pilot 11: bigger feedback + video + socially anxious"
25,"SUPPRF76395",75,72,34,-2,-12,50,46,36,"Pilot 11","Pilot 11: bigger feedback + video + socially anxious"
26,"SUPPRF76395",83,55,96,41,16,39,80,55,"Pilot 11","Pilot 11: bigger feedback + video + socially anxious"
27,"SUPPRF76395",52,75,38,-11,-16,55,54,49,"Pilot 11","Pilot 11: bigger feedback + video + socially anxious"
28,"SUPPRF76395",68,76,46,15,17,15,29,31,"Pilot 11","Pilot 11: bigger feedback + video + socially anxious"
29,"SUPPRF76395",77,62,55,14,-16,18,71,41,"Pilot 11","Pilot 11: bigger feedback + video + socially anxious"
30,"SUPPRF76395",88,57,75,34,29,26,46,41,"Pilot 11","Pilot 11: bigger feedback + video + socially anxious"
31,"SUPPRF76395",66,72,41,-6,-13,17,54,47,"Pilot 11","Pilot 11: bigger feedback + video + socially anxious"
32,"SUPPRF76395",62,75,67,23,-13,14,80,44,"Pilot 11","Pilot 11: bigger feedback + video + socially anxious"
33,"SUPPRF76395",89,66,78,40,24,9,54,38,"Pilot 11","Pilot 11: bigger feedback + video + socially anxious"
34,"SUPPRF76395",85,65,61,29,24,1,37,32,"Pilot 11","Pilot 11: bigger feedback + video + socially anxious"
35,"SUPPRF76395",68,66,55,11,1,5,54,44,"Pilot 11","Pilot 11: bigger feedback + video + socially anxious"
36,"SUPPRF76395",57,70,68,-17,-12,30,80,85,"Pilot 11","Pilot 11: bigger feedback + video + socially anxious"
37,"SUPPRF76395",90,68,71,43,0,16,71,28,"Pilot 11","Pilot 11: bigger feedback + video + socially anxious"
38,"SUPPRF76395",85,52,47,27,27,4,20,20,"Pilot 11","Pilot 11: bigger feedback + video + socially anxious"
39,"SUPPRF76395",88,69,38,19,1,3,37,19,"Pilot 11","Pilot 11: bigger feedback + video + socially anxious"
40,"SUPPRF76395",66,56,45,14,-1,8,46,31,"Pilot 11","Pilot 11: bigger feedback + video + socially anxious"
41,"SUPPRF76395",68,57,49,35,12,4,37,14,"Pilot 11","Pilot 11: bigger feedback + video + socially anxious"
42,"SUPPRF76395",56,57,24,-8,-13,9,37,32,"Pilot 11","Pilot 11: bigger feedback + video + socially anxious"
43,"SUPPRF76395",77,59,58,39,12,34,46,19,"Pilot 11","Pilot 11: bigger feedback + video + socially anxious"
44,"SUPPRF76395",95,53,94,56,23,30,71,38,"Pilot 11","Pilot 11: bigger feedback + video + socially anxious"
45,"SUPPRF76395",61,70,37,7,0,37,37,30,"Pilot 11","Pilot 11: bigger feedback + video + socially anxious"
46,"SUPPRF76395",94,72,83,8,12,47,71,75,"Pilot 11","Pilot 11: bigger feedback + video + socially anxious"
47,"SUPPRF76395",72,79,22,-10,-15,48,37,32,"Pilot 11","Pilot 11: bigger feedback + video + socially anxious"
48,"SUPPRF76395",81,65,66,24,12,6,54,42,"Pilot 11","Pilot 11: bigger feedback + video + socially anxious"
