"Trial.Number","Random_ID","Response_H","Response_Ax","Response_fdbk","Response_SubjPE","Response_PE","Response_certainty","Response_m_hist","Response_pred","mini_SPIN_total","Pilot_Number","Social_Anxiety"
1,"SUPPRF31306",94,1,24,-11,-13,"61",37,35,7,9,"high"
2,"SUPPRF31306",97,3,56,-25,-15,"63",71,81,7,9,"high"
3,"SUPPRF31306",98,1,67,-6,-13,"58",80,73,7,9,"high"
4,"SUPPRF31306",98,2,22,-1,-15,"39",37,23,7,9,"high"
5,"SUPPRF31306",97,1,38,-8,-16,"32",54,46,7,9,"high"
6,"SUPPRF31306",97,2,8,-31,-12,"9",20,39,7,9,"high"
7,"SUPPRF31306",97,2,6,-11,-14,"20",20,17,7,9,"high"
8,"SUPPRF31306",97,4,16,-4,-13,"35",29,20,7,9,"high"
9,"SUPPRF31306",96,4,54,34,0,"78",54,20,7,9,"high"
10,"SUPPRF31306",97,2,100,72,20,"77",80,28,7,9,"high"
11,"SUPPRF31306",99,1,94,6,23,"90",71,88,7,9,"high"
12,"SUPPRF31306",95,4,63,2,0,"69",63,61,7,9,"high"
13,"SUPPRF31306",95,4,61,13,24,"49",37,48,7,9,"high"
14,"SUPPRF31306",94,1,41,-24,-13,"66",54,65,7,9,"high"
15,"SUPPRF31306",96,3,58,-1,12,"42",46,59,7,9,"high"
16,"SUPPRF31306",96,4,83,37,12,"58",71,46,7,9,"high"
17,"SUPPRF31306",98,3,88,75,25,"68",63,13,7,9,"high"
18,"SUPPRF31306",96,5,49,13,12,"74",37,36,7,9,"high"
19,"SUPPRF31306",19,73,50,-8,-13,"65",63,58,7,9,"high"
20,"SUPPRF31306",12,26,37,-3,0,"69",37,40,7,9,"high"
21,"SUPPRF31306",31,24,80,7,0,"53",80,73,7,9,"high"
22,"SUPPRF31306",19,24,81,17,1,"47",80,64,7,9,"high"
23,"SUPPRF31306",19,20,47,23,27,"63",20,24,7,9,"high"
24,"SUPPRF31306",13,14,78,43,24,"78",54,35,7,9,"high"
25,"SUPPRF31306",3,26,15,-33,-14,"26",29,48,7,9,"high"
26,"SUPPRF31306",8,35,58,-7,29,"54",29,65,7,9,"high"
27,"SUPPRF31306",2,41,55,1,1,"66",54,54,7,9,"high"
28,"SUPPRF31306",63,10,46,26,17,"73",29,20,7,9,"high"
29,"SUPPRF31306",2,41,70,11,-1,"61",71,59,7,9,"high"
30,"SUPPRF31306",7,75,47,-1,-16,"26",63,48,7,9,"high"
31,"SUPPRF31306",7,68,71,11,0,"57",71,60,7,9,"high"
32,"SUPPRF31306",8,77,46,13,0,"66",46,33,7,9,"high"
33,"SUPPRF31306",4,90,33,-12,-13,"100",46,45,7,9,"high"
34,"SUPPRF31306",10,93,77,24,14,"30",63,53,7,9,"high"
35,"SUPPRF31306",5,96,45,-9,-1,"78",46,54,7,9,"high"
36,"SUPPRF31306",13,100,55,-9,-16,"30",71,64,7,9,"high"
37,"SUPPRF31306",0,100,29,-35,0,"42",29,64,7,9,"high"
38,"SUPPRF31306",2,98,20,4,0,"79",20,16,7,9,"high"
39,"SUPPRF31306",3,80,28,-2,-1,"69",29,30,7,9,"high"
40,"SUPPRF31306",37,53,34,-10,-12,"60",46,44,7,9,"high"
41,"SUPPRF31306",9,96,38,-10,1,"29",37,48,7,9,"high"
42,"SUPPRF31306",0,100,96,45,16,"21",80,51,7,9,"high"
43,"SUPPRF31306",0,99,35,15,15,"100",20,20,7,9,"high"
44,"SUPPRF31306",6,100,68,-3,-12,"22",80,71,7,9,"high"
45,"SUPPRF31306",0,100,19,-2,-1,"72",20,21,7,9,"high"
46,"SUPPRF31306",0,89,66,11,12,"65",54,55,7,9,"high"
47,"SUPPRF31306",0,100,75,27,29,"74",46,48,7,9,"high"
48,"SUPPRF31306",0,84,62,-13,-1,"74",63,75,7,9,"high"
1,"SUPPRF86350",49,68,61,25,24,"45",37,36,11,9,"high"
2,"SUPPRF86350",68,37,94,13,23,"67",71,81,11,9,"high"
3,"SUPPRF86350",29,52,55,-18,-16,"73",71,73,11,9,"high"
4,"SUPPRF86350",65,37,78,18,24,"53",54,60,11,9,"high"
5,"SUPPRF86350",48,44,20,-13,0,"29",20,33,11,9,"high"
6,"SUPPRF86350",30,51,22,-28,-15,"36",37,50,11,9,"high"
7,"SUPPRF86350",58,47,71,-12,0,"71",71,83,11,9,"high"
8,"SUPPRF86350",27,12,8,-54,-12,"64",20,62,11,9,"high"
9,"SUPPRF86350",53,42,62,-1,-1,"41",63,63,11,9,"high"
10,"SUPPRF86350",65,51,16,-14,-13,"43",29,30,11,9,"high"
11,"SUPPRF86350",99,21,100,63,20,"18",80,37,11,9,"high"
12,"SUPPRF86350",55,60,58,12,12,"54",46,46,11,9,"high"
13,"SUPPRF86350",51,23,88,30,25,"9",63,58,11,9,"high"
14,"SUPPRF86350",76,25,81,4,1,"67",80,77,11,9,"high"
15,"SUPPRF86350",50,30,41,-23,-13,"67",54,64,11,9,"high"
16,"SUPPRF86350",50,50,34,-21,-12,"32",46,55,11,9,"high"
17,"SUPPRF86350",76,50,77,27,14,"15",63,50,11,9,"high"
18,"SUPPRF86350",30,42,70,-6,-1,"75",71,76,11,9,"high"
19,"SUPPRF86350",51,53,46,19,17,"16",29,27,11,9,"high"
20,"SUPPRF86350",52,56,46,12,0,"66",46,34,11,9,"high"
21,"SUPPRF86350",53,50,50,-6,-13,"65",63,56,11,9,"high"
22,"SUPPRF86350",21,58,6,-23,-14,"58",20,29,11,9,"high"
23,"SUPPRF86350",48,57,49,17,12,"30",37,32,11,9,"high"
24,"SUPPRF86350",46,48,54,-8,0,"53",54,62,11,9,"high"
25,"SUPPRF86350",51,50,38,1,1,"54",37,37,11,9,"high"
26,"SUPPRF86350",3,93,15,-20,-14,"32",29,35,11,9,"high"
27,"SUPPRF86350",12,54,75,29,29,"31",46,46,11,9,"high"
28,"SUPPRF86350",43,37,56,-18,-15,"61",71,74,11,9,"high"
29,"SUPPRF86350",49,37,37,-8,0,"50",37,45,11,9,"high"
30,"SUPPRF86350",39,54,29,-19,0,"48",29,48,11,9,"high"
31,"SUPPRF86350",46,46,83,17,12,"53",71,66,11,9,"high"
32,"SUPPRF86350",50,46,68,14,-12,"53",80,54,11,9,"high"
33,"SUPPRF86350",49,45,47,-2,27,"51",20,49,11,9,"high"
34,"SUPPRF86350",46,51,24,-32,-13,"59",37,56,11,9,"high"
35,"SUPPRF86350",53,47,67,-5,-13,"66",80,72,11,9,"high"
36,"SUPPRF86350",47,52,35,-19,15,"49",20,54,11,9,"high"
37,"SUPPRF86350",53,50,28,-29,-1,"50",29,57,11,9,"high"
38,"SUPPRF86350",49,54,38,-10,-16,"59",54,48,11,9,"high"
39,"SUPPRF86350",53,49,47,0,-16,"28",63,47,11,9,"high"
40,"SUPPRF86350",1,50,33,-14,-13,"43",46,47,11,9,"high"
41,"SUPPRF86350",80,50,80,29,0,"47",80,51,11,9,"high"
42,"SUPPRF86350",97,52,96,34,16,"50",80,62,11,9,"high"
43,"SUPPRF86350",64,68,19,-52,-1,"70",20,71,11,9,"high"
44,"SUPPRF86350",59,64,63,2,0,"64",63,61,11,9,"high"
45,"SUPPRF86350",59,60,58,15,29,"46",29,43,11,9,"high"
46,"SUPPRF86350",54,65,45,-5,-1,"66",46,50,11,9,"high"
47,"SUPPRF86350",55,61,55,4,1,"48",54,51,11,9,"high"
48,"SUPPRF86350",61,66,66,20,12,"78",54,46,11,9,"high"
1,"SUPPRF93485",62,2,71,-10,0,"86",71,81,8,9,"high"
2,"SUPPRF93485",46,3,50,-6,-13,"71",63,56,8,9,"high"
3,"SUPPRF93485",57,17,96,58,16,"53",80,38,8,9,"high"
4,"SUPPRF93485",23,0,28,-23,-1,"77",29,51,8,9,"high"
5,"SUPPRF93485",26,7,16,-46,-13,"45",29,62,8,9,"high"
6,"SUPPRF93485",30,7,6,-10,-14,"78",20,16,8,9,"high"
7,"SUPPRF93485",34,21,47,-24,-16,"73",63,71,8,9,"high"
8,"SUPPRF93485",34,22,38,7,1,"78",37,31,8,9,"high"
9,"SUPPRF93485",69,3,63,8,0,"45",63,55,8,9,"high"
10,"SUPPRF93485",48,4,45,21,-1,"45",46,24,8,9,"high"
11,"SUPPRF93485",76,28,46,-3,17,"58",29,49,8,9,"high"
12,"SUPPRF93485",62,17,19,-39,-1,"43",20,58,8,9,"high"
13,"SUPPRF93485",46,47,34,-26,-12,"43",46,60,8,9,"high"
14,"SUPPRF93485",57,51,49,-18,12,"26",37,67,8,9,"high"
15,"SUPPRF93485",100,9,100,14,20,"60",80,86,8,9,"high"
16,"SUPPRF93485",41,48,22,-32,-15,"39",37,54,8,9,"high"
17,"SUPPRF93485",34,5,67,24,-13,"44",80,43,8,9,"high"
18,"SUPPRF93485",64,0,68,6,-12,"68",80,62,8,9,"high"
19,"SUPPRF93485",70,7,56,4,-15,"35",71,52,8,9,"high"
20,"SUPPRF93485",41,66,66,7,12,"39",54,59,8,9,"high"
21,"SUPPRF93485",68,39,54,30,0,"52",54,24,8,9,"high"
22,"SUPPRF93485",45,16,58,10,29,"29",29,48,8,9,"high"
23,"SUPPRF93485",64,48,55,6,-16,"39",71,49,8,9,"high"
24,"SUPPRF93485",70,11,94,31,23,"14",71,63,8,9,"high"
25,"SUPPRF93485",78,4,78,29,24,"30",54,49,8,9,"high"
26,"SUPPRF93485",80,15,38,-25,-16,"21",54,63,8,9,"high"
27,"SUPPRF93485",70,51,20,-44,0,"58",20,64,8,9,"high"
28,"SUPPRF93485",77,48,77,38,14,"57",63,39,8,9,"high"
29,"SUPPRF93485",75,54,46,16,0,"47",46,30,8,9,"high"
30,"SUPPRF93485",77,20,80,-5,0,"81",80,85,8,9,"high"
31,"SUPPRF93485",69,16,15,-16,-14,"51",29,31,8,9,"high"
32,"SUPPRF93485",61,37,29,3,0,"22",29,26,8,9,"high"
33,"SUPPRF93485",36,11,33,-21,-13,"25",46,54,8,9,"high"
34,"SUPPRF93485",56,13,61,34,24,"38",37,27,8,9,"high"
35,"SUPPRF93485",71,11,47,-11,27,"41",20,58,8,9,"high"
36,"SUPPRF93485",81,53,83,33,12,"47",71,50,8,9,"high"
37,"SUPPRF93485",75,10,35,22,15,"45",20,13,8,9,"high"
38,"SUPPRF93485",80,0,55,5,1,"73",54,50,8,9,"high"
39,"SUPPRF93485",77,0,41,-7,-13,"62",54,48,8,9,"high"
40,"SUPPRF93485",74,25,62,15,-1,"65",63,47,8,9,"high"
41,"SUPPRF93485",73,21,37,7,0,"63",37,30,8,9,"high"
42,"SUPPRF93485",78,17,75,17,29,"75",46,58,8,9,"high"
43,"SUPPRF93485",73,16,58,28,12,"58",46,30,8,9,"high"
44,"SUPPRF93485",78,19,88,21,25,"53",63,67,8,9,"high"
45,"SUPPRF93485",75,0,24,4,-13,"61",37,20,8,9,"high"
46,"SUPPRF93485",83,11,8,-8,-12,"76",20,16,8,9,"high"
47,"SUPPRF93485",81,5,81,38,1,"12",80,43,8,9,"high"
48,"SUPPRF93485",80,5,70,-2,-1,"87",71,72,8,9,"high"
1,"SUPPRF70813",75,27,77,16,14,"50",63,61,11,9,"high"
2,"SUPPRF70813",71,31,19,-19,-1,"67",20,38,11,9,"high"
3,"SUPPRF70813",61,24,37,0,0,"62",37,37,11,9,"high"
4,"SUPPRF70813",70,32,34,-34,-12,"58",46,68,11,9,"high"
5,"SUPPRF70813",74,21,71,6,0,"47",71,65,11,9,"high"
6,"SUPPRF70813",74,28,20,-43,0,"71",20,63,11,9,"high"
7,"SUPPRF70813",81,29,45,6,-1,"69",46,39,11,9,"high"
8,"SUPPRF70813",75,19,96,56,16,"65",80,40,11,9,"high"
9,"SUPPRF70813",83,22,61,0,24,"31",37,61,11,9,"high"
10,"SUPPRF70813",73,29,38,-29,1,"83",37,67,11,9,"high"
11,"SUPPRF70813",65,27,15,-13,-14,"65",29,28,11,9,"high"
12,"SUPPRF70813",75,27,49,17,12,"69",37,32,11,9,"high"
13,"SUPPRF70813",72,26,94,72,23,"69",71,22,11,9,"high"
14,"SUPPRF70813",74,21,66,43,12,"74",54,23,11,9,"high"
15,"SUPPRF70813",69,27,75,28,29,"72",46,47,11,9,"high"
16,"SUPPRF70813",68,26,78,9,24,"52",54,69,11,9,"high"
17,"SUPPRF70813",69,27,47,-5,-16,"76",63,52,11,9,"high"
18,"SUPPRF70813",69,26,55,-11,1,"79",54,66,11,9,"high"
19,"SUPPRF70813",65,33,58,21,29,"65",29,37,11,9,"high"
20,"SUPPRF70813",75,22,80,7,0,"63",80,73,11,9,"high"
21,"SUPPRF70813",62,25,56,-10,-15,"85",71,66,11,9,"high"
22,"SUPPRF70813",77,32,55,35,-16,"26",71,20,11,9,"high"
23,"SUPPRF70813",58,25,88,25,25,"75",63,63,11,9,"high"
24,"SUPPRF70813",65,31,28,-12,-1,"67",29,40,11,9,"high"
25,"SUPPRF70813",68,32,22,-40,-15,"33",37,62,11,9,"high"
26,"SUPPRF70813",73,32,38,-11,-16,"29",54,49,11,9,"high"
27,"SUPPRF70813",64,33,50,20,-13,"69",63,30,11,9,"high"
28,"SUPPRF70813",69,28,83,15,12,"49",71,68,11,9,"high"
29,"SUPPRF70813",65,31,16,-49,-13,"47",29,65,11,9,"high"
30,"SUPPRF70813",67,25,81,14,1,"30",80,67,11,9,"high"
31,"SUPPRF70813",57,33,35,-9,15,"68",20,44,11,9,"high"
32,"SUPPRF70813",70,25,100,48,20,"63",80,52,11,9,"high"
33,"SUPPRF70813",66,34,29,-36,0,"30",29,65,11,9,"high"
34,"SUPPRF70813",65,29,70,14,-1,"61",71,56,11,9,"high"
35,"SUPPRF70813",61,26,67,25,-13,"65",80,42,11,9,"high"
36,"SUPPRF70813",73,23,58,28,12,"72",46,30,11,9,"high"
37,"SUPPRF70813",67,33,8,-11,-12,"68",20,19,11,9,"high"
38,"SUPPRF70813",67,26,46,-19,17,"69",29,65,11,9,"high"
39,"SUPPRF70813",60,23,68,37,-12,"63",80,31,11,9,"high"
40,"SUPPRF70813",67,34,47,-18,27,"76",20,65,11,9,"high"
41,"SUPPRF70813",65,27,33,-13,-13,"68",46,46,11,9,"high"
42,"SUPPRF70813",72,32,63,24,0,"72",63,39,11,9,"high"
43,"SUPPRF70813",72,31,6,-51,-14,"65",20,57,11,9,"high"
44,"SUPPRF70813",72,29,41,-17,-13,"76",54,58,11,9,"high"
45,"SUPPRF70813",66,25,54,-10,0,"72",54,64,11,9,"high"
46,"SUPPRF70813",59,32,24,-36,-13,"65",37,60,11,9,"high"
47,"SUPPRF70813",61,34,46,-8,0,"67",46,54,11,9,"high"
48,"SUPPRF70813",70,35,62,5,-1,"68",63,57,11,9,"high"
1,"SUPPRF86378",67,12,66,36,12,"82",54,30,3,9,"low"
2,"SUPPRF86378",83,19,61,18,24,"76",37,43,3,9,"low"
3,"SUPPRF86378",55,16,20,-42,0,"72",20,62,3,9,"low"
4,"SUPPRF86378",51,15,37,-14,0,"68",37,51,3,9,"low"
5,"SUPPRF86378",53,20,34,-11,-12,"63",46,45,3,9,"low"
6,"SUPPRF86378",51,35,35,21,15,"57",20,14,3,9,"low"
7,"SUPPRF86378",63,23,19,-8,-1,"60",20,27,3,9,"low"
8,"SUPPRF86378",73,17,71,38,0,"32",71,33,3,9,"low"
9,"SUPPRF86378",92,6,100,49,20,"53",80,51,3,9,"low"
10,"SUPPRF86378",77,12,41,-2,-13,"61",54,43,3,9,"low"
11,"SUPPRF86378",80,11,83,14,12,"76",71,69,3,9,"low"
12,"SUPPRF86378",72,14,28,5,-1,"62",29,23,3,9,"low"
13,"SUPPRF86378",83,10,81,13,1,"72",80,68,3,9,"low"
14,"SUPPRF86378",84,15,54,13,0,"60",54,41,3,9,"low"
15,"SUPPRF86378",90,10,38,-15,1,"54",37,53,3,9,"low"
16,"SUPPRF86378",84,8,75,42,29,"50",46,33,3,9,"low"
17,"SUPPRF86378",91,10,38,-7,-16,"70",54,45,3,9,"low"
18,"SUPPRF86378",91,13,47,28,27,"78",20,19,3,9,"low"
19,"SUPPRF86378",87,12,67,-11,-13,"86",80,78,3,9,"low"
20,"SUPPRF86378",83,12,50,2,-13,"42",63,48,3,9,"low"
21,"SUPPRF86378",85,10,77,30,14,"83",63,47,3,9,"low"
22,"SUPPRF86378",83,20,56,-18,-15,"66",71,74,3,9,"low"
23,"SUPPRF86378",85,16,55,9,1,"29",54,46,3,9,"low"
24,"SUPPRF86378",85,12,29,10,0,"50",29,19,3,9,"low"
25,"SUPPRF86378",84,10,62,26,-1,"71",63,36,3,9,"low"
26,"SUPPRF86378",84,20,22,-28,-15,"33",37,50,3,9,"low"
27,"SUPPRF86378",79,15,47,14,-16,"55",63,33,3,9,"low"
28,"SUPPRF86378",18,22,33,-7,-13,"61",46,40,3,9,"low"
29,"SUPPRF86378",70,11,80,5,0,"73",80,75,3,9,"low"
30,"SUPPRF86378",79,23,6,-14,-14,"73",20,20,3,9,"low"
31,"SUPPRF86378",80,13,45,2,-1,"58",46,43,3,9,"low"
32,"SUPPRF86378",79,14,63,5,0,"77",63,58,3,9,"low"
33,"SUPPRF86378",75,19,58,1,12,"66",46,57,3,9,"low"
34,"SUPPRF86378",82,23,96,31,16,"66",80,65,3,9,"low"
35,"SUPPRF86378",85,20,68,52,-12,"78",80,16,3,9,"low"
36,"SUPPRF86378",81,4,55,-10,-16,"89",71,65,3,9,"low"
37,"SUPPRF86378",67,15,94,24,23,"65",71,70,3,9,"low"
38,"SUPPRF86378",79,22,46,-6,0,"47",46,52,3,9,"low"
39,"SUPPRF86378",75,32,78,34,24,"69",54,44,3,9,"low"
40,"SUPPRF86378",78,22,8,-8,-12,"65",20,16,3,9,"low"
41,"SUPPRF86378",82,11,16,-16,-13,"56",29,32,3,9,"low"
42,"SUPPRF86378",82,22,58,31,29,"38",29,27,3,9,"low"
43,"SUPPRF86378",72,21,15,-12,-14,"42",29,27,3,9,"low"
44,"SUPPRF86378",86,14,88,47,25,"50",63,41,3,9,"low"
45,"SUPPRF86378",84,24,49,13,12,"57",37,36,3,9,"low"
46,"SUPPRF86378",76,12,70,-5,-1,"82",71,75,3,9,"low"
47,"SUPPRF86378",83,24,24,-10,-13,"48",37,34,3,9,"low"
48,"SUPPRF86378",92,25,46,25,17,"41",29,21,3,9,"low"
1,"SUPPRF66344",47,0,38,-7,-16,"48",54,45,1,9,"low"
2,"SUPPRF66344",48,0,58,35,12,"0",46,23,1,9,"low"
3,"SUPPRF66344",47,0,96,37,16,"45",80,59,1,9,"low"
4,"SUPPRF66344",48,0,35,18,15,"74",20,17,1,9,"low"
5,"SUPPRF66344",49,0,24,-21,-13,"0",37,45,1,9,"low"
6,"SUPPRF66344",47,0,15,-19,-14,"46",29,34,1,9,"low"
7,"SUPPRF66344",47,0,8,-13,-12,"0",20,21,1,9,"low"
8,"SUPPRF66344",47,0,94,39,23,"0",71,55,1,9,"low"
9,"SUPPRF66344",48,0,63,7,0,"0",63,56,1,9,"low"
10,"SUPPRF66344",48,0,47,-9,-16,"2",63,56,1,9,"low"
11,"SUPPRF66344",46,0,62,10,-1,"0",63,52,1,9,"low"
12,"SUPPRF66344",47,0,47,28,27,"0",20,19,1,9,"low"
13,"SUPPRF66344",48,0,34,8,-12,"0",46,26,1,9,"low"
14,"SUPPRF66344",49,0,22,-14,-15,"0",37,36,1,9,"low"
15,"SUPPRF66344",49,0,54,12,0,"0",54,42,1,9,"low"
16,"SUPPRF66344",47,0,77,39,14,"0",63,38,1,9,"low"
17,"SUPPRF66344",48,0,41,-23,-13,"50",54,64,1,9,"low"
18,"SUPPRF66344",48,0,68,3,-12,"0",80,65,1,9,"low"
19,"SUPPRF66344",49,0,19,-29,-1,"0",20,48,1,9,"low"
20,"SUPPRF66344",47,0,28,2,-1,"0",29,26,1,9,"low"
21,"SUPPRF66344",47,0,6,-18,-14,"0",20,24,1,9,"low"
22,"SUPPRF66344",49,0,45,13,-1,"0",46,32,1,9,"low"
23,"SUPPRF66344",46,0,78,41,24,"0",54,37,1,9,"low"
24,"SUPPRF66344",46,0,38,9,1,"0",37,29,1,9,"low"
25,"SUPPRF66344",47,0,81,27,1,"45",80,54,1,9,"low"
26,"SUPPRF66344",47,0,58,9,29,"34",29,49,1,9,"low"
27,"SUPPRF66344",50,0,50,-2,-13,"47",63,52,1,9,"low"
28,"SUPPRF66344",49,0,33,-16,-13,"48",46,49,1,9,"low"
29,"SUPPRF66344",47,0,55,7,1,"0",54,48,1,9,"low"
30,"SUPPRF66344",48,0,61,12,24,"5",37,49,1,9,"low"
31,"SUPPRF66344",48,0,66,25,12,"6",54,41,1,9,"low"
32,"SUPPRF66344",46,0,75,54,29,"49",46,21,1,9,"low"
33,"SUPPRF66344",48,0,55,-6,-16,"39",71,61,1,9,"low"
34,"SUPPRF66344",49,0,83,31,12,"45",71,52,1,9,"low"
35,"SUPPRF66344",50,0,20,-7,0,"43",20,27,1,9,"low"
36,"SUPPRF66344",47,0,70,20,-1,"45",71,50,1,9,"low"
37,"SUPPRF66344",45,0,29,4,0,"47",29,25,1,9,"low"
38,"SUPPRF66344",66,0,100,37,20,"47",80,63,1,9,"low"
39,"SUPPRF66344",50,0,67,11,-13,"50",80,56,1,9,"low"
40,"SUPPRF66344",49,0,37,-9,0,"4",37,46,1,9,"low"
41,"SUPPRF66344",48,0,80,12,0,"48",80,68,1,9,"low"
42,"SUPPRF66344",48,0,46,7,0,"49",46,39,1,9,"low"
43,"SUPPRF66344",49,0,88,41,25,"7",63,47,1,9,"low"
44,"SUPPRF66344",47,0,56,-1,-15,"46",71,57,1,9,"low"
45,"SUPPRF66344",50,0,46,23,17,"46",29,23,1,9,"low"
46,"SUPPRF66344",49,0,16,-3,-13,"46",29,19,1,9,"low"
47,"SUPPRF66344",48,0,49,25,12,"45",37,24,1,9,"low"
48,"SUPPRF66344",47,0,71,15,0,"2",71,56,1,9,"low"
1,"SUPPRF60832",27,72,41,-19,-13,"62",54,60,6,9,"high"
2,"SUPPRF60832",96,1,100,11,20,"89",80,89,6,9,"high"
3,"SUPPRF60832",18,85,34,7,-12,"77",46,27,6,9,"high"
4,"SUPPRF60832",9,86,49,19,12,"81",37,30,6,9,"high"
5,"SUPPRF60832",68,43,58,17,12,"83",46,41,6,9,"high"
6,"SUPPRF60832",18,68,38,11,-16,"47",54,27,6,9,"high"
7,"SUPPRF60832",83,25,55,49,1,"49",54,6,6,9,"high"
8,"SUPPRF60832",64,35,47,-7,-16,"35",63,54,6,9,"high"
9,"SUPPRF60832",84,12,68,1,-12,"30",80,67,6,9,"high"
10,"SUPPRF60832",77,31,61,44,24,"75",37,17,6,9,"high"
11,"SUPPRF60832",1,99,15,-56,-14,"59",29,71,6,9,"high"
12,"SUPPRF60832",32,59,19,5,-1,"91",20,14,6,9,"high"
13,"SUPPRF60832",76,34,55,22,-16,"45",71,33,6,9,"high"
14,"SUPPRF60832",3,98,6,-16,-14,"13",20,22,6,9,"high"
15,"SUPPRF60832",98,4,96,30,16,"80",80,66,6,9,"high"
16,"SUPPRF60832",92,8,78,36,24,"25",54,42,6,9,"high"
17,"SUPPRF60832",24,86,28,-17,-1,"51",29,45,6,9,"high"
18,"SUPPRF60832",21,72,37,-27,0,"14",37,64,6,9,"high"
19,"SUPPRF60832",74,27,71,15,0,"33",71,56,6,9,"high"
20,"SUPPRF60832",84,28,77,32,14,"49",63,45,6,9,"high"
21,"SUPPRF60832",65,32,47,26,27,"76",20,21,6,9,"high"
22,"SUPPRF60832",67,31,58,-13,29,"80",29,71,6,9,"high"
23,"SUPPRF60832",81,31,75,23,29,"58",46,52,6,9,"high"
24,"SUPPRF60832",69,23,63,-5,0,"82",63,68,6,9,"high"
25,"SUPPRF60832",5,92,16,-38,-13,"35",29,54,6,9,"high"
26,"SUPPRF60832",61,42,56,5,-15,"53",71,51,6,9,"high"
27,"SUPPRF60832",72,32,50,16,-13,"19",63,34,6,9,"high"
28,"SUPPRF60832",79,34,66,20,12,"30",54,46,6,9,"high"
29,"SUPPRF60832",70,25,67,-5,-13,"71",80,72,6,9,"high"
30,"SUPPRF60832",18,65,38,-16,1,"20",37,54,6,9,"high"
31,"SUPPRF60832",71,16,83,60,12,"9",71,23,6,9,"high"
32,"SUPPRF60832",80,30,62,-3,-1,"26",63,65,6,9,"high"
33,"SUPPRF60832",98,1,70,2,-1,"1",71,68,6,9,"high"
34,"SUPPRF60832",12,85,24,-14,-13,"36",37,38,6,9,"high"
35,"SUPPRF60832",20,84,22,-12,-15,"56",37,34,6,9,"high"
36,"SUPPRF60832",98,1,94,49,23,"1",71,45,6,9,"high"
37,"SUPPRF60832",2,97,8,-15,-12,"84",20,23,6,9,"high"
38,"SUPPRF60832",61,33,33,-2,-13,"16",46,35,6,9,"high"
39,"SUPPRF60832",88,11,80,26,0,"16",80,54,6,9,"high"
40,"SUPPRF60832",96,10,81,31,1,"61",80,50,6,9,"high"
41,"SUPPRF60832",72,39,35,19,15,"87",20,16,6,9,"high"
42,"SUPPRF60832",41,53,20,-5,0,"71",20,25,6,9,"high"
43,"SUPPRF60832",75,24,46,22,0,"86",46,24,6,9,"high"
44,"SUPPRF60832",39,70,46,17,17,"30",29,29,6,9,"high"
45,"SUPPRF60832",93,16,88,29,25,"21",63,59,6,9,"high"
46,"SUPPRF60832",63,34,54,-13,0,"44",54,67,6,9,"high"
47,"SUPPRF60832",58,43,45,-7,-1,"71",46,52,6,9,"high"
48,"SUPPRF60832",70,26,29,1,0,"77",29,28,6,9,"high"
1,"SUPPRF79935",29,29,55,32,1,"41",54,23,9,9,"high"
2,"SUPPRF79935",30,26,63,-16,0,"79",63,79,9,9,"high"
3,"SUPPRF79935",30,31,33,-46,-13,"69",46,79,9,9,"high"
4,"SUPPRF79935",31,29,75,20,29,"60",46,55,9,9,"high"
5,"SUPPRF79935",31,28,71,-8,0,"73",71,79,9,9,"high"
6,"SUPPRF79935",28,30,66,-3,12,"69",54,69,9,9,"high"
7,"SUPPRF79935",33,34,88,22,25,"70",63,66,9,9,"high"
8,"SUPPRF79935",31,27,58,19,29,"48",29,39,9,9,"high"
9,"SUPPRF79935",28,31,70,-5,-1,"70",71,75,9,9,"high"
10,"SUPPRF79935",33,31,19,-31,-1,"53",20,50,9,9,"high"
11,"SUPPRF79935",31,34,46,-2,17,"46",29,48,9,9,"high"
12,"SUPPRF79935",28,28,35,-43,15,"77",20,78,9,9,"high"
13,"SUPPRF79935",22,25,45,22,-1,"24",46,23,9,9,"high"
14,"SUPPRF79935",28,29,96,62,16,"41",80,34,9,9,"high"
15,"SUPPRF79935",27,22,34,-51,-12,"80",46,85,9,9,"high"
16,"SUPPRF79935",18,19,68,47,-12,"42",80,21,9,9,"high"
17,"SUPPRF79935",22,22,6,-16,-14,"22",20,22,9,9,"high"
18,"SUPPRF79935",25,25,55,28,-16,"27",71,27,9,9,"high"
19,"SUPPRF79935",22,23,47,21,27,"51",20,26,9,9,"high"
20,"SUPPRF79935",27,26,46,-29,0,"69",46,75,9,9,"high"
21,"SUPPRF79935",31,36,77,45,14,"51",63,32,9,9,"high"
22,"SUPPRF79935",29,26,38,-44,-16,"85",54,82,9,9,"high"
23,"SUPPRF79935",34,36,41,-29,-13,"63",54,70,9,9,"high"
24,"SUPPRF79935",51,50,24,-43,-13,"73",37,67,9,9,"high"
25,"SUPPRF79935",32,35,62,-21,-1,"84",63,83,9,9,"high"
26,"SUPPRF79935",32,42,61,-14,24,"68",37,75,9,9,"high"
27,"SUPPRF79935",37,45,67,26,-13,"55",80,41,9,9,"high"
28,"SUPPRF79935",21,31,100,28,20,"71",80,72,9,9,"high"
29,"SUPPRF79935",34,33,81,31,1,"47",80,50,9,9,"high"
30,"SUPPRF79935",30,30,49,-17,12,"70",37,66,9,9,"high"
31,"SUPPRF79935",33,32,16,-64,-13,"87",29,80,9,9,"high"
32,"SUPPRF79935",34,35,56,-37,-15,"84",71,93,9,9,"high"
33,"SUPPRF79935",35,37,38,-31,1,"82",37,69,9,9,"high"
34,"SUPPRF79935",37,57,78,17,24,"65",54,61,9,9,"high"
35,"SUPPRF79935",24,28,28,-6,-1,"31",29,34,9,9,"high"
36,"SUPPRF79935",30,33,58,-3,12,"67",46,61,9,9,"high"
37,"SUPPRF79935",40,46,54,16,0,"42",54,38,9,9,"high"
38,"SUPPRF79935",23,32,37,-2,0,"40",37,39,9,9,"high"
39,"SUPPRF79935",27,27,20,-6,0,"23",20,26,9,9,"high"
40,"SUPPRF79935",31,37,83,51,12,"35",71,32,9,9,"high"
41,"SUPPRF79935",20,29,50,23,-13,"33",63,27,9,9,"high"
42,"SUPPRF79935",36,47,80,36,0,"51",80,44,9,9,"high"
43,"SUPPRF79935",30,27,47,2,-16,"52",63,45,9,9,"high"
44,"SUPPRF79935",42,38,29,-21,0,"48",29,50,9,9,"high"
45,"SUPPRF79935",32,33,15,-12,-14,"70",29,27,9,9,"high"
46,"SUPPRF79935",23,25,8,-87,-12,"87",20,95,9,9,"high"
47,"SUPPRF79935",30,31,94,57,23,"41",71,37,9,9,"high"
48,"SUPPRF79935",24,25,22,-3,-15,"29",37,25,9,9,"high"
1,"SUPPRF35697",48,33,35,7,15,"65",20,28,1,9,"low"
2,"SUPPRF35697",60,27,55,1,1,"55",54,54,1,9,"low"
3,"SUPPRF35697",58,41,38,-17,1,"44",37,55,1,9,"low"
4,"SUPPRF35697",52,28,47,18,27,"61",20,29,1,9,"low"
5,"SUPPRF35697",48,41,28,-26,-1,"50",29,54,1,9,"low"
6,"SUPPRF35697",42,32,100,68,20,"25",80,32,1,9,"low"
7,"SUPPRF35697",57,37,46,-5,17,"44",29,51,1,9,"low"
8,"SUPPRF35697",56,39,70,11,-1,"41",71,59,1,9,"low"
9,"SUPPRF35697",40,30,6,-55,-14,"40",20,61,1,9,"low"
10,"SUPPRF35697",52,47,22,-34,-15,"38",37,56,1,9,"low"
11,"SUPPRF35697",52,38,24,-33,-13,"42",37,57,1,9,"low"
12,"SUPPRF35697",36,46,15,-30,-14,"43",29,45,1,9,"low"
13,"SUPPRF35697",46,38,45,-3,-1,"34",46,48,1,9,"low"
14,"SUPPRF35697",39,44,33,-15,-13,"55",46,48,1,9,"low"
15,"SUPPRF35697",43,38,81,11,1,"56",80,70,1,9,"low"
16,"SUPPRF35697",37,50,29,-20,0,"48",29,49,1,9,"low"
17,"SUPPRF35697",49,47,34,33,-12,"1",46,1,1,9,"low"
18,"SUPPRF35697",39,50,38,-13,-16,"50",54,51,1,9,"low"
19,"SUPPRF35697",48,50,88,36,25,"50",63,52,1,9,"low"
20,"SUPPRF35697",57,48,63,18,0,"57",63,45,1,9,"low"
21,"SUPPRF35697",51,58,56,-3,-15,"59",71,59,1,9,"low"
22,"SUPPRF35697",54,45,8,-17,-12,"55",20,25,1,9,"low"
23,"SUPPRF35697",57,42,50,5,-13,"60",63,45,1,9,"low"
24,"SUPPRF35697",55,46,83,22,12,"55",71,61,1,9,"low"
25,"SUPPRF35697",40,48,16,-20,-13,"55",29,36,1,9,"low"
26,"SUPPRF35697",57,64,67,-15,-13,"73",80,82,1,9,"low"
27,"SUPPRF35697",52,48,75,14,29,"45",46,61,1,9,"low"
28,"SUPPRF35697",64,31,94,16,23,"70",71,78,1,9,"low"
29,"SUPPRF35697",52,46,66,8,12,"52",54,58,1,9,"low"
30,"SUPPRF35697",36,40,54,0,0,"53",54,54,1,9,"low"
31,"SUPPRF35697",41,55,55,-10,-16,"49",71,65,1,9,"low"
32,"SUPPRF35697",30,57,20,-2,0,"62",20,22,1,9,"low"
33,"SUPPRF35697",44,39,37,-10,0,"33",37,47,1,9,"low"
34,"SUPPRF35697",51,43,61,-2,24,"43",37,63,1,9,"low"
35,"SUPPRF35697",54,45,49,3,12,"51",37,46,1,9,"low"
36,"SUPPRF35697",49,51,77,34,14,"57",63,43,1,9,"low"
37,"SUPPRF35697",71,37,80,5,0,"56",80,75,1,9,"low"
38,"SUPPRF35697",50,64,68,12,-12,"55",80,56,1,9,"low"
39,"SUPPRF35697",59,47,47,-28,-16,"74",63,75,1,9,"low"
40,"SUPPRF35697",53,43,41,-15,-13,"44",54,56,1,9,"low"
41,"SUPPRF35697",49,41,46,-14,0,"39",46,60,1,9,"low"
42,"SUPPRF35697",43,52,58,12,29,"41",29,46,1,9,"low"
43,"SUPPRF35697",41,51,58,9,12,"38",46,49,1,9,"low"
44,"SUPPRF35697",42,50,71,24,0,"36",71,47,1,9,"low"
45,"SUPPRF35697",45,56,62,8,-1,"41",63,54,1,9,"low"
46,"SUPPRF35697",27,51,19,-5,-1,"24",20,24,1,9,"low"
47,"SUPPRF35697",53,44,78,29,24,"40",54,49,1,9,"low"
48,"SUPPRF35697",71,34,96,23,16,"71",80,73,1,9,"low"
1,"SUPPRF37035",48,46,45,8,-1,"31",46,37,6,9,"high"
2,"SUPPRF37035",45,45,19,-1,-1,"97",20,20,6,9,"high"
3,"SUPPRF37035",49,49,20,4,0,"41",20,16,6,9,"high"
4,"SUPPRF37035",47,51,49,7,12,"49",37,42,6,9,"high"
5,"SUPPRF37035",51,50,81,25,1,"48",80,56,6,9,"high"
6,"SUPPRF37035",23,26,96,20,16,"96",80,76,6,9,"high"
7,"SUPPRF37035",44,45,77,36,14,"39",63,41,6,9,"high"
8,"SUPPRF37035",49,48,71,19,0,"71",71,52,6,9,"high"
9,"SUPPRF37035",57,52,88,22,25,"96",63,66,6,9,"high"
10,"SUPPRF37035",49,56,61,10,24,"80",37,51,6,9,"high"
11,"SUPPRF37035",49,50,8,-8,-12,"85",20,16,6,9,"high"
12,"SUPPRF37035",51,53,38,1,-16,"49",54,37,6,9,"high"
13,"SUPPRF37035",51,54,78,26,24,"55",54,52,6,9,"high"
14,"SUPPRF37035",51,53,41,-21,-13,"84",54,62,6,9,"high"
15,"SUPPRF37035",55,57,58,15,12,"41",46,43,6,9,"high"
16,"SUPPRF37035",59,53,50,1,-13,"71",63,49,6,9,"high"
17,"SUPPRF37035",54,52,83,29,12,"85",71,54,6,9,"high"
18,"SUPPRF37035",49,49,24,-9,-13,"86",37,33,6,9,"high"
19,"SUPPRF37035",48,51,22,-2,-15,"95",37,24,6,9,"high"
20,"SUPPRF37035",55,57,54,7,0,"89",54,47,6,9,"high"
21,"SUPPRF37035",52,55,56,2,-15,"81",71,54,6,9,"high"
22,"SUPPRF37035",45,49,35,19,15,"92",20,16,6,9,"high"
23,"SUPPRF37035",59,59,75,37,29,"81",46,38,6,9,"high"
24,"SUPPRF37035",48,54,55,10,1,"86",54,45,6,9,"high"
25,"SUPPRF37035",53,63,58,27,29,"84",29,31,6,9,"high"
26,"SUPPRF37035",21,79,67,-12,-13,"86",80,79,6,9,"high"
27,"SUPPRF37035",52,44,33,-30,-13,"60",46,63,6,9,"high"
28,"SUPPRF37035",53,51,100,72,20,"31",80,28,6,9,"high"
29,"SUPPRF37035",51,55,70,28,-1,"44",71,42,6,9,"high"
30,"SUPPRF37035",50,50,15,-20,-14,"71",29,35,6,9,"high"
31,"SUPPRF37035",55,55,66,15,12,"55",54,51,6,9,"high"
32,"SUPPRF37035",55,53,37,-10,0,"82",37,47,6,9,"high"
33,"SUPPRF37035",50,49,47,12,27,"33",20,35,6,9,"high"
34,"SUPPRF37035",52,53,47,1,-16,"69",63,46,6,9,"high"
35,"SUPPRF37035",51,50,28,-8,-1,"84",29,36,6,9,"high"
36,"SUPPRF37035",47,50,68,42,-12,"81",80,26,6,9,"high"
37,"SUPPRF37035",51,49,55,-2,-16,"57",71,57,6,9,"high"
38,"SUPPRF37035",55,54,34,-14,-12,"82",46,48,6,9,"high"
39,"SUPPRF37035",50,51,38,-15,1,"83",37,53,6,9,"high"
40,"SUPPRF37035",50,48,80,-1,0,"79",80,81,6,9,"high"
41,"SUPPRF37035",52,56,46,-10,17,"53",29,56,6,9,"high"
42,"SUPPRF37035",52,50,46,-2,0,"52",46,48,6,9,"high"
43,"SUPPRF37035",52,56,16,-39,-13,"59",29,55,6,9,"high"
44,"SUPPRF37035",54,54,29,5,0,"86",29,24,6,9,"high"
45,"SUPPRF37035",49,53,6,-12,-14,"84",20,18,6,9,"high"
46,"SUPPRF37035",62,58,94,32,23,"67",71,62,6,9,"high"
47,"SUPPRF37035",52,61,63,12,0,"77",63,51,6,9,"high"
48,"SUPPRF37035",55,54,62,13,-1,"51",63,49,6,9,"high"
1,"SUPPRF68142",50,37,15,-11,-14,"39",29,26,0,9,"low"
2,"SUPPRF68142",49,52,75,43,29,"48",46,32,0,9,"low"
3,"SUPPRF68142",48,27,56,-1,-15,"50",71,57,0,9,"low"
4,"SUPPRF68142",52,50,22,-31,-15,"50",37,53,0,9,"low"
5,"SUPPRF68142",48,51,100,58,20,"48",80,42,0,9,"low"
6,"SUPPRF68142",47,46,77,25,14,"50",63,52,0,9,"low"
7,"SUPPRF68142",50,51,61,33,24,"33",37,28,0,9,"low"
8,"SUPPRF68142",42,45,94,31,23,"52",71,63,0,9,"low"
9,"SUPPRF68142",51,45,33,-12,-13,"45",46,45,0,9,"low"
10,"SUPPRF68142",49,49,83,29,12,"48",71,54,0,9,"low"
11,"SUPPRF68142",52,42,62,4,-1,"46",63,58,0,9,"low"
12,"SUPPRF68142",44,50,71,24,0,"50",71,47,0,9,"low"
13,"SUPPRF68142",50,48,66,11,12,"38",54,55,0,9,"low"
14,"SUPPRF68142",46,47,47,24,27,"44",20,23,0,9,"low"
15,"SUPPRF68142",49,45,46,23,17,"55",29,23,0,9,"low"
16,"SUPPRF68142",48,49,28,-20,-1,"43",29,48,0,9,"low"
17,"SUPPRF68142",52,50,38,-4,1,"30",37,42,0,9,"low"
18,"SUPPRF68142",49,48,20,-7,0,"68",20,27,0,9,"low"
19,"SUPPRF68142",47,50,47,-11,-16,"40",63,58,0,9,"low"
20,"SUPPRF68142",49,54,38,-29,-16,"50",54,67,0,9,"low"
21,"SUPPRF68142",51,45,78,23,24,"66",54,55,0,9,"low"
22,"SUPPRF68142",48,46,67,2,-13,"41",80,65,0,9,"low"
23,"SUPPRF68142",48,46,41,-11,-13,"48",54,52,0,9,"low"
24,"SUPPRF68142",49,48,58,9,12,"45",46,49,0,9,"low"
25,"SUPPRF68142",51,47,70,18,-1,"46",71,52,0,9,"low"
26,"SUPPRF68142",53,49,45,-6,-1,"48",46,51,0,9,"low"
27,"SUPPRF68142",48,46,16,-30,-13,"51",29,46,0,9,"low"
28,"SUPPRF68142",46,51,58,28,29,"71",29,30,0,9,"low"
29,"SUPPRF68142",25,22,46,-4,0,"50",46,50,0,9,"low"
30,"SUPPRF68142",38,48,68,15,-12,"49",80,53,0,9,"low"
31,"SUPPRF68142",50,31,50,1,-13,"0",63,49,0,9,"low"
32,"SUPPRF68142",50,48,88,37,25,"49",63,51,0,9,"low"
33,"SUPPRF68142",49,50,29,-25,0,"47",29,54,0,9,"low"
34,"SUPPRF68142",48,47,55,-17,-16,"69",71,72,0,9,"low"
35,"SUPPRF68142",48,43,63,15,0,"45",63,48,0,9,"low"
36,"SUPPRF68142",46,47,19,-28,-1,"2",20,47,0,9,"low"
37,"SUPPRF68142",42,42,24,-9,-13,"4",37,33,0,9,"low"
38,"SUPPRF68142",42,46,54,51,0,"63",54,3,0,9,"low"
39,"SUPPRF68142",49,46,81,36,1,"41",80,45,0,9,"low"
40,"SUPPRF68142",46,45,49,2,12,"46",37,47,0,9,"low"
41,"SUPPRF68142",47,47,34,-9,-12,"43",46,43,0,9,"low"
42,"SUPPRF68142",46,48,80,33,0,"24",80,47,0,9,"low"
43,"SUPPRF68142",44,46,35,-3,15,"14",20,38,0,9,"low"
44,"SUPPRF68142",38,42,6,-37,-14,"45",20,43,0,9,"low"
45,"SUPPRF68142",39,48,55,14,1,"59",54,41,0,9,"low"
46,"SUPPRF68142",50,45,96,45,16,"54",80,51,0,9,"low"
47,"SUPPRF68142",27,45,8,-35,-12,"46",20,43,0,9,"low"
48,"SUPPRF68142",46,48,37,-6,0,"45",37,43,0,9,"low"
1,"SUPPRF88148",51,2,94,53,23,"26",71,41,9,9,"high"
2,"SUPPRF88148",55,0,100,56,20,"14",80,44,9,9,"high"
3,"SUPPRF88148",49,2,77,26,14,"58",63,51,9,9,"high"
4,"SUPPRF88148",39,1,16,-36,-13,"15",29,52,9,9,"high"
5,"SUPPRF88148",53,2,70,13,-1,"60",71,57,9,9,"high"
6,"SUPPRF88148",47,1,29,11,0,"63",29,18,9,9,"high"
7,"SUPPRF88148",45,1,41,-7,-13,"73",54,48,9,9,"high"
8,"SUPPRF88148",65,1,45,34,-1,"74",46,11,9,9,"high"
9,"SUPPRF88148",57,3,56,-4,-15,"70",71,60,9,9,"high"
10,"SUPPRF88148",52,1,28,1,-1,"50",29,27,9,9,"high"
11,"SUPPRF88148",50,1,46,24,0,"33",46,22,9,9,"high"
12,"SUPPRF88148",54,3,71,9,0,"61",71,62,9,9,"high"
13,"SUPPRF88148",47,5,47,23,27,"35",20,24,9,9,"high"
14,"SUPPRF88148",60,1,58,40,29,"60",29,18,9,9,"high"
15,"SUPPRF88148",49,2,35,19,15,"61",20,16,9,9,"high"
16,"SUPPRF88148",53,2,81,17,1,"53",80,64,9,9,"high"
17,"SUPPRF88148",61,1,54,15,0,"47",54,39,9,9,"high"
18,"SUPPRF88148",45,0,49,20,12,"60",37,29,9,9,"high"
19,"SUPPRF88148",50,0,22,-13,-15,"60",37,35,9,9,"high"
20,"SUPPRF88148",53,1,55,8,-16,"51",71,47,9,9,"high"
21,"SUPPRF88148",44,2,38,9,1,"14",37,29,9,9,"high"
22,"SUPPRF88148",45,5,50,21,-13,"67",63,29,9,9,"high"
23,"SUPPRF88148",45,0,61,39,24,"14",37,22,9,9,"high"
24,"SUPPRF88148",43,0,38,3,-16,"44",54,35,9,9,"high"
25,"SUPPRF88148",44,1,47,18,-16,"52",63,29,9,9,"high"
26,"SUPPRF88148",52,1,80,30,0,"73",80,50,9,9,"high"
27,"SUPPRF88148",41,0,83,31,12,"53",71,52,9,9,"high"
28,"SUPPRF88148",29,1,62,31,-1,"67",63,31,9,9,"high"
29,"SUPPRF88148",45,2,67,-12,-13,"67",80,79,9,9,"high"
30,"SUPPRF88148",31,53,37,6,0,"52",37,31,9,9,"high"
31,"SUPPRF88148",57,8,78,59,24,"68",54,19,9,9,"high"
32,"SUPPRF88148",52,0,15,-5,-14,"86",29,20,9,9,"high"
33,"SUPPRF88148",35,0,88,62,25,"79",63,26,9,9,"high"
34,"SUPPRF88148",32,19,20,-4,0,"76",20,24,9,9,"high"
35,"SUPPRF88148",30,5,46,31,17,"85",29,15,9,9,"high"
36,"SUPPRF88148",25,1,33,-1,-13,"55",46,34,9,9,"high"
37,"SUPPRF88148",26,4,96,58,16,"20",80,38,9,9,"high"
38,"SUPPRF88148",26,0,19,3,-1,"63",20,16,9,9,"high"
39,"SUPPRF88148",28,2,68,62,-12,"82",80,6,9,9,"high"
40,"SUPPRF88148",29,3,55,37,1,"70",54,18,9,9,"high"
41,"SUPPRF88148",7,7,66,53,12,"88",54,13,9,9,"high"
42,"SUPPRF88148",33,7,34,-15,-12,"62",46,49,9,9,"high"
43,"SUPPRF88148",32,10,24,0,-13,"20",37,24,9,9,"high"
44,"SUPPRF88148",12,6,8,-8,-12,"20",20,16,9,9,"high"
45,"SUPPRF88148",72,1,75,43,29,"26",46,32,9,9,"high"
46,"SUPPRF88148",35,6,63,-1,0,"69",63,64,9,9,"high"
47,"SUPPRF88148",15,2,6,-7,-14,"69",20,13,9,9,"high"
48,"SUPPRF88148",21,2,58,20,12,"11",46,38,9,9,"high"
1,"SUPPRF99152",99,41,100,34,20,"26",80,66,5,9,"low"
2,"SUPPRF99152",69,37,62,-8,-1,"53",63,70,5,9,"low"
3,"SUPPRF99152",73,38,35,5,15,"59",20,30,5,9,"low"
4,"SUPPRF99152",52,49,19,-11,-1,"26",20,30,5,9,"low"
5,"SUPPRF99152",37,52,22,-18,-15,"50",37,40,5,9,"low"
6,"SUPPRF99152",28,62,24,-26,-13,"50",37,50,5,9,"low"
7,"SUPPRF99152",55,44,58,14,12,"43",46,44,5,9,"low"
8,"SUPPRF99152",62,37,71,12,0,"36",71,59,5,9,"low"
9,"SUPPRF99152",65,37,78,28,24,"25",54,50,5,9,"low"
10,"SUPPRF99152",74,35,58,14,29,"28",29,44,5,9,"low"
11,"SUPPRF99152",50,50,41,-24,-13,"62",54,65,5,9,"low"
12,"SUPPRF99152",40,54,16,-14,-13,"26",29,30,5,9,"low"
13,"SUPPRF99152",64,31,47,19,27,"29",20,28,5,9,"low"
14,"SUPPRF99152",52,42,50,-10,-13,"25",63,60,5,9,"low"
15,"SUPPRF99152",57,35,54,0,0,"37",54,54,5,9,"low"
16,"SUPPRF99152",49,52,29,-11,0,"24",29,40,5,9,"low"
17,"SUPPRF99152",69,33,88,33,25,"45",63,55,5,9,"low"
18,"SUPPRF99152",52,53,28,-12,-1,"55",29,40,5,9,"low"
19,"SUPPRF99152",81,31,96,46,16,"33",80,50,5,9,"low"
20,"SUPPRF99152",48,51,33,-17,-13,"44",46,50,5,9,"low"
21,"SUPPRF99152",55,45,38,-8,1,"42",37,46,5,9,"low"
22,"SUPPRF99152",55,37,46,16,17,"18",29,30,5,9,"low"
23,"SUPPRF99152",59,35,61,17,24,"35",37,44,5,9,"low"
24,"SUPPRF99152",68,41,37,-5,0,"39",37,42,5,9,"low"
25,"SUPPRF99152",68,45,66,12,12,"56",54,54,5,9,"low"
26,"SUPPRF99152",72,25,81,14,1,"41",80,67,5,9,"low"
27,"SUPPRF99152",69,26,49,-2,12,"21",37,51,5,9,"low"
28,"SUPPRF99152",56,47,45,16,-1,"34",46,29,5,9,"low"
29,"SUPPRF99152",54,52,38,-14,-16,"53",54,52,5,9,"low"
30,"SUPPRF99152",66,33,56,2,-15,"26",71,54,5,9,"low"
31,"SUPPRF99152",67,46,20,0,0,"53",20,20,5,9,"low"
32,"SUPPRF99152",67,35,55,0,1,"71",54,55,5,9,"low"
33,"SUPPRF99152",69,43,46,11,0,"56",46,35,5,9,"low"
34,"SUPPRF99152",67,44,83,33,12,"43",71,50,5,9,"low"
35,"SUPPRF99152",61,33,67,-4,-13,"59",80,71,5,9,"low"
36,"SUPPRF99152",68,31,68,-4,-12,"60",80,72,5,9,"low"
37,"SUPPRF99152",64,37,63,15,0,"40",63,48,5,9,"low"
38,"SUPPRF99152",56,50,15,-17,-14,"56",29,32,5,9,"low"
39,"SUPPRF99152",64,41,70,6,-1,"33",71,64,5,9,"low"
40,"SUPPRF99152",72,32,75,27,29,"58",46,48,5,9,"low"
41,"SUPPRF99152",57,44,55,-17,-16,"40",71,72,5,9,"low"
42,"SUPPRF99152",55,49,47,-11,-16,"30",63,58,5,9,"low"
43,"SUPPRF99152",83,26,94,21,23,"57",71,73,5,9,"low"
44,"SUPPRF99152",39,66,6,-24,-14,"31",20,30,5,9,"low"
45,"SUPPRF99152",24,65,8,-17,-12,"27",20,25,5,9,"low"
46,"SUPPRF99152",50,50,34,-6,-12,"36",46,40,5,9,"low"
47,"SUPPRF99152",63,47,80,-1,0,"50",80,81,5,9,"low"
48,"SUPPRF99152",66,46,77,26,14,"32",63,51,5,9,"low"
1,"SUPPRF85444",66,66,58,-7,29,"27",29,65,5,9,"low"
2,"SUPPRF85444",34,75,29,-25,0,"63",29,54,5,9,"low"
3,"SUPPRF85444",57,62,47,25,27,"63",20,22,5,9,"low"
4,"SUPPRF85444",84,30,88,5,25,"79",63,83,5,9,"low"
5,"SUPPRF85444",67,40,80,18,0,"57",80,62,5,9,"low"
6,"SUPPRF85444",67,26,83,1,12,"86",71,82,5,9,"low"
7,"SUPPRF85444",63,33,22,-11,-15,"71",37,33,5,9,"low"
8,"SUPPRF85444",54,27,28,-7,-1,"55",29,35,5,9,"low"
9,"SUPPRF85444",64,19,38,9,1,"57",37,29,5,9,"low"
10,"SUPPRF85444",67,8,66,2,12,"78",54,64,5,9,"low"
11,"SUPPRF85444",26,22,15,-17,-14,"66",29,32,5,9,"low"
12,"SUPPRF85444",75,4,62,-8,-1,"71",63,70,5,9,"low"
13,"SUPPRF85444",77,2,68,28,-12,"40",80,40,5,9,"low"
14,"SUPPRF85444",82,2,49,41,12,"38",37,8,5,9,"low"
15,"SUPPRF85444",67,2,70,-7,-1,"81",71,77,5,9,"low"
16,"SUPPRF85444",88,0,78,12,24,"66",54,66,5,9,"low"
17,"SUPPRF85444",94,0,35,16,15,"51",20,19,5,9,"low"
18,"SUPPRF85444",30,1,24,-29,-13,"63",37,53,5,9,"low"
19,"SUPPRF85444",50,4,41,-24,-13,"54",54,65,5,9,"low"
20,"SUPPRF85444",77,1,67,-12,-13,"79",80,79,5,9,"low"
21,"SUPPRF85444",75,0,61,25,24,"38",37,36,5,9,"low"
22,"SUPPRF85444",69,1,37,-2,0,"70",37,39,5,9,"low"
23,"SUPPRF85444",80,0,75,43,29,"59",46,32,5,9,"low"
24,"SUPPRF85444",85,0,100,27,20,"78",80,73,5,9,"low"
25,"SUPPRF85444",76,1,77,17,14,"78",63,60,5,9,"low"
26,"SUPPRF85444",77,1,63,-3,0,"83",63,66,5,9,"low"
27,"SUPPRF85444",92,1,96,16,16,"84",80,80,5,9,"low"
28,"SUPPRF85444",76,1,20,-39,0,"80",20,59,5,9,"low"
29,"SUPPRF85444",86,1,45,7,-1,"38",46,38,5,9,"low"
30,"SUPPRF85444",27,1,34,-16,-12,"72",46,50,5,9,"low"
31,"SUPPRF85444",90,0,81,5,1,"71",80,76,5,9,"low"
32,"SUPPRF85444",86,0,54,-1,0,"85",54,55,5,9,"low"
33,"SUPPRF85444",79,1,38,-17,-16,"76",54,55,5,9,"low"
34,"SUPPRF85444",80,1,58,2,12,"72",46,56,5,9,"low"
35,"SUPPRF85444",80,0,6,-16,-14,"78",20,22,5,9,"low"
36,"SUPPRF85444",62,2,56,17,-15,"55",71,39,5,9,"low"
37,"SUPPRF85444",54,2,55,-14,1,"73",54,69,5,9,"low"
38,"SUPPRF85444",77,1,71,20,0,"27",71,51,5,9,"low"
39,"SUPPRF85444",78,1,46,10,17,"73",29,36,5,9,"low"
40,"SUPPRF85444",19,0,19,-24,-1,"75",20,43,5,9,"low"
41,"SUPPRF85444",23,0,47,-4,-16,"76",63,51,5,9,"low"
42,"SUPPRF85444",92,1,94,39,23,"78",71,55,5,9,"low"
43,"SUPPRF85444",22,1,46,-19,0,"33",46,65,5,9,"low"
44,"SUPPRF85444",14,0,8,-43,-12,"67",20,51,5,9,"low"
45,"SUPPRF85444",19,1,33,-19,-13,"29",46,52,5,9,"low"
46,"SUPPRF85444",9,0,55,-4,-16,"78",71,59,5,9,"low"
47,"SUPPRF85444",10,0,50,-5,-13,"31",63,55,5,9,"low"
48,"SUPPRF85444",6,1,16,-35,-13,"37",29,51,5,9,"low"
1,"SUPPRF85297",41,60,38,-1,1,"65",37,39,7,9,"high"
2,"SUPPRF85297",43,50,58,14,12,"61",46,44,7,9,"high"
3,"SUPPRF85297",43,48,46,-4,0,"66",46,50,7,9,"high"
4,"SUPPRF85297",44,52,28,-8,-1,"54",29,36,7,9,"high"
5,"SUPPRF85297",50,46,75,27,29,"67",46,48,7,9,"high"
6,"SUPPRF85297",43,62,33,1,-13,"48",46,32,7,9,"high"
7,"SUPPRF85297",52,61,62,-3,-1,"68",63,65,7,9,"high"
8,"SUPPRF85297",46,56,61,25,24,"63",37,36,7,9,"high"
9,"SUPPRF85297",46,52,35,12,15,"58",20,23,7,9,"high"
10,"SUPPRF85297",43,49,66,11,12,"34",54,55,7,9,"high"
11,"SUPPRF85297",47,49,63,-3,0,"47",63,66,7,9,"high"
12,"SUPPRF85297",49,53,50,1,-13,"5",63,49,7,9,"high"
13,"SUPPRF85297",44,47,24,-25,-13,"16",37,49,7,9,"high"
14,"SUPPRF85297",49,53,81,-5,1,"70",80,86,7,9,"high"
15,"SUPPRF85297",57,48,58,32,29,"58",29,26,7,9,"high"
16,"SUPPRF85297",32,54,38,-25,-16,"60",54,63,7,9,"high"
17,"SUPPRF85297",61,48,80,0,0,"64",80,80,7,9,"high"
18,"SUPPRF85297",52,57,29,5,0,"44",29,24,7,9,"high"
19,"SUPPRF85297",31,59,22,-27,-15,"17",37,49,7,9,"high"
20,"SUPPRF85297",39,47,19,-5,-1,"53",20,24,7,9,"high"
21,"SUPPRF85297",75,48,94,15,23,"69",71,79,7,9,"high"
22,"SUPPRF85297",52,42,55,-25,-16,"75",71,80,7,9,"high"
23,"SUPPRF85297",48,50,15,-3,-14,"65",29,18,7,9,"high"
24,"SUPPRF85297",48,40,34,6,-12,"66",46,28,7,9,"high"
25,"SUPPRF85297",47,48,83,32,12,"50",71,51,7,9,"high"
26,"SUPPRF85297",50,49,47,9,-16,"45",63,38,7,9,"high"
27,"SUPPRF85297",50,48,47,24,27,"72",20,23,7,9,"high"
28,"SUPPRF85297",50,50,96,43,16,"24",80,53,7,9,"high"
29,"SUPPRF85297",51,48,70,13,-1,"19",71,57,7,9,"high"
30,"SUPPRF85297",39,49,8,-18,-12,"64",20,26,7,9,"high"
31,"SUPPRF85297",46,50,54,-6,0,"19",54,60,7,9,"high"
32,"SUPPRF85297",48,47,37,11,0,"48",37,26,7,9,"high"
33,"SUPPRF85297",52,52,77,43,14,"49",63,34,7,9,"high"
34,"SUPPRF85297",49,56,78,8,24,"38",54,70,7,9,"high"
35,"SUPPRF85297",51,52,71,31,0,"37",71,40,7,9,"high"
36,"SUPPRF85297",33,48,6,-14,-14,"65",20,20,7,9,"high"
37,"SUPPRF85297",44,50,56,-24,-15,"51",71,80,7,9,"high"
38,"SUPPRF85297",48,51,41,-18,-13,"64",54,59,7,9,"high"
39,"SUPPRF85297",49,52,55,15,1,"45",54,40,7,9,"high"
40,"SUPPRF85297",50,52,49,18,12,"64",37,31,7,9,"high"
41,"SUPPRF85297",49,49,46,-6,17,"53",29,52,7,9,"high"
42,"SUPPRF85297",49,52,100,60,20,"50",80,40,7,9,"high"
43,"SUPPRF85297",52,53,45,9,-1,"55",46,36,7,9,"high"
44,"SUPPRF85297",52,61,68,4,-12,"59",80,64,7,9,"high"
45,"SUPPRF85297",40,42,16,-37,-13,"22",29,53,7,9,"high"
46,"SUPPRF85297",52,51,67,-17,-13,"78",80,84,7,9,"high"
47,"SUPPRF85297",48,46,20,-31,0,"51",20,51,7,9,"high"
48,"SUPPRF85297",49,48,88,58,25,"66",63,30,7,9,"high"
1,"SUPPRF10856",67,37,80,5,0,"65",80,75,10,9,"high"
2,"SUPPRF10856",68,53,62,31,-1,"74",63,31,10,9,"high"
3,"SUPPRF10856",62,46,47,-21,-16,"75",63,68,10,9,"high"
4,"SUPPRF10856",60,41,22,-23,-15,"40",37,45,10,9,"high"
5,"SUPPRF10856",46,60,58,13,12,"70",46,45,10,9,"high"
6,"SUPPRF10856",61,46,24,-16,-13,"75",37,40,10,9,"high"
7,"SUPPRF10856",60,39,68,-12,-12,"75",80,80,10,9,"high"
8,"SUPPRF10856",54,43,46,13,17,"75",29,33,10,9,"high"
9,"SUPPRF10856",60,46,55,-15,-16,"75",71,70,10,9,"high"
10,"SUPPRF10856",64,44,96,19,16,"70",80,77,10,9,"high"
11,"SUPPRF10856",45,39,33,-7,-13,"70",46,40,10,9,"high"
12,"SUPPRF10856",57,44,34,-6,-12,"70",46,40,10,9,"high"
13,"SUPPRF10856",57,45,67,2,-13,"40",80,65,10,9,"high"
14,"SUPPRF10856",63,41,29,-1,0,"70",29,30,10,9,"high"
15,"SUPPRF10856",64,42,77,2,14,"60",63,75,10,9,"high"
16,"SUPPRF10856",62,43,19,-3,-1,"29",20,22,10,9,"high"
17,"SUPPRF10856",57,43,56,-14,-15,"75",71,70,10,9,"high"
18,"SUPPRF10856",58,43,15,-13,-14,"75",29,28,10,9,"high"
19,"SUPPRF10856",60,41,66,11,12,"35",54,55,10,9,"high"
20,"SUPPRF10856",59,43,41,-17,-13,"60",54,58,10,9,"high"
21,"SUPPRF10856",58,39,6,-12,-14,"55",20,18,10,9,"high"
22,"SUPPRF10856",65,42,83,18,12,"80",71,65,10,9,"high"
23,"SUPPRF10856",62,39,47,17,27,"65",20,30,10,9,"high"
24,"SUPPRF10856",60,46,8,-27,-12,"60",20,35,10,9,"high"
25,"SUPPRF10856",62,39,63,-2,0,"70",63,65,10,9,"high"
26,"SUPPRF10856",59,48,55,-5,1,"40",54,60,10,9,"high"
27,"SUPPRF10856",56,42,75,14,29,"70",46,61,10,9,"high"
28,"SUPPRF10856",59,42,46,-14,0,"75",46,60,10,9,"high"
29,"SUPPRF10856",61,39,58,43,29,"60",29,15,10,9,"high"
30,"SUPPRF10856",62,37,71,6,0,"65",71,65,10,9,"high"
31,"SUPPRF10856",60,40,16,-10,-13,"75",29,26,10,9,"high"
32,"SUPPRF10856",61,43,70,15,-1,"70",71,55,10,9,"high"
33,"SUPPRF10856",57,41,38,-20,-16,"51",54,58,10,9,"high"
34,"SUPPRF10856",60,39,50,-20,-13,"55",63,70,10,9,"high"
35,"SUPPRF10856",64,42,94,24,23,"80",71,70,10,9,"high"
36,"SUPPRF10856",62,40,45,5,-1,"50",46,40,10,9,"high"
37,"SUPPRF10856",60,46,49,-7,12,"35",37,56,10,9,"high"
38,"SUPPRF10856",61,40,100,21,20,"70",80,79,10,9,"high"
39,"SUPPRF10856",58,44,54,-13,0,"75",54,67,10,9,"high"
40,"SUPPRF10856",62,38,20,0,0,"57",20,20,10,9,"high"
41,"SUPPRF10856",61,42,28,-12,-1,"37",29,40,10,9,"high"
42,"SUPPRF10856",58,40,38,-2,1,"70",37,40,10,9,"high"
43,"SUPPRF10856",61,43,37,7,0,"39",37,30,10,9,"high"
44,"SUPPRF10856",59,42,61,21,24,"60",37,40,10,9,"high"
45,"SUPPRF10856",58,40,35,15,15,"65",20,20,10,9,"high"
46,"SUPPRF10856",58,43,88,33,25,"51",63,55,10,9,"high"
47,"SUPPRF10856",61,43,81,4,1,"70",80,77,10,9,"high"
48,"SUPPRF10856",56,44,78,23,24,"37",54,55,10,9,"high"
1,"SUPPRF24628",28,21,16,-11,-13,"69",29,27,6,9,"high"
2,"SUPPRF24628",56,21,47,23,27,"72",20,24,6,9,"high"
3,"SUPPRF24628",73,25,6,-15,-14,"64",20,21,6,9,"high"
4,"SUPPRF24628",73,3,67,-9,-13,"76",80,76,6,9,"high"
5,"SUPPRF24628",78,6,55,-22,-16,"74",71,77,6,9,"high"
6,"SUPPRF24628",25,76,58,17,12,"59",46,41,6,9,"high"
7,"SUPPRF24628",67,17,38,2,1,"63",37,36,6,9,"high"
8,"SUPPRF24628",64,62,19,2,-1,"43",20,17,6,9,"high"
9,"SUPPRF24628",91,52,78,24,24,"60",54,54,6,9,"high"
10,"SUPPRF24628",89,60,88,15,25,"82",63,73,6,9,"high"
11,"SUPPRF24628",35,63,54,-16,0,"75",54,70,6,9,"high"
12,"SUPPRF24628",39,33,50,-6,-13,"28",63,56,6,9,"high"
13,"SUPPRF24628",47,60,66,-4,12,"49",54,70,6,9,"high"
14,"SUPPRF24628",69,62,80,1,0,"71",80,79,6,9,"high"
15,"SUPPRF24628",100,43,100,32,20,"49",80,68,6,9,"high"
16,"SUPPRF24628",98,21,83,2,12,"30",71,81,6,9,"high"
17,"SUPPRF24628",30,48,20,0,0,"41",20,20,6,9,"high"
18,"SUPPRF24628",62,38,63,-4,0,"30",63,67,6,9,"high"
19,"SUPPRF24628",12,70,22,-25,-15,"22",37,47,6,9,"high"
20,"SUPPRF24628",17,50,33,-21,-13,"42",46,54,6,9,"high"
21,"SUPPRF24628",80,29,70,0,-1,"32",71,70,6,9,"high"
22,"SUPPRF24628",59,33,28,13,-1,"68",29,15,6,9,"high"
23,"SUPPRF24628",59,25,34,-17,-12,"38",46,51,6,9,"high"
24,"SUPPRF24628",65,37,81,5,1,"61",80,76,6,9,"high"
25,"SUPPRF24628",65,66,46,21,17,"24",29,25,6,9,"high"
26,"SUPPRF24628",28,26,15,-22,-14,"14",29,37,6,9,"high"
27,"SUPPRF24628",20,39,24,-19,-13,"27",37,43,6,9,"high"
28,"SUPPRF24628",59,39,47,10,-16,"26",63,37,6,9,"high"
29,"SUPPRF24628",50,33,56,7,-15,"1",71,49,6,9,"high"
30,"SUPPRF24628",51,39,75,23,29,"25",46,52,6,9,"high"
31,"SUPPRF24628",99,10,94,41,23,"34",71,53,6,9,"high"
32,"SUPPRF24628",98,21,96,24,16,"14",80,72,6,9,"high"
33,"SUPPRF24628",47,27,29,3,0,"27",29,26,6,9,"high"
34,"SUPPRF24628",49,27,71,1,0,"56",71,70,6,9,"high"
35,"SUPPRF24628",40,37,68,-12,-12,"65",80,80,6,9,"high"
36,"SUPPRF24628",25,34,49,2,12,"69",37,47,6,9,"high"
37,"SUPPRF24628",1,26,38,-7,-16,"30",54,45,6,9,"high"
38,"SUPPRF24628",4,15,62,19,-1,"9",63,43,6,9,"high"
39,"SUPPRF24628",1,30,46,12,0,"66",46,34,6,9,"high"
40,"SUPPRF24628",2,23,61,5,24,"60",37,56,6,9,"high"
41,"SUPPRF24628",8,18,41,-18,-13,"63",54,59,6,9,"high"
42,"SUPPRF24628",15,24,58,32,29,"65",29,26,6,9,"high"
43,"SUPPRF24628",9,16,37,-18,0,"29",37,55,6,9,"high"
44,"SUPPRF24628",2,22,8,-8,-12,"59",20,16,6,9,"high"
45,"SUPPRF24628",27,17,35,22,15,"65",20,13,6,9,"high"
46,"SUPPRF24628",23,17,45,-9,-1,"31",46,54,6,9,"high"
47,"SUPPRF24628",59,25,77,22,14,"26",63,55,6,9,"high"
48,"SUPPRF24628",1,21,55,4,1,"23",54,51,6,9,"high"
1,"SUPPRF95341",79,16,6,-13,-14,"78",20,19,1,9,"low"
2,"SUPPRF95341",86,8,63,0,0,"40",63,63,1,9,"low"
3,"SUPPRF95341",76,5,55,-12,1,"89",54,67,1,9,"low"
4,"SUPPRF95341",94,2,15,-4,-14,"74",29,19,1,9,"low"
5,"SUPPRF95341",95,4,62,-1,-1,"81",63,63,1,9,"low"
6,"SUPPRF95341",98,5,58,7,12,"89",46,51,1,9,"low"
7,"SUPPRF95341",95,3,50,-11,-13,"77",63,61,1,9,"low"
8,"SUPPRF95341",98,2,94,10,23,"2",71,84,1,9,"low"
9,"SUPPRF95341",87,7,47,-9,-16,"77",63,56,1,9,"low"
10,"SUPPRF95341",99,2,71,2,0,"12",71,69,1,9,"low"
11,"SUPPRF95341",84,8,41,-13,-13,"91",54,54,1,9,"low"
12,"SUPPRF95341",83,18,22,-24,-15,"79",37,46,1,9,"low"
13,"SUPPRF95341",96,18,78,29,24,"28",54,49,1,9,"low"
14,"SUPPRF95341",96,5,66,8,12,"78",54,58,1,9,"low"
15,"SUPPRF95341",99,0,100,19,20,"64",80,81,1,9,"low"
16,"SUPPRF95341",98,1,68,-12,-12,"57",80,80,1,9,"low"
17,"SUPPRF95341",90,7,54,-3,0,"76",54,57,1,9,"low"
18,"SUPPRF95341",98,16,46,20,0,"33",46,26,1,9,"low"
19,"SUPPRF95341",99,3,81,2,1,"80",80,79,1,9,"low"
20,"SUPPRF95341",72,10,8,-41,-12,"7",20,49,1,9,"low"
21,"SUPPRF95341",88,4,38,-2,1,"32",37,40,1,9,"low"
22,"SUPPRF95341",78,10,49,19,12,"71",37,30,1,9,"low"
23,"SUPPRF95341",98,3,28,8,-1,"97",29,20,1,9,"low"
24,"SUPPRF95341",98,6,35,-19,15,"5",20,54,1,9,"low"
25,"SUPPRF95341",92,3,67,-5,-13,"11",80,72,1,9,"low"
26,"SUPPRF95341",91,8,16,-1,-13,"86",29,17,1,9,"low"
27,"SUPPRF95341",98,8,45,15,-1,"63",46,30,1,9,"low"
28,"SUPPRF95341",89,5,83,8,12,"88",71,75,1,9,"low"
29,"SUPPRF95341",97,1,38,-41,-16,"87",54,79,1,9,"low"
30,"SUPPRF95341",99,7,96,59,16,"23",80,37,1,9,"low"
31,"SUPPRF95341",100,4,58,35,29,"75",29,23,1,9,"low"
32,"SUPPRF95341",98,3,56,-38,-15,"4",71,94,1,9,"low"
33,"SUPPRF95341",92,11,34,-10,-12,"58",46,44,1,9,"low"
34,"SUPPRF95341",92,5,55,6,-16,"9",71,49,1,9,"low"
35,"SUPPRF95341",98,6,33,5,-13,"7",46,28,1,9,"low"
36,"SUPPRF95341",89,10,70,23,-1,"9",71,47,1,9,"low"
37,"SUPPRF95341",97,4,19,-60,-1,"44",20,79,1,9,"low"
38,"SUPPRF95341",98,1,29,8,0,"95",29,21,1,9,"low"
39,"SUPPRF95341",89,2,24,-43,-13,"11",37,67,1,9,"low"
40,"SUPPRF95341",99,0,88,48,25,"82",63,40,1,9,"low"
41,"SUPPRF95341",99,0,80,62,0,"87",80,18,1,9,"low"
42,"SUPPRF95341",87,11,20,13,0,"87",20,7,1,9,"low"
43,"SUPPRF95341",100,1,47,35,27,"81",20,12,1,9,"low"
44,"SUPPRF95341",99,4,46,31,17,"89",29,15,1,9,"low"
45,"SUPPRF95341",98,9,77,-2,14,"90",63,79,1,9,"low"
46,"SUPPRF95341",99,2,61,40,24,"26",37,21,1,9,"low"
47,"SUPPRF95341",98,10,37,0,0,"45",37,37,1,9,"low"
48,"SUPPRF95341",91,5,75,47,29,"92",46,28,1,9,"low"
1,"SUPPRF54475",40,57,62,-11,-1,"79",63,73,3,9,"low"
2,"SUPPRF54475",22,70,68,-18,-12,"68",80,86,3,9,"low"
3,"SUPPRF54475",12,78,6,-10,-14,"67",20,16,3,9,"low"
4,"SUPPRF54475",6,75,16,-18,-13,"63",29,34,3,9,"low"
5,"SUPPRF54475",85,38,94,27,23,"69",71,67,3,9,"low"
6,"SUPPRF54475",58,64,49,27,12,"71",37,22,3,9,"low"
7,"SUPPRF54475",41,52,50,-7,-13,"47",63,57,3,9,"low"
8,"SUPPRF54475",58,30,71,13,0,"60",71,58,3,9,"low"
9,"SUPPRF54475",49,56,55,14,1,"63",54,41,3,9,"low"
10,"SUPPRF54475",43,51,54,20,0,"49",54,34,3,9,"low"
11,"SUPPRF54475",31,60,38,-1,1,"41",37,39,3,9,"low"
12,"SUPPRF54475",18,59,28,-9,-1,"37",29,37,3,9,"low"
13,"SUPPRF54475",80,4,100,28,20,"78",80,72,3,9,"low"
14,"SUPPRF54475",39,40,35,11,15,"52",20,24,3,9,"low"
15,"SUPPRF54475",57,38,70,19,-1,"54",71,51,3,9,"low"
16,"SUPPRF54475",66,44,61,32,24,"57",37,29,3,9,"low"
17,"SUPPRF54475",49,45,45,-4,-1,"46",46,49,3,9,"low"
18,"SUPPRF54475",64,33,47,36,27,"65",20,11,3,9,"low"
19,"SUPPRF54475",45,40,20,3,0,"63",20,17,3,9,"low"
20,"SUPPRF54475",22,60,56,-20,-15,"79",71,76,3,9,"low"
21,"SUPPRF54475",41,53,29,7,0,"63",29,22,3,9,"low"
22,"SUPPRF54475",53,29,33,13,-13,"52",46,20,3,9,"low"
23,"SUPPRF54475",46,42,66,24,12,"58",54,42,3,9,"low"
24,"SUPPRF54475",21,57,67,-19,-13,"64",80,86,3,9,"low"
25,"SUPPRF54475",54,42,80,26,0,"39",80,54,3,9,"low"
26,"SUPPRF54475",74,34,88,43,25,"49",63,45,3,9,"low"
27,"SUPPRF54475",45,53,41,-5,-13,"38",54,46,3,9,"low"
28,"SUPPRF54475",58,42,81,10,1,"74",80,71,3,9,"low"
29,"SUPPRF54475",58,28,83,27,12,"54",71,56,3,9,"low"
30,"SUPPRF54475",60,33,46,12,0,"35",46,34,3,9,"low"
31,"SUPPRF54475",60,14,8,-13,-12,"39",20,21,3,9,"low"
32,"SUPPRF54475",65,25,37,23,0,"28",37,14,3,9,"low"
33,"SUPPRF54475",51,31,46,20,17,"57",29,26,3,9,"low"
34,"SUPPRF54475",25,28,15,-44,-14,"36",29,59,3,9,"low"
35,"SUPPRF54475",82,30,58,48,29,"61",29,10,3,9,"low"
36,"SUPPRF54475",70,4,63,-1,0,"59",63,64,3,9,"low"
37,"SUPPRF54475",60,20,75,41,29,"48",46,34,3,9,"low"
38,"SUPPRF54475",41,31,38,-12,-16,"62",54,50,3,9,"low"
39,"SUPPRF54475",36,63,22,-19,-15,"56",37,41,3,9,"low"
40,"SUPPRF54475",63,15,78,26,24,"48",54,52,3,9,"low"
41,"SUPPRF54475",67,39,55,-6,-16,"43",71,61,3,9,"low"
42,"SUPPRF54475",69,24,24,-10,-13,"58",37,34,3,9,"low"
43,"SUPPRF54475",41,47,47,-8,-16,"63",63,55,3,9,"low"
44,"SUPPRF54475",70,23,96,30,16,"70",80,66,3,9,"low"
45,"SUPPRF54475",51,48,58,-2,12,"51",46,60,3,9,"low"
46,"SUPPRF54475",60,27,77,13,14,"56",63,64,3,9,"low"
47,"SUPPRF54475",46,48,19,8,-1,"53",20,11,3,9,"low"
48,"SUPPRF54475",36,64,34,-16,-12,"43",46,50,3,9,"low"
1,"SUPPRF06342",39,73,24,-29,-13,"59",37,53,10,9,"high"
2,"SUPPRF06342",50,59,61,40,24,"72",37,21,10,9,"high"
3,"SUPPRF06342",28,66,16,7,-13,"73",29,9,10,9,"high"
4,"SUPPRF06342",58,69,100,30,20,"66",80,70,10,9,"high"
5,"SUPPRF06342",55,60,63,9,0,"41",63,54,10,9,"high"
6,"SUPPRF06342",49,56,56,-14,-15,"61",71,70,10,9,"high"
7,"SUPPRF06342",49,51,68,25,-12,"63",80,43,10,9,"high"
8,"SUPPRF06342",48,40,71,6,0,"63",71,65,10,9,"high"
9,"SUPPRF06342",45,46,54,-5,0,"59",54,59,10,9,"high"
10,"SUPPRF06342",49,47,62,13,-1,"72",63,49,10,9,"high"
11,"SUPPRF06342",41,55,45,6,-1,"71",46,39,10,9,"high"
12,"SUPPRF06342",51,54,58,27,12,"59",46,31,10,9,"high"
13,"SUPPRF06342",37,58,58,29,29,"75",29,29,10,9,"high"
14,"SUPPRF06342",43,49,83,23,12,"62",71,60,10,9,"high"
15,"SUPPRF06342",28,67,28,-25,-1,"36",29,53,10,9,"high"
16,"SUPPRF06342",33,66,38,-37,-16,"61",54,75,10,9,"high"
17,"SUPPRF06342",60,40,81,19,1,"47",80,62,10,9,"high"
18,"SUPPRF06342",41,56,41,-19,-13,"56",54,60,10,9,"high"
19,"SUPPRF06342",40,59,34,6,-12,"66",46,28,10,9,"high"
20,"SUPPRF06342",45,56,67,29,-13,"37",80,38,10,9,"high"
21,"SUPPRF06342",25,63,6,-19,-14,"58",20,25,10,9,"high"
22,"SUPPRF06342",46,70,80,51,0,"71",80,29,10,9,"high"
23,"SUPPRF06342",29,65,55,24,-16,"61",71,31,10,9,"high"
24,"SUPPRF06342",52,37,78,24,24,"54",54,54,10,9,"high"
25,"SUPPRF06342",57,30,46,11,0,"55",46,35,10,9,"high"
26,"SUPPRF06342",27,68,22,-53,-15,"60",37,75,10,9,"high"
27,"SUPPRF06342",36,65,33,21,-13,"70",46,12,10,9,"high"
28,"SUPPRF06342",17,37,8,-37,-12,"36",20,45,10,9,"high"
29,"SUPPRF06342",39,66,29,-7,0,"67",29,36,10,9,"high"
30,"SUPPRF06342",32,65,38,-7,1,"40",37,45,10,9,"high"
31,"SUPPRF06342",36,53,55,21,1,"30",54,34,10,9,"high"
32,"SUPPRF06342",48,61,47,-11,-16,"41",63,58,10,9,"high"
33,"SUPPRF06342",44,42,46,3,17,"42",29,43,10,9,"high"
34,"SUPPRF06342",43,46,20,0,0,"62",20,20,10,9,"high"
35,"SUPPRF06342",56,41,66,21,12,"68",54,45,10,9,"high"
36,"SUPPRF06342",55,41,88,67,25,"58",63,21,10,9,"high"
37,"SUPPRF06342",58,36,47,29,27,"70",20,18,10,9,"high"
38,"SUPPRF06342",64,27,96,64,16,"66",80,32,10,9,"high"
39,"SUPPRF06342",52,26,37,3,0,"80",37,34,10,9,"high"
40,"SUPPRF06342",55,25,77,13,14,"80",63,64,10,9,"high"
41,"SUPPRF06342",51,19,50,-22,-13,"82",63,72,10,9,"high"
42,"SUPPRF06342",45,35,19,-13,-1,"67",20,32,10,9,"high"
43,"SUPPRF06342",45,50,15,-13,-14,"67",29,28,10,9,"high"
44,"SUPPRF06342",51,63,49,30,12,"52",37,19,10,9,"high"
45,"SUPPRF06342",52,61,94,69,23,"40",71,25,10,9,"high"
46,"SUPPRF06342",49,55,35,-10,15,"38",20,45,10,9,"high"
47,"SUPPRF06342",52,56,70,34,-1,"59",71,36,10,9,"high"
48,"SUPPRF06342",48,46,75,22,29,"58",46,53,10,9,"high"
1,"SUPPRF73117",49,11,62,27,-1,"65",63,35,9,9,"high"
2,"SUPPRF73117",55,11,83,13,12,"49",71,70,9,9,"high"
3,"SUPPRF73117",60,7,50,-15,-13,"56",63,65,9,9,"high"
4,"SUPPRF73117",60,12,61,16,24,"66",37,45,9,9,"high"
5,"SUPPRF73117",66,20,46,-14,0,"57",46,60,9,9,"high"
6,"SUPPRF73117",74,9,20,0,0,"56",20,20,9,9,"high"
7,"SUPPRF73117",70,11,47,-13,-16,"51",63,60,9,9,"high"
8,"SUPPRF73117",44,6,47,17,27,"55",20,30,9,9,"high"
9,"SUPPRF73117",57,11,96,15,16,"58",80,81,9,9,"high"
10,"SUPPRF73117",73,14,81,-14,1,"64",80,95,9,9,"high"
11,"SUPPRF73117",48,9,71,-9,0,"70",71,80,9,9,"high"
12,"SUPPRF73117",62,15,22,-11,-15,"61",37,33,9,9,"high"
13,"SUPPRF73117",43,15,88,50,25,"58",63,38,9,9,"high"
14,"SUPPRF73117",50,11,56,-14,-15,"69",71,70,9,9,"high"
15,"SUPPRF73117",52,17,45,-30,-1,"68",46,75,9,9,"high"
16,"SUPPRF73117",39,14,58,28,29,"64",29,30,9,9,"high"
17,"SUPPRF73117",53,13,16,-30,-13,"33",29,46,9,9,"high"
18,"SUPPRF73117",54,8,8,-4,-12,"37",20,12,9,9,"high"
19,"SUPPRF73117",41,11,55,6,1,"35",54,49,9,9,"high"
20,"SUPPRF73117",34,17,78,22,24,"31",54,56,9,9,"high"
21,"SUPPRF73117",10,14,100,11,20,"27",80,89,9,9,"high"
22,"SUPPRF73117",100,11,80,0,0,"17",80,80,9,9,"high"
23,"SUPPRF73117",55,9,75,44,29,"16",46,31,9,9,"high"
24,"SUPPRF73117",49,12,37,6,0,"21",37,31,9,9,"high"
25,"SUPPRF73117",46,6,15,-31,-14,"7",29,46,9,9,"high"
26,"SUPPRF73117",51,9,77,45,14,"8",63,32,9,9,"high"
27,"SUPPRF73117",35,9,94,19,23,"9",71,75,9,9,"high"
28,"SUPPRF73117",13,8,29,-55,0,"8",29,84,9,9,"high"
29,"SUPPRF73117",10,12,33,10,-13,"54",46,23,9,9,"high"
30,"SUPPRF73117",11,9,55,-40,-16,"33",71,95,9,9,"high"
31,"SUPPRF73117",0,11,54,22,0,"8",54,32,9,9,"high"
32,"SUPPRF73117",0,20,19,-25,-1,"0",20,44,9,9,"high"
33,"SUPPRF73117",0,27,24,-14,-13,"0",37,38,9,9,"high"
34,"SUPPRF73117",0,10,41,-27,-13,"0",54,68,9,9,"high"
35,"SUPPRF73117",30,23,68,5,-12,"28",80,63,9,9,"high"
36,"SUPPRF73117",0,30,6,-94,-14,"0",20,100,9,9,"high"
37,"SUPPRF73117",0,40,38,2,-16,"4",54,36,9,9,"high"
38,"SUPPRF73117",0,44,46,32,17,"0",29,14,9,9,"high"
39,"SUPPRF73117",0,46,67,67,-13,"0",80,0,9,9,"high"
40,"SUPPRF73117",0,53,38,38,1,"0",37,0,9,9,"high"
41,"SUPPRF73117",0,49,35,24,15,"0",20,11,9,9,"high"
42,"SUPPRF73117",0,82,63,63,0,"0",63,0,9,9,"high"
43,"SUPPRF73117",0,100,28,-22,-1,"0",29,50,9,9,"high"
44,"SUPPRF73117",0,100,34,-11,-12,"14",46,45,9,9,"high"
45,"SUPPRF73117",0,100,70,0,-1,"0",71,70,9,9,"high"
46,"SUPPRF73117",0,100,66,64,12,"0",54,2,9,9,"high"
47,"SUPPRF73117",0,100,49,-2,12,"0",37,51,9,9,"high"
48,"SUPPRF73117",0,100,58,-21,12,"0",46,79,9,9,"high"
1,"SUPPRF91978",53,53,38,-6,-16,"53",54,44,0,9,"low"
2,"SUPPRF91978",68,28,63,-9,0,"70",63,72,0,9,"low"
3,"SUPPRF91978",50,48,6,-20,-14,"29",20,26,0,9,"low"
4,"SUPPRF91978",77,65,61,26,24,"96",37,35,0,9,"low"
5,"SUPPRF91978",97,8,75,15,29,"97",46,60,0,9,"low"
6,"SUPPRF91978",50,49,55,-25,-16,"100",71,80,0,9,"low"
7,"SUPPRF91978",52,52,33,-19,-13,"1",46,52,0,9,"low"
8,"SUPPRF91978",48,66,29,-12,0,"74",29,41,0,9,"low"
9,"SUPPRF91978",59,56,41,-4,-13,"87",54,45,0,9,"low"
10,"SUPPRF91978",73,27,88,-9,25,"94",63,97,0,9,"low"
11,"SUPPRF91978",53,57,16,-21,-13,"98",29,37,0,9,"low"
12,"SUPPRF91978",74,11,54,3,0,"2",54,51,0,9,"low"
13,"SUPPRF91978",73,49,70,26,-1,"1",71,44,0,9,"low"
14,"SUPPRF91978",68,8,71,-7,0,"91",71,78,0,9,"low"
15,"SUPPRF91978",69,25,46,1,0,"47",46,45,0,9,"low"
16,"SUPPRF91978",48,57,77,27,14,"1",63,50,0,9,"low"
17,"SUPPRF91978",31,37,24,-57,-13,"78",37,81,0,9,"low"
18,"SUPPRF91978",68,61,68,-5,-12,"86",80,73,0,9,"low"
19,"SUPPRF91978",50,48,37,0,0,"66",37,37,0,9,"low"
20,"SUPPRF91978",53,51,47,27,27,"70",20,20,0,9,"low"
21,"SUPPRF91978",50,50,47,12,-16,"3",63,35,0,9,"low"
22,"SUPPRF91978",35,37,15,-72,-14,"18",29,87,0,9,"low"
23,"SUPPRF91978",47,1,38,-16,1,"2",37,54,0,9,"low"
24,"SUPPRF91978",31,38,62,9,-1,"2",63,53,0,9,"low"
25,"SUPPRF91978",45,50,22,-23,-15,"0",37,45,0,9,"low"
26,"SUPPRF91978",49,47,55,5,1,"1",54,50,0,9,"low"
27,"SUPPRF91978",51,55,45,-25,-1,"0",46,70,0,9,"low"
28,"SUPPRF91978",49,51,46,-14,17,"48",29,60,0,9,"low"
29,"SUPPRF91978",47,49,56,1,-15,"2",71,55,0,9,"low"
30,"SUPPRF91978",57,29,35,18,15,"83",20,17,0,9,"low"
31,"SUPPRF91978",56,51,66,15,12,"48",54,51,0,9,"low"
32,"SUPPRF91978",17,94,34,2,-12,"23",46,32,0,9,"low"
33,"SUPPRF91978",21,72,19,7,-1,"9",20,12,0,9,"low"
34,"SUPPRF91978",1,99,58,19,12,"14",46,39,0,9,"low"
35,"SUPPRF91978",0,100,96,7,16,"10",80,89,0,9,"low"
36,"SUPPRF91978",1,99,58,3,29,"8",29,55,0,9,"low"
37,"SUPPRF91978",12,47,94,61,23,"3",71,33,0,9,"low"
38,"SUPPRF91978",24,73,8,-23,-12,"69",20,31,0,9,"low"
39,"SUPPRF91978",16,84,80,-1,0,"41",80,81,0,9,"low"
40,"SUPPRF91978",25,77,81,8,1,"9",80,73,0,9,"low"
41,"SUPPRF91978",52,65,49,-9,12,"2",37,58,0,9,"low"
42,"SUPPRF91978",19,72,67,-17,-13,"75",80,84,0,9,"low"
43,"SUPPRF91978",30,79,100,28,20,"2",80,72,0,9,"low"
44,"SUPPRF91978",51,49,28,-14,-1,"2",29,42,0,9,"low"
45,"SUPPRF91978",53,55,50,-46,-13,"80",63,96,0,9,"low"
46,"SUPPRF91978",51,55,78,13,24,"71",54,65,0,9,"low"
47,"SUPPRF91978",47,47,83,33,12,"0",71,50,0,9,"low"
48,"SUPPRF91978",49,49,20,7,0,"76",20,13,0,9,"low"
1,"SUPPRF75922",87,8,46,-19,0,"81",46,65,4,9,"low"
2,"SUPPRF75922",89,7,50,-19,-13,"78",63,69,4,9,"low"
3,"SUPPRF75922",88,10,24,-31,-13,"85",37,55,4,9,"low"
4,"SUPPRF75922",94,8,71,11,0,"90",71,60,4,9,"low"
5,"SUPPRF75922",94,8,67,-18,-13,"99",80,85,4,9,"low"
6,"SUPPRF75922",93,7,96,37,16,"78",80,59,4,9,"low"
7,"SUPPRF75922",92,3,55,-25,-16,"80",71,80,4,9,"low"
8,"SUPPRF75922",91,6,47,22,27,"50",20,25,4,9,"low"
9,"SUPPRF75922",92,6,80,0,0,"94",80,80,4,9,"low"
10,"SUPPRF75922",94,6,55,-4,1,"83",54,59,4,9,"low"
11,"SUPPRF75922",96,7,45,-25,-1,"76",46,70,4,9,"low"
12,"SUPPRF75922",90,7,8,-32,-12,"47",20,40,4,9,"low"
13,"SUPPRF75922",88,4,46,1,17,"71",29,45,4,9,"low"
14,"SUPPRF75922",92,14,75,5,29,"86",46,70,4,9,"low"
15,"SUPPRF75922",95,18,6,-33,-14,"100",20,39,4,9,"low"
16,"SUPPRF75922",89,26,16,-59,-13,"25",29,75,4,9,"low"
17,"SUPPRF75922",94,9,77,13,14,"75",63,64,4,9,"low"
18,"SUPPRF75922",94,4,41,8,-13,"82",54,33,4,9,"low"
19,"SUPPRF75922",89,15,37,-17,0,"92",37,54,4,9,"low"
20,"SUPPRF75922",92,10,56,-12,-15,"94",71,68,4,9,"low"
21,"SUPPRF75922",95,5,38,-32,-16,"76",54,70,4,9,"low"
22,"SUPPRF75922",93,6,29,2,0,"85",29,27,4,9,"low"
23,"SUPPRF75922",86,7,70,21,-1,"90",71,49,4,9,"low"
24,"SUPPRF75922",97,11,66,16,12,"98",54,50,4,9,"low"
25,"SUPPRF75922",92,16,68,-27,-12,"100",80,95,4,9,"low"
26,"SUPPRF75922",91,10,22,-4,-15,"95",37,26,4,9,"low"
27,"SUPPRF75922",96,5,19,-17,-1,"98",20,36,4,9,"low"
28,"SUPPRF75922",91,7,34,0,-12,"94",46,34,4,9,"low"
29,"SUPPRF75922",93,6,94,14,23,"99",71,80,4,9,"low"
30,"SUPPRF75922",89,8,33,-27,-13,"89",46,60,4,9,"low"
31,"SUPPRF75922",94,6,83,-5,12,"100",71,88,4,9,"low"
32,"SUPPRF75922",91,15,63,-12,0,"91",63,75,4,9,"low"
33,"SUPPRF75922",92,9,58,18,29,"51",29,40,4,9,"low"
34,"SUPPRF75922",92,9,81,5,1,"93",80,76,4,9,"low"
35,"SUPPRF75922",93,8,100,10,20,"85",80,90,4,9,"low"
36,"SUPPRF75922",91,8,61,11,24,"88",37,50,4,9,"low"
37,"SUPPRF75922",89,8,28,-45,-1,"88",29,73,4,9,"low"
38,"SUPPRF75922",90,9,62,-18,-1,"87",63,80,4,9,"low"
39,"SUPPRF75922",98,6,58,-7,12,"100",46,65,4,9,"low"
40,"SUPPRF75922",88,18,47,-38,-16,"92",63,85,4,9,"low"
41,"SUPPRF75922",97,4,78,8,24,"88",54,70,4,9,"low"
42,"SUPPRF75922",92,13,49,-4,12,"100",37,53,4,9,"low"
43,"SUPPRF75922",80,28,15,-10,-14,"85",29,25,4,9,"low"
44,"SUPPRF75922",77,8,35,5,15,"44",20,30,4,9,"low"
45,"SUPPRF75922",84,17,54,-6,0,"87",54,60,4,9,"low"
46,"SUPPRF75922",95,12,88,33,25,"99",63,55,4,9,"low"
47,"SUPPRF75922",76,23,20,-5,0,"92",20,25,4,9,"low"
48,"SUPPRF75922",88,11,38,-3,1,"60",37,41,4,9,"low"
1,"SUPPRF94497",69,17,55,-5,1,"86",54,60,3,9,"low"
2,"SUPPRF94497",59,21,67,-13,-13,"95",80,80,3,9,"low"
3,"SUPPRF94497",70,17,19,-1,-1,"86",20,20,3,9,"low"
4,"SUPPRF94497",71,21,56,-24,-15,"75",71,80,3,9,"low"
5,"SUPPRF94497",60,14,47,-18,-16,"90",63,65,3,9,"low"
6,"SUPPRF94497",62,11,68,-2,-12,"60",80,70,3,9,"low"
7,"SUPPRF94497",68,19,38,-7,-16,"62",54,45,3,9,"low"
8,"SUPPRF94497",61,10,20,7,0,"81",20,13,3,9,"low"
9,"SUPPRF94497",59,10,88,28,25,"87",63,60,3,9,"low"
10,"SUPPRF94497",59,13,58,-2,29,"28",29,60,3,9,"low"
11,"SUPPRF94497",62,14,8,-2,-12,"82",20,10,3,9,"low"
12,"SUPPRF94497",66,8,78,30,24,"26",54,48,3,9,"low"
13,"SUPPRF94497",64,11,46,16,0,"80",46,30,3,9,"low"
14,"SUPPRF94497",64,7,77,20,14,"71",63,57,3,9,"low"
15,"SUPPRF94497",66,5,80,11,0,"80",80,69,3,9,"low"
16,"SUPPRF94497",87,0,96,29,16,"59",80,67,3,9,"low"
17,"SUPPRF94497",83,3,34,-17,-12,"70",46,51,3,9,"low"
18,"SUPPRF94497",76,7,54,4,0,"79",54,50,3,9,"low"
19,"SUPPRF94497",80,3,49,-1,12,"85",37,50,3,9,"low"
20,"SUPPRF94497",59,4,16,-19,-13,"81",29,35,3,9,"low"
21,"SUPPRF94497",74,4,58,8,12,"79",46,50,3,9,"low"
22,"SUPPRF94497",73,6,41,1,-13,"73",54,40,3,9,"low"
23,"SUPPRF94497",72,4,70,12,-1,"62",71,58,3,9,"low"
24,"SUPPRF94497",72,0,46,-9,17,"73",29,55,3,9,"low"
25,"SUPPRF94497",76,0,63,5,0,"18",63,58,3,9,"low"
26,"SUPPRF94497",89,0,94,24,23,"91",71,70,3,9,"low"
27,"SUPPRF94497",75,0,50,-2,-13,"83",63,52,3,9,"low"
28,"SUPPRF94497",74,0,45,-3,-1,"79",46,48,3,9,"low"
29,"SUPPRF94497",80,0,83,29,12,"65",71,54,3,9,"low"
30,"SUPPRF94497",77,0,22,-8,-15,"83",37,30,3,9,"low"
31,"SUPPRF94497",78,1,33,-8,-13,"80",46,41,3,9,"low"
32,"SUPPRF94497",81,0,24,-24,-13,"32",37,48,3,9,"low"
33,"SUPPRF94497",53,8,81,-19,1,"100",80,100,3,9,"low"
34,"SUPPRF94497",65,0,71,-3,0,"61",71,74,3,9,"low"
35,"SUPPRF94497",68,0,37,-5,0,"60",37,42,3,9,"low"
36,"SUPPRF94497",81,6,66,4,12,"82",54,62,3,9,"low"
37,"SUPPRF94497",76,0,55,-8,-16,"54",71,63,3,9,"low"
38,"SUPPRF94497",81,0,75,32,29,"91",46,43,3,9,"low"
39,"SUPPRF94497",13,0,6,-19,-14,"84",20,25,3,9,"low"
40,"SUPPRF94497",91,2,47,27,27,"90",20,20,3,9,"low"
41,"SUPPRF94497",100,0,100,27,20,"59",80,73,3,9,"low"
42,"SUPPRF94497",84,0,35,16,15,"89",20,19,3,9,"low"
43,"SUPPRF94497",100,0,38,-7,1,"88",37,45,3,9,"low"
44,"SUPPRF94497",81,0,62,13,-1,"81",63,49,3,9,"low"
45,"SUPPRF94497",90,0,61,28,24,"63",37,33,3,9,"low"
46,"SUPPRF94497",57,0,15,-20,-14,"84",29,35,3,9,"low"
47,"SUPPRF94497",75,0,28,4,-1,"85",29,24,3,9,"low"
48,"SUPPRF94497",80,0,29,5,0,"84",29,24,3,9,"low"
1,"SUPPRF15709",51,42,68,31,-12,"16",80,37,7,9,"high"
2,"SUPPRF15709",28,35,63,31,0,"17",63,32,7,9,"high"
3,"SUPPRF15709",44,63,46,19,0,"13",46,27,7,9,"high"
4,"SUPPRF15709",44,24,80,62,0,"16",80,18,7,9,"high"
5,"SUPPRF15709",43,36,47,22,-16,"32",63,25,7,9,"high"
6,"SUPPRF15709",45,46,22,7,-15,"55",37,15,7,9,"high"
7,"SUPPRF15709",42,36,55,33,1,"19",54,22,7,9,"high"
8,"SUPPRF15709",33,34,49,20,12,"13",37,29,7,9,"high"
9,"SUPPRF15709",39,41,50,23,-13,"12",63,27,7,9,"high"
10,"SUPPRF15709",46,44,100,64,20,"14",80,36,7,9,"high"
11,"SUPPRF15709",41,46,34,13,-12,"74",46,21,7,9,"high"
12,"SUPPRF15709",45,41,77,48,14,"67",63,29,7,9,"high"
13,"SUPPRF15709",35,46,24,-8,-13,"42",37,32,7,9,"high"
14,"SUPPRF15709",46,37,71,45,0,"70",71,26,7,9,"high"
15,"SUPPRF15709",28,29,67,45,-13,"26",80,22,7,9,"high"
16,"SUPPRF15709",36,36,16,-12,-13,"22",29,28,7,9,"high"
17,"SUPPRF15709",27,28,46,14,17,"27",29,32,7,9,"high"
18,"SUPPRF15709",39,30,55,31,-16,"37",71,24,7,9,"high"
19,"SUPPRF15709",30,40,33,3,-13,"45",46,30,7,9,"high"
20,"SUPPRF15709",20,53,47,14,27,"7",20,33,7,9,"high"
21,"SUPPRF15709",20,34,88,69,25,"77",63,19,7,9,"high"
22,"SUPPRF15709",17,46,38,11,1,"9",37,27,7,9,"high"
23,"SUPPRF15709",17,44,38,15,-16,"55",54,23,7,9,"high"
24,"SUPPRF15709",34,43,66,39,12,"4",54,27,7,9,"high"
25,"SUPPRF15709",33,43,41,6,-13,"20",54,35,7,9,"high"
26,"SUPPRF15709",41,28,94,77,23,"7",71,17,7,9,"high"
27,"SUPPRF15709",11,33,56,34,-15,"7",71,22,7,9,"high"
28,"SUPPRF15709",15,20,20,5,0,"54",20,15,7,9,"high"
29,"SUPPRF15709",18,66,81,41,1,"65",80,40,7,9,"high"
30,"SUPPRF15709",25,46,58,23,29,"9",29,35,7,9,"high"
31,"SUPPRF15709",34,22,28,-9,-1,"16",29,37,7,9,"high"
32,"SUPPRF15709",23,60,61,27,24,"19",37,34,7,9,"high"
33,"SUPPRF15709",23,56,8,-12,-12,"55",20,20,7,9,"high"
34,"SUPPRF15709",33,33,70,29,-1,"14",71,41,7,9,"high"
35,"SUPPRF15709",26,56,45,17,-1,"11",46,28,7,9,"high"
36,"SUPPRF15709",25,28,29,-4,0,"14",29,33,7,9,"high"
37,"SUPPRF15709",46,27,58,40,12,"80",46,18,7,9,"high"
38,"SUPPRF15709",33,29,54,28,0,"42",54,26,7,9,"high"
39,"SUPPRF15709",35,31,83,59,12,"14",71,24,7,9,"high"
40,"SUPPRF15709",24,22,15,-7,-14,"15",29,22,7,9,"high"
41,"SUPPRF15709",46,38,35,20,15,"75",20,15,7,9,"high"
42,"SUPPRF15709",27,26,6,-32,-14,"35",20,38,7,9,"high"
43,"SUPPRF15709",35,37,75,44,29,"9",46,31,7,9,"high"
44,"SUPPRF15709",32,33,96,74,16,"11",80,22,7,9,"high"
45,"SUPPRF15709",28,31,37,11,0,"12",37,26,7,9,"high"
46,"SUPPRF15709",45,24,19,-18,-1,"36",20,37,7,9,"high"
47,"SUPPRF15709",42,30,78,49,24,"6",54,29,7,9,"high"
48,"SUPPRF15709",34,33,62,32,-1,"39",63,30,7,9,"high"
1,"SUPPRF43675",75,37,88,65,25,"53",63,23,3,9,"low"
2,"SUPPRF43675",58,55,6,-9,-14,"48",20,15,3,9,"low"
3,"SUPPRF43675",59,66,46,-3,17,"57",29,49,3,9,"low"
4,"SUPPRF43675",48,60,24,-28,-13,"72",37,52,3,9,"low"
5,"SUPPRF43675",55,57,34,23,-12,"55",46,11,3,9,"low"
6,"SUPPRF43675",54,67,62,19,-1,"26",63,43,3,9,"low"
7,"SUPPRF43675",65,59,81,16,1,"66",80,65,3,9,"low"
8,"SUPPRF43675",67,69,37,-12,0,"51",37,49,3,9,"low"
9,"SUPPRF43675",65,63,68,-4,-12,"63",80,72,3,9,"low"
10,"SUPPRF43675",66,69,100,57,20,"71",80,43,3,9,"low"
11,"SUPPRF43675",60,63,63,12,0,"59",63,51,3,9,"low"
12,"SUPPRF43675",47,59,15,-26,-14,"61",29,41,3,9,"low"
13,"SUPPRF43675",55,63,83,76,12,"40",71,7,3,9,"low"
14,"SUPPRF43675",69,71,78,12,24,"53",54,66,3,9,"low"
15,"SUPPRF43675",51,58,71,30,0,"61",71,41,3,9,"low"
16,"SUPPRF43675",70,61,47,37,27,"73",20,10,3,9,"low"
17,"SUPPRF43675",70,75,38,-6,1,"62",37,44,3,9,"low"
18,"SUPPRF43675",71,65,38,3,-16,"59",54,35,3,9,"low"
19,"SUPPRF43675",70,74,54,16,0,"68",54,38,3,9,"low"
20,"SUPPRF43675",72,70,58,7,29,"73",29,51,3,9,"low"
21,"SUPPRF43675",70,70,22,-30,-15,"67",37,52,3,9,"low"
22,"SUPPRF43675",73,63,28,17,-1,"76",29,11,3,9,"low"
23,"SUPPRF43675",57,69,20,-19,0,"55",20,39,3,9,"low"
24,"SUPPRF43675",65,69,66,9,12,"67",54,57,3,9,"low"
25,"SUPPRF43675",64,63,70,52,-1,"50",71,18,3,9,"low"
26,"SUPPRF43675",68,73,56,-6,-15,"34",71,62,3,9,"low"
27,"SUPPRF43675",74,67,58,30,12,"48",46,28,3,9,"low"
28,"SUPPRF43675",69,68,61,22,24,"58",37,39,3,9,"low"
29,"SUPPRF43675",48,55,8,-15,-12,"55",20,23,3,9,"low"
30,"SUPPRF43675",74,72,75,64,29,"57",46,11,3,9,"low"
31,"SUPPRF43675",54,65,94,36,23,"58",71,58,3,9,"low"
32,"SUPPRF43675",59,72,47,2,-16,"61",63,45,3,9,"low"
33,"SUPPRF43675",78,74,96,24,16,"21",80,72,3,9,"low"
34,"SUPPRF43675",69,71,35,29,15,"37",20,6,3,9,"low"
35,"SUPPRF43675",65,77,77,33,14,"53",63,44,3,9,"low"
36,"SUPPRF43675",72,64,49,4,12,"34",37,45,3,9,"low"
37,"SUPPRF43675",75,71,80,16,0,"29",80,64,3,9,"low"
38,"SUPPRF43675",70,66,55,31,1,"69",54,24,3,9,"low"
39,"SUPPRF43675",66,77,46,-5,0,"57",46,51,3,9,"low"
40,"SUPPRF43675",73,52,33,-7,-13,"64",46,40,3,9,"low"
41,"SUPPRF43675",65,56,19,15,-1,"54",20,4,3,9,"low"
42,"SUPPRF43675",60,74,16,-20,-13,"53",29,36,3,9,"low"
43,"SUPPRF43675",53,72,41,17,-13,"50",54,24,3,9,"low"
44,"SUPPRF43675",74,67,29,-21,0,"66",29,50,3,9,"low"
45,"SUPPRF43675",78,79,45,3,-1,"60",46,42,3,9,"low"
46,"SUPPRF43675",72,64,55,25,-16,"56",71,30,3,9,"low"
47,"SUPPRF43675",74,58,50,0,-13,"71",63,50,3,9,"low"
48,"SUPPRF43675",78,46,67,31,-13,"59",80,36,3,9,"low"
1,"SUPPRF43222",48,24,29,-51,0,"66",29,80,6,9,"high"
2,"SUPPRF43222",47,17,56,-34,-15,"69",71,90,6,9,"high"
3,"SUPPRF43222",50,30,63,-4,0,"57",63,67,6,9,"high"
4,"SUPPRF43222",49,26,68,6,-12,"41",80,62,6,9,"high"
5,"SUPPRF43222",50,20,8,-59,-12,"60",20,67,6,9,"high"
6,"SUPPRF43222",50,13,46,-30,0,"71",46,76,6,9,"high"
7,"SUPPRF43222",50,18,47,-26,-16,"74",63,73,6,9,"high"
8,"SUPPRF43222",48,24,6,-68,-14,"67",20,74,6,9,"high"
9,"SUPPRF43222",51,14,80,24,0,"67",80,56,6,9,"high"
10,"SUPPRF43222",50,16,41,-30,-13,"82",54,71,6,9,"high"
11,"SUPPRF43222",49,22,71,26,0,"46",71,45,6,9,"high"
12,"SUPPRF43222",51,24,35,2,15,"67",20,33,6,9,"high"
13,"SUPPRF43222",55,26,81,7,1,"65",80,74,6,9,"high"
14,"SUPPRF43222",51,22,100,10,20,"62",80,90,6,9,"high"
15,"SUPPRF43222",47,15,50,-13,-13,"41",63,63,6,9,"high"
16,"SUPPRF43222",49,18,24,-54,-13,"70",37,78,6,9,"high"
17,"SUPPRF43222",50,25,77,7,14,"69",63,70,6,9,"high"
18,"SUPPRF43222",48,30,58,-8,29,"63",29,66,6,9,"high"
19,"SUPPRF43222",50,13,55,-18,1,"64",54,73,6,9,"high"
20,"SUPPRF43222",49,13,61,21,24,"73",37,40,6,9,"high"
21,"SUPPRF43222",50,22,33,-9,-13,"72",46,42,6,9,"high"
22,"SUPPRF43222",48,21,94,7,23,"77",71,87,6,9,"high"
23,"SUPPRF43222",49,24,49,-15,12,"40",37,64,6,9,"high"
24,"SUPPRF43222",47,14,45,-36,-1,"71",46,81,6,9,"high"
25,"SUPPRF43222",50,25,83,-1,12,"58",71,84,6,9,"high"
26,"SUPPRF43222",57,31,19,-50,-1,"42",20,69,6,9,"high"
27,"SUPPRF43222",51,26,78,11,24,"46",54,67,6,9,"high"
28,"SUPPRF43222",49,21,34,-49,-12,"62",46,83,6,9,"high"
29,"SUPPRF43222",54,24,46,-23,17,"37",29,69,6,9,"high"
30,"SUPPRF43222",50,21,67,-10,-13,"78",80,77,6,9,"high"
31,"SUPPRF43222",49,17,22,-40,-15,"43",37,62,6,9,"high"
32,"SUPPRF43222",50,26,58,-7,12,"40",46,65,6,9,"high"
33,"SUPPRF43222",53,19,75,9,29,"39",46,66,6,9,"high"
34,"SUPPRF43222",53,15,16,-29,-13,"67",29,45,6,9,"high"
35,"SUPPRF43222",49,22,28,-32,-1,"41",29,60,6,9,"high"
36,"SUPPRF43222",52,27,66,-11,12,"75",54,77,6,9,"high"
37,"SUPPRF43222",48,12,37,7,0,"81",37,30,6,9,"high"
38,"SUPPRF43222",48,21,62,-4,-1,"40",63,66,6,9,"high"
39,"SUPPRF43222",50,36,38,-9,-16,"65",54,47,6,9,"high"
40,"SUPPRF43222",48,23,47,1,27,"61",20,46,6,9,"high"
41,"SUPPRF43222",49,15,15,-54,-14,"33",29,69,6,9,"high"
42,"SUPPRF43222",50,20,88,26,25,"38",63,62,6,9,"high"
43,"SUPPRF43222",49,18,38,-42,1,"37",37,80,6,9,"high"
44,"SUPPRF43222",48,16,20,-47,0,"39",20,67,6,9,"high"
45,"SUPPRF43222",51,18,96,10,16,"62",80,86,6,9,"high"
46,"SUPPRF43222",50,14,70,4,-1,"40",71,66,6,9,"high"
47,"SUPPRF43222",44,20,54,-9,0,"41",54,63,6,9,"high"
48,"SUPPRF43222",51,16,55,-24,-16,"57",71,79,6,9,"high"
1,"SUPPRF78720",49,51,58,18,29,"59",29,40,7,9,"high"
2,"SUPPRF78720",54,49,62,1,-1,"49",63,61,7,9,"high"
3,"SUPPRF78720",49,50,29,-7,0,"50",29,36,7,9,"high"
4,"SUPPRF78720",50,30,41,-2,-13,"49",54,43,7,9,"high"
5,"SUPPRF78720",61,28,80,5,0,"69",80,75,7,9,"high"
6,"SUPPRF78720",54,26,63,12,0,"31",63,51,7,9,"high"
7,"SUPPRF78720",54,26,96,59,16,"51",80,37,7,9,"high"
8,"SUPPRF78720",53,37,33,-28,-13,"32",46,61,7,9,"high"
9,"SUPPRF78720",51,32,19,6,-1,"66",20,13,7,9,"high"
10,"SUPPRF78720",55,51,38,-1,1,"37",37,39,7,9,"high"
11,"SUPPRF78720",50,44,58,-3,12,"54",46,61,7,9,"high"
12,"SUPPRF78720",52,49,47,20,27,"57",20,27,7,9,"high"
13,"SUPPRF78720",49,47,94,47,23,"45",71,47,7,9,"high"
14,"SUPPRF78720",50,50,70,5,-1,"65",71,65,7,9,"high"
15,"SUPPRF78720",47,51,71,9,0,"45",71,62,7,9,"high"
16,"SUPPRF78720",57,38,100,29,20,"59",80,71,7,9,"high"
17,"SUPPRF78720",49,49,77,19,14,"44",63,58,7,9,"high"
18,"SUPPRF78720",51,51,68,1,-12,"50",80,67,7,9,"high"
19,"SUPPRF78720",50,48,66,17,12,"46",54,49,7,9,"high"
20,"SUPPRF78720",49,51,83,31,12,"67",71,52,7,9,"high"
21,"SUPPRF78720",50,52,22,-2,-15,"59",37,24,7,9,"high"
22,"SUPPRF78720",50,50,75,38,29,"29",46,37,7,9,"high"
23,"SUPPRF78720",49,48,38,-2,-16,"61",54,40,7,9,"high"
24,"SUPPRF78720",49,48,46,-3,17,"27",29,49,7,9,"high"
25,"SUPPRF78720",49,50,61,10,24,"38",37,51,7,9,"high"
26,"SUPPRF78720",48,49,24,-20,-13,"31",37,44,7,9,"high"
27,"SUPPRF78720",51,51,28,5,-1,"58",29,23,7,9,"high"
28,"SUPPRF78720",50,51,37,-2,0,"49",37,39,7,9,"high"
29,"SUPPRF78720",49,51,56,12,-15,"49",71,44,7,9,"high"
30,"SUPPRF78720",49,50,15,-24,-14,"66",29,39,7,9,"high"
31,"SUPPRF78720",49,51,20,-41,0,"47",20,61,7,9,"high"
32,"SUPPRF78720",49,50,81,24,1,"59",80,57,7,9,"high"
33,"SUPPRF78720",51,51,49,-14,12,"50",37,63,7,9,"high"
34,"SUPPRF78720",49,48,6,-23,-14,"31",20,29,7,9,"high"
35,"SUPPRF78720",51,50,47,-9,-16,"44",63,56,7,9,"high"
36,"SUPPRF78720",49,50,50,10,-13,"21",63,40,7,9,"high"
37,"SUPPRF78720",50,49,67,56,-13,"63",80,11,7,9,"high"
38,"SUPPRF78720",51,51,88,34,25,"60",63,54,7,9,"high"
39,"SUPPRF78720",51,51,78,16,24,"54",54,62,7,9,"high"
40,"SUPPRF78720",52,50,35,-14,15,"21",20,49,7,9,"high"
41,"SUPPRF78720",50,50,16,-8,-13,"68",29,24,7,9,"high"
42,"SUPPRF78720",48,48,34,28,-12,"99",46,6,7,9,"high"
43,"SUPPRF78720",49,50,45,11,-1,"42",46,34,7,9,"high"
44,"SUPPRF78720",48,49,46,-1,0,"64",46,47,7,9,"high"
45,"SUPPRF78720",51,51,54,19,0,"60",54,35,7,9,"high"
46,"SUPPRF78720",49,47,55,18,-16,"24",71,37,7,9,"high"
47,"SUPPRF78720",49,50,55,6,1,"76",54,49,7,9,"high"
48,"SUPPRF78720",41,54,8,-35,-12,"64",20,43,7,9,"high"
1,"SUPPRF28694",68,49,62,50,-1,"11",63,12,9,9,"high"
2,"SUPPRF28694",63,20,63,43,0,"29",63,20,9,9,"high"
3,"SUPPRF28694",79,20,54,22,0,"25",54,32,9,9,"high"
4,"SUPPRF28694",49,29,22,-20,-15,"22",37,42,9,9,"high"
5,"SUPPRF28694",75,25,83,33,12,"52",71,50,9,9,"high"
6,"SUPPRF28694",61,15,41,-11,-13,"41",54,52,9,9,"high"
7,"SUPPRF28694",74,18,81,59,1,"56",80,22,9,9,"high"
8,"SUPPRF28694",68,15,75,25,29,"14",46,50,9,9,"high"
9,"SUPPRF28694",100,6,100,60,20,"15",80,40,9,9,"high"
10,"SUPPRF28694",67,20,20,-53,0,"65",20,73,9,9,"high"
11,"SUPPRF28694",60,15,55,-13,-16,"52",71,68,9,9,"high"
12,"SUPPRF28694",47,24,33,1,-13,"16",46,32,9,9,"high"
13,"SUPPRF28694",66,14,24,-1,-13,"24",37,25,9,9,"high"
14,"SUPPRF28694",56,18,55,32,1,"25",54,23,9,9,"high"
15,"SUPPRF28694",15,23,8,-7,-12,"14",20,15,9,9,"high"
16,"SUPPRF28694",54,18,56,-5,-15,"45",71,61,9,9,"high"
17,"SUPPRF28694",33,32,15,-23,-14,"33",29,38,9,9,"high"
18,"SUPPRF28694",21,26,58,27,29,"28",29,31,9,9,"high"
19,"SUPPRF28694",26,22,66,32,12,"22",54,34,9,9,"high"
20,"SUPPRF28694",39,20,50,-13,-13,"19",63,63,9,9,"high"
21,"SUPPRF28694",51,13,28,9,-1,"54",29,19,9,9,"high"
22,"SUPPRF28694",79,20,94,66,23,"30",71,28,9,9,"high"
23,"SUPPRF28694",28,30,46,13,0,"35",46,33,9,9,"high"
24,"SUPPRF28694",35,37,77,37,14,"7",63,40,9,9,"high"
25,"SUPPRF28694",56,34,68,18,-12,"20",80,50,9,9,"high"
26,"SUPPRF28694",50,22,38,-4,1,"24",37,42,9,9,"high"
27,"SUPPRF28694",42,27,80,53,0,"42",80,27,9,9,"high"
28,"SUPPRF28694",38,30,35,-13,15,"40",20,48,9,9,"high"
29,"SUPPRF28694",44,35,49,-2,12,"41",37,51,9,9,"high"
30,"SUPPRF28694",39,25,45,0,-1,"46",46,45,9,9,"high"
31,"SUPPRF28694",45,29,34,-7,-12,"30",46,41,9,9,"high"
32,"SUPPRF28694",40,24,78,58,24,"8",54,20,9,9,"high"
33,"SUPPRF28694",36,32,38,8,-16,"38",54,30,9,9,"high"
34,"SUPPRF28694",44,29,70,26,-1,"4",71,44,9,9,"high"
35,"SUPPRF28694",34,50,37,15,0,"13",37,22,9,9,"high"
36,"SUPPRF28694",40,42,47,30,-16,"41",63,17,9,9,"high"
37,"SUPPRF28694",46,29,19,-16,-1,"26",20,35,9,9,"high"
38,"SUPPRF28694",57,54,67,31,-13,"42",80,36,9,9,"high"
39,"SUPPRF28694",27,26,16,-20,-13,"24",29,36,9,9,"high"
40,"SUPPRF28694",38,34,47,30,27,"23",20,17,9,9,"high"
41,"SUPPRF28694",28,21,71,44,0,"20",71,27,9,9,"high"
42,"SUPPRF28694",56,8,46,5,17,"22",29,41,9,9,"high"
43,"SUPPRF28694",67,24,88,44,25,"33",63,44,9,9,"high"
44,"SUPPRF28694",20,15,61,24,24,"21",37,37,9,9,"high"
45,"SUPPRF28694",32,37,6,-21,-14,"25",20,27,9,9,"high"
46,"SUPPRF28694",43,40,58,26,12,"39",46,32,9,9,"high"
47,"SUPPRF28694",35,23,29,9,0,"28",29,20,9,9,"high"
48,"SUPPRF28694",26,23,96,83,16,"6",80,13,9,9,"high"
1,"SUPPRF90079",71,28,16,-11,-13,"88",29,27,9,9,"high"
2,"SUPPRF90079",89,6,35,26,15,"96",20,9,9,9,"high"
3,"SUPPRF90079",79,12,50,-25,-13,"71",63,75,9,9,"high"
4,"SUPPRF90079",88,12,47,3,27,"63",20,44,9,9,"high"
5,"SUPPRF90079",90,12,61,10,24,"73",37,51,9,9,"high"
6,"SUPPRF90079",84,12,19,-46,-1,"63",20,65,9,9,"high"
7,"SUPPRF90079",80,8,20,-43,0,"31",20,63,9,9,"high"
8,"SUPPRF90079",89,6,71,9,0,"25",71,62,9,9,"high"
9,"SUPPRF90079",86,10,46,-4,17,"25",29,50,9,9,"high"
10,"SUPPRF90079",89,8,8,-71,-12,"14",20,79,9,9,"high"
11,"SUPPRF90079",94,7,15,-85,-14,"22",29,100,9,9,"high"
12,"SUPPRF90079",87,7,58,2,12,"59",46,56,9,9,"high"
13,"SUPPRF90079",88,9,67,8,-13,"10",80,59,9,9,"high"
14,"SUPPRF90079",87,10,38,-18,1,"73",37,56,9,9,"high"
15,"SUPPRF90079",87,7,29,-41,0,"22",29,70,9,9,"high"
16,"SUPPRF90079",87,12,38,-23,-16,"12",54,61,9,9,"high"
17,"SUPPRF90079",87,5,24,-43,-13,"15",37,67,9,9,"high"
18,"SUPPRF90079",97,5,63,-17,0,"18",63,80,9,9,"high"
19,"SUPPRF90079",90,7,100,27,20,"19",80,73,9,9,"high"
20,"SUPPRF90079",88,7,41,-38,-13,"16",54,79,9,9,"high"
21,"SUPPRF90079",86,9,33,-9,-13,"29",46,42,9,9,"high"
22,"SUPPRF90079",85,10,55,-15,-16,"14",71,70,9,9,"high"
23,"SUPPRF90079",100,0,37,-52,0,"60",37,89,9,9,"high"
24,"SUPPRF90079",100,2,58,-15,29,"22",29,73,9,9,"high"
25,"SUPPRF90079",86,10,68,-22,-12,"11",80,90,9,9,"high"
26,"SUPPRF90079",83,8,34,-32,-12,"75",46,66,9,9,"high"
27,"SUPPRF90079",83,18,47,-25,-16,"16",63,72,9,9,"high"
28,"SUPPRF90079",86,11,80,8,0,"15",80,72,9,9,"high"
29,"SUPPRF90079",91,9,83,14,12,"18",71,69,9,9,"high"
30,"SUPPRF90079",80,11,49,-17,12,"12",37,66,9,9,"high"
31,"SUPPRF90079",87,14,94,19,23,"18",71,75,9,9,"high"
32,"SUPPRF90079",91,5,96,30,16,"69",80,66,9,9,"high"
33,"SUPPRF90079",91,11,78,7,24,"19",54,71,9,9,"high"
34,"SUPPRF90079",85,13,45,-30,-1,"19",46,75,9,9,"high"
35,"SUPPRF90079",81,13,22,-54,-15,"11",37,76,9,9,"high"
36,"SUPPRF90079",95,9,62,-4,-1,"20",63,66,9,9,"high"
37,"SUPPRF90079",91,8,75,60,29,"12",46,15,9,9,"high"
38,"SUPPRF90079",92,7,81,13,1,"15",80,68,9,9,"high"
39,"SUPPRF90079",89,11,54,2,0,"14",54,52,9,9,"high"
40,"SUPPRF90079",88,14,88,39,25,"20",63,49,9,9,"high"
41,"SUPPRF90079",89,12,55,4,1,"24",54,51,9,9,"high"
42,"SUPPRF90079",84,13,77,46,14,"74",63,31,9,9,"high"
43,"SUPPRF90079",87,10,70,11,-1,"22",71,59,9,9,"high"
44,"SUPPRF90079",69,17,66,38,12,"22",54,28,9,9,"high"
45,"SUPPRF90079",85,13,28,-33,-1,"16",29,61,9,9,"high"
46,"SUPPRF90079",80,19,46,11,0,"20",46,35,9,9,"high"
47,"SUPPRF90079",81,11,56,7,-15,"76",71,49,9,9,"high"
48,"SUPPRF90079",84,11,6,-71,-14,"24",20,77,9,9,"high"
1,"SUPPRF04190",51,38,75,31,29,"72",46,44,12,9,"high"
2,"SUPPRF04190",73,25,81,-7,1,"85",80,88,12,9,"high"
3,"SUPPRF04190",40,41,35,25,15,"58",20,10,12,9,"high"
4,"SUPPRF04190",58,65,96,3,16,"75",80,93,12,9,"high"
5,"SUPPRF04190",52,37,50,-19,-13,"62",63,69,12,9,"high"
6,"SUPPRF04190",53,51,70,-6,-1,"74",71,76,12,9,"high"
7,"SUPPRF04190",53,50,6,-10,-14,"54",20,16,12,9,"high"
8,"SUPPRF04190",48,50,19,2,-1,"63",20,17,12,9,"high"
9,"SUPPRF04190",51,50,56,13,-15,"10",71,43,12,9,"high"
10,"SUPPRF04190",51,49,29,-25,0,"39",29,54,12,9,"high"
11,"SUPPRF04190",48,48,16,-11,-13,"47",29,27,12,9,"high"
12,"SUPPRF04190",47,51,24,-8,-13,"50",37,32,12,9,"high"
13,"SUPPRF04190",50,48,66,24,12,"65",54,42,12,9,"high"
14,"SUPPRF04190",38,59,71,50,0,"45",71,21,12,9,"high"
15,"SUPPRF04190",48,50,46,5,17,"56",29,41,12,9,"high"
16,"SUPPRF04190",47,49,20,-6,0,"36",20,26,12,9,"high"
17,"SUPPRF04190",52,50,61,20,24,"45",37,41,12,9,"high"
18,"SUPPRF04190",48,49,83,29,12,"54",71,54,12,9,"high"
19,"SUPPRF04190",52,52,41,-20,-13,"63",54,61,12,9,"high"
20,"SUPPRF04190",61,43,100,36,20,"26",80,64,12,9,"high"
21,"SUPPRF04190",53,52,67,-33,-13,"73",80,100,12,9,"high"
22,"SUPPRF04190",52,50,88,39,25,"13",63,49,12,9,"high"
23,"SUPPRF04190",51,50,55,8,-16,"64",71,47,12,9,"high"
24,"SUPPRF04190",51,51,38,-10,1,"51",37,48,12,9,"high"
25,"SUPPRF04190",51,51,58,20,29,"62",29,38,12,9,"high"
26,"SUPPRF04190",54,49,49,0,12,"48",37,49,12,9,"high"
27,"SUPPRF04190",51,51,8,-30,-12,"38",20,38,12,9,"high"
28,"SUPPRF04190",50,51,62,21,-1,"5",63,41,12,9,"high"
29,"SUPPRF04190",48,51,78,37,24,"81",54,41,12,9,"high"
30,"SUPPRF04190",52,52,46,3,0,"48",46,43,12,9,"high"
31,"SUPPRF04190",51,50,58,5,12,"74",46,53,12,9,"high"
32,"SUPPRF04190",50,50,22,-10,-15,"21",37,32,12,9,"high"
33,"SUPPRF04190",52,51,94,27,23,"67",71,67,12,9,"high"
34,"SUPPRF04190",48,48,33,-16,-13,"49",46,49,12,9,"high"
35,"SUPPRF04190",51,48,54,8,0,"11",54,46,12,9,"high"
36,"SUPPRF04190",46,48,28,-8,-1,"9",29,36,12,9,"high"
37,"SUPPRF04190",51,48,55,-3,1,"10",54,58,12,9,"high"
38,"SUPPRF04190",51,51,37,-10,0,"21",37,47,12,9,"high"
39,"SUPPRF04190",50,51,63,12,0,"51",63,51,12,9,"high"
40,"SUPPRF04190",50,47,47,12,-16,"49",63,35,12,9,"high"
41,"SUPPRF04190",53,51,34,-6,-12,"65",46,40,12,9,"high"
42,"SUPPRF04190",58,57,80,15,0,"35",80,65,12,9,"high"
43,"SUPPRF04190",49,48,47,4,27,"49",20,43,12,9,"high"
44,"SUPPRF04190",48,49,77,70,14,"20",63,7,12,9,"high"
45,"SUPPRF04190",51,52,38,-32,-16,"82",54,70,12,9,"high"
46,"SUPPRF04190",50,50,68,16,-12,"52",80,52,12,9,"high"
47,"SUPPRF04190",51,49,45,-20,-1,"77",46,65,12,9,"high"
48,"SUPPRF04190",50,50,15,-26,-14,"48",29,41,12,9,"high"
1,"SUPPRF17949",93,5,33,-11,-13,"7",46,44,3,9,"low"
2,"SUPPRF17949",89,6,16,-19,-13,"21",29,35,3,9,"low"
3,"SUPPRF17949",89,7,38,10,1,"6",37,28,3,9,"low"
4,"SUPPRF17949",94,7,49,16,12,"14",37,33,3,9,"low"
5,"SUPPRF17949",94,6,28,8,-1,"30",29,20,3,9,"low"
6,"SUPPRF17949",89,10,55,-20,-16,"50",71,75,3,9,"low"
7,"SUPPRF17949",96,7,55,0,1,"20",54,55,3,9,"low"
8,"SUPPRF17949",94,4,34,4,-12,"15",46,30,3,9,"low"
9,"SUPPRF17949",94,5,58,43,29,"21",29,15,3,9,"low"
10,"SUPPRF17949",94,7,56,-4,-15,"29",71,60,3,9,"low"
11,"SUPPRF17949",93,6,45,-5,-1,"30",46,50,3,9,"low"
12,"SUPPRF17949",95,5,77,13,14,"28",63,64,3,9,"low"
13,"SUPPRF17949",94,9,15,-35,-14,"29",29,50,3,9,"low"
14,"SUPPRF17949",90,9,29,4,0,"19",29,25,3,9,"low"
15,"SUPPRF17949",86,9,67,16,-13,"17",80,51,3,9,"low"
16,"SUPPRF17949",83,12,38,-8,-16,"70",54,46,3,9,"low"
17,"SUPPRF17949",84,16,71,22,0,"82",71,49,3,9,"low"
18,"SUPPRF17949",67,22,88,40,25,"33",63,48,3,9,"low"
19,"SUPPRF17949",72,22,35,-15,15,"25",20,50,3,9,"low"
20,"SUPPRF17949",65,33,83,26,12,"33",71,57,3,9,"low"
21,"SUPPRF17949",62,34,63,2,0,"25",63,61,3,9,"low"
22,"SUPPRF17949",77,38,66,30,12,"23",54,36,3,9,"low"
23,"SUPPRF17949",60,38,96,48,16,"43",80,48,3,9,"low"
24,"SUPPRF17949",68,28,81,6,1,"64",80,75,3,9,"low"
25,"SUPPRF17949",71,34,22,-33,-15,"47",37,55,3,9,"low"
26,"SUPPRF17949",59,40,8,-7,-12,"81",20,15,3,9,"low"
27,"SUPPRF17949",53,40,80,57,0,"57",80,23,3,9,"low"
28,"SUPPRF17949",64,30,54,12,0,"34",54,42,3,9,"low"
29,"SUPPRF17949",54,47,47,5,-16,"49",63,42,3,9,"low"
30,"SUPPRF17949",62,44,50,-4,-13,"35",63,54,3,9,"low"
31,"SUPPRF17949",51,51,61,29,24,"16",37,32,3,9,"low"
32,"SUPPRF17949",52,46,62,13,-1,"17",63,49,3,9,"low"
33,"SUPPRF17949",50,50,47,1,27,"35",20,46,3,9,"low"
34,"SUPPRF17949",56,41,78,31,24,"17",54,47,3,9,"low"
35,"SUPPRF17949",48,53,100,48,20,"34",80,52,3,9,"low"
36,"SUPPRF17949",45,51,41,-13,-13,"60",54,54,3,9,"low"
37,"SUPPRF17949",45,60,20,-18,0,"23",20,38,3,9,"low"
38,"SUPPRF17949",39,56,24,-8,-13,"26",37,32,3,9,"low"
39,"SUPPRF17949",44,47,46,-28,0,"78",46,74,3,9,"low"
40,"SUPPRF17949",82,48,37,2,0,"66",37,35,3,9,"low"
41,"SUPPRF17949",100,30,94,26,23,"69",71,68,3,9,"low"
42,"SUPPRF17949",49,30,58,32,12,"57",46,26,3,9,"low"
43,"SUPPRF17949",51,48,46,-14,17,"30",29,60,3,9,"low"
44,"SUPPRF17949",33,79,75,40,29,"86",46,35,3,9,"low"
45,"SUPPRF17949",46,51,70,-8,-1,"57",71,78,3,9,"low"
46,"SUPPRF17949",52,31,6,-20,-14,"7",20,26,3,9,"low"
47,"SUPPRF17949",52,50,19,5,-1,"94",20,14,3,9,"low"
48,"SUPPRF17949",57,49,68,-21,-12,"70",80,89,3,9,"low"
1,"SUPPRF62253",62,31,54,-1,0,"45",54,55,0,9,"low"
2,"SUPPRF62253",57,34,61,2,24,"60",37,59,0,9,"low"
3,"SUPPRF62253",46,54,38,-31,1,"54",37,69,0,9,"low"
4,"SUPPRF62253",68,28,66,6,12,"56",54,60,0,9,"low"
5,"SUPPRF62253",57,35,19,-29,-1,"60",20,48,0,9,"low"
6,"SUPPRF62253",28,56,55,-14,-16,"56",71,69,0,9,"low"
7,"SUPPRF62253",65,31,45,-16,-1,"28",46,61,0,9,"low"
8,"SUPPRF62253",31,67,47,-1,27,"53",20,48,0,9,"low"
9,"SUPPRF62253",67,57,80,17,0,"61",80,63,0,9,"low"
10,"SUPPRF62253",55,33,49,-11,12,"49",37,60,0,9,"low"
11,"SUPPRF62253",63,64,83,24,12,"52",71,59,0,9,"low"
12,"SUPPRF62253",57,36,62,-9,-1,"45",63,71,0,9,"low"
13,"SUPPRF62253",62,40,41,-13,-13,"54",54,54,0,9,"low"
14,"SUPPRF62253",62,41,81,9,1,"60",80,72,0,9,"low"
15,"SUPPRF62253",36,49,16,-49,-13,"54",29,65,0,9,"low"
16,"SUPPRF62253",70,19,100,44,20,"52",80,56,0,9,"low"
17,"SUPPRF62253",53,55,28,-32,-1,"50",29,60,0,9,"low"
18,"SUPPRF62253",58,47,94,29,23,"55",71,65,0,9,"low"
19,"SUPPRF62253",49,49,8,-51,-12,"51",20,59,0,9,"low"
20,"SUPPRF62253",60,37,68,9,-12,"48",80,59,0,9,"low"
21,"SUPPRF62253",52,52,29,-30,0,"54",29,59,0,9,"low"
22,"SUPPRF62253",49,49,58,-1,12,"49",46,59,0,9,"low"
23,"SUPPRF62253",48,47,20,-26,0,"49",20,46,0,9,"low"
24,"SUPPRF62253",45,40,67,14,-13,"57",80,53,0,9,"low"
25,"SUPPRF62253",51,48,47,-11,-16,"57",63,58,0,9,"low"
26,"SUPPRF62253",48,48,33,-20,-13,"52",46,53,0,9,"low"
27,"SUPPRF62253",48,49,6,-54,-14,"51",20,60,0,9,"low"
28,"SUPPRF62253",53,50,15,-39,-14,"51",29,54,0,9,"low"
29,"SUPPRF62253",48,49,22,-26,-15,"49",37,48,0,9,"low"
30,"SUPPRF62253",54,49,58,11,29,"52",29,47,0,9,"low"
31,"SUPPRF62253",49,52,38,-26,-16,"65",54,64,0,9,"low"
32,"SUPPRF62253",49,48,37,-13,0,"48",37,50,0,9,"low"
33,"SUPPRF62253",47,56,63,13,0,"48",63,50,0,9,"low"
34,"SUPPRF62253",46,50,77,28,14,"50",63,49,0,9,"low"
35,"SUPPRF62253",58,57,78,28,24,"49",54,50,0,9,"low"
36,"SUPPRF62253",52,53,75,25,29,"51",46,50,0,9,"low"
37,"SUPPRF62253",79,30,96,44,16,"51",80,52,0,9,"low"
38,"SUPPRF62253",51,50,24,-23,-13,"44",37,47,0,9,"low"
39,"SUPPRF62253",51,48,56,6,-15,"49",71,50,0,9,"low"
40,"SUPPRF62253",49,50,34,-17,-12,"51",46,51,0,9,"low"
41,"SUPPRF62253",59,58,71,21,0,"52",71,50,0,9,"low"
42,"SUPPRF62253",50,55,50,-3,-13,"50",63,53,0,9,"low"
43,"SUPPRF62253",50,52,35,-16,15,"51",20,51,0,9,"low"
44,"SUPPRF62253",57,53,46,-9,17,"57",29,55,0,9,"low"
45,"SUPPRF62253",56,60,55,-13,1,"55",54,68,0,9,"low"
46,"SUPPRF62253",53,50,46,-6,0,"53",46,52,0,9,"low"
47,"SUPPRF62253",51,60,70,19,-1,"49",71,51,0,9,"low"
48,"SUPPRF62253",56,56,88,39,25,"49",63,49,0,9,"low"
1,"SUPPRF61804",41,58,24,-15,-13,"39",37,39,3,9,"low"
2,"SUPPRF61804",21,59,20,-27,0,"51",20,47,3,9,"low"
3,"SUPPRF61804",54,39,61,32,24,"45",37,29,3,9,"low"
4,"SUPPRF61804",74,38,58,20,12,"43",46,38,3,9,"low"
5,"SUPPRF61804",80,20,70,49,-1,"47",71,21,3,9,"low"
6,"SUPPRF61804",80,35,81,14,1,"69",80,67,3,9,"low"
7,"SUPPRF61804",0,67,6,-21,-14,"60",20,27,3,9,"low"
8,"SUPPRF61804",83,32,67,2,-13,"65",80,65,3,9,"low"
9,"SUPPRF61804",76,30,96,29,16,"73",80,67,3,9,"low"
10,"SUPPRF61804",75,20,68,6,-12,"72",80,62,3,9,"low"
11,"SUPPRF61804",36,66,41,-28,-13,"34",54,69,3,9,"low"
12,"SUPPRF61804",0,49,16,-40,-13,"44",29,56,3,9,"low"
13,"SUPPRF61804",67,50,47,23,27,"63",20,24,3,9,"low"
14,"SUPPRF61804",0,64,19,-43,-1,"45",20,62,3,9,"low"
15,"SUPPRF61804",61,21,63,2,0,"75",63,61,3,9,"low"
16,"SUPPRF61804",35,38,15,-9,-14,"73",29,24,3,9,"low"
17,"SUPPRF61804",64,13,45,-1,-1,"51",46,46,3,9,"low"
18,"SUPPRF61804",79,22,47,0,-16,"57",63,47,3,9,"low"
19,"SUPPRF61804",83,18,88,27,25,"67",63,61,3,9,"low"
20,"SUPPRF61804",85,13,100,32,20,"65",80,68,3,9,"low"
21,"SUPPRF61804",55,39,29,6,0,"68",29,23,3,9,"low"
22,"SUPPRF61804",81,38,71,24,0,"53",71,47,3,9,"low"
23,"SUPPRF61804",60,10,46,-9,17,"37",29,55,3,9,"low"
24,"SUPPRF61804",66,30,66,16,12,"55",54,50,3,9,"low"
25,"SUPPRF61804",36,21,49,-7,12,"68",37,56,3,9,"low"
26,"SUPPRF61804",30,34,55,-8,1,"79",54,63,3,9,"low"
27,"SUPPRF61804",24,45,37,5,0,"44",37,32,3,9,"low"
28,"SUPPRF61804",76,29,78,28,24,"51",54,50,3,9,"low"
29,"SUPPRF61804",0,34,8,-8,-12,"61",20,16,3,9,"low"
30,"SUPPRF61804",72,18,58,4,29,"28",29,54,3,9,"low"
31,"SUPPRF61804",86,17,77,31,14,"49",63,46,3,9,"low"
32,"SUPPRF61804",47,21,35,26,15,"78",20,9,3,9,"low"
33,"SUPPRF61804",68,8,56,2,-15,"11",71,54,3,9,"low"
34,"SUPPRF61804",79,4,54,5,0,"62",54,49,3,9,"low"
35,"SUPPRF61804",75,35,94,33,23,"49",71,61,3,9,"low"
36,"SUPPRF61804",21,76,22,-28,-15,"49",37,50,3,9,"low"
37,"SUPPRF61804",61,28,50,7,-13,"15",63,43,3,9,"low"
38,"SUPPRF61804",30,46,38,-21,-16,"65",54,59,3,9,"low"
39,"SUPPRF61804",33,51,28,12,-1,"66",29,16,3,9,"low"
40,"SUPPRF61804",86,18,83,31,12,"42",71,52,3,9,"low"
41,"SUPPRF61804",49,18,62,10,-1,"34",63,52,3,9,"low"
42,"SUPPRF61804",81,29,80,8,0,"79",80,72,3,9,"low"
43,"SUPPRF61804",61,37,46,-7,0,"53",46,53,3,9,"low"
44,"SUPPRF61804",71,43,38,-24,1,"67",37,62,3,9,"low"
45,"SUPPRF61804",75,26,75,36,29,"59",46,39,3,9,"low"
46,"SUPPRF61804",23,77,33,-32,-13,"71",46,65,3,9,"low"
47,"SUPPRF61804",50,46,55,-5,-16,"62",71,60,3,9,"low"
48,"SUPPRF61804",22,56,34,-12,-12,"67",46,46,3,9,"low"
1,"SUPPRF67813",99,0,24,-9,-13,"86",37,33,0,9,"low"
2,"SUPPRF67813",99,0,80,-3,0,"97",80,83,0,9,"low"
3,"SUPPRF67813",100,0,46,16,17,"100",29,30,0,9,"low"
4,"SUPPRF67813",100,0,70,-5,-1,"100",71,75,0,9,"low"
5,"SUPPRF67813",100,0,38,-20,-16,"100",54,58,0,9,"low"
6,"SUPPRF67813",100,0,29,0,0,"100",29,29,0,9,"low"
7,"SUPPRF67813",100,0,61,26,24,"100",37,35,0,9,"low"
8,"SUPPRF67813",49,49,19,-4,-1,"68",20,23,0,9,"low"
9,"SUPPRF67813",50,49,55,-18,-16,"50",71,73,0,9,"low"
10,"SUPPRF67813",48,50,94,23,23,"50",71,71,0,9,"low"
11,"SUPPRF67813",50,49,81,0,1,"48",80,81,0,9,"low"
12,"SUPPRF67813",50,50,83,10,12,"48",71,73,0,9,"low"
13,"SUPPRF67813",49,49,47,20,27,"49",20,27,0,9,"low"
14,"SUPPRF67813",49,50,63,11,0,"49",63,52,0,9,"low"
15,"SUPPRF67813",50,50,88,38,25,"49",63,50,0,9,"low"
16,"SUPPRF67813",50,49,20,-30,0,"48",20,50,0,9,"low"
17,"SUPPRF67813",49,48,75,22,29,"50",46,53,0,9,"low"
18,"SUPPRF67813",49,49,66,15,12,"48",54,51,0,9,"low"
19,"SUPPRF67813",50,50,62,12,-1,"50",63,50,0,9,"low"
20,"SUPPRF67813",49,47,45,-5,-1,"51",46,50,0,9,"low"
21,"SUPPRF67813",51,50,37,-15,0,"50",37,52,0,9,"low"
22,"SUPPRF67813",52,52,68,18,-12,"47",80,50,0,9,"low"
23,"SUPPRF67813",49,50,6,-44,-14,"51",20,50,0,9,"low"
24,"SUPPRF67813",49,50,38,-12,1,"50",37,50,0,9,"low"
25,"SUPPRF67813",49,51,54,4,0,"49",54,50,0,9,"low"
26,"SUPPRF67813",52,50,58,9,12,"48",46,49,0,9,"low"
27,"SUPPRF67813",48,48,46,-4,0,"50",46,50,0,9,"low"
28,"SUPPRF67813",49,51,56,4,-15,"51",71,52,0,9,"low"
29,"SUPPRF67813",47,49,22,-28,-15,"50",37,50,0,9,"low"
30,"SUPPRF67813",49,49,35,-13,15,"49",20,48,0,9,"low"
31,"SUPPRF67813",51,49,96,46,16,"50",80,50,0,9,"low"
32,"SUPPRF67813",48,51,34,-11,-12,"50",46,45,0,9,"low"
33,"SUPPRF67813",51,50,50,0,-13,"52",63,50,0,9,"low"
34,"SUPPRF67813",48,49,8,-41,-12,"50",20,49,0,9,"low"
35,"SUPPRF67813",50,49,58,9,29,"49",29,49,0,9,"low"
36,"SUPPRF67813",50,49,78,29,24,"51",54,49,0,9,"low"
37,"SUPPRF67813",53,54,67,20,-13,"55",80,47,0,9,"low"
38,"SUPPRF67813",51,50,47,-6,-16,"50",63,53,0,9,"low"
39,"SUPPRF67813",49,50,15,-40,-14,"50",29,55,0,9,"low"
40,"SUPPRF67813",51,47,55,4,1,"50",54,51,0,9,"low"
41,"SUPPRF67813",49,51,33,-17,-13,"51",46,50,0,9,"low"
42,"SUPPRF67813",49,49,100,51,20,"50",80,49,0,9,"low"
43,"SUPPRF67813",51,50,16,-35,-13,"50",29,51,0,9,"low"
44,"SUPPRF67813",51,50,71,20,0,"50",71,51,0,9,"low"
45,"SUPPRF67813",49,48,49,-1,12,"49",37,50,0,9,"low"
46,"SUPPRF67813",48,49,28,-22,-1,"49",29,50,0,9,"low"
47,"SUPPRF67813",50,50,77,26,14,"50",63,51,0,9,"low"
48,"SUPPRF67813",49,50,41,-10,-13,"51",54,51,0,9,"low"
1,"SUPPRF87016",21,92,19,-2,-1,"78",20,21,8,9,"high"
2,"SUPPRF87016",68,75,61,18,24,"76",37,43,8,9,"high"
3,"SUPPRF87016",22,66,56,-14,-15,"72",71,70,8,9,"high"
4,"SUPPRF87016",25,68,22,-18,-15,"68",37,40,8,9,"high"
5,"SUPPRF87016",88,70,88,38,25,"34",63,50,8,9,"high"
6,"SUPPRF87016",56,63,28,3,-1,"50",29,25,8,9,"high"
7,"SUPPRF87016",89,35,58,34,29,"67",29,24,8,9,"high"
8,"SUPPRF87016",94,22,96,26,16,"63",80,70,8,9,"high"
9,"SUPPRF87016",81,27,83,21,12,"75",71,62,8,9,"high"
10,"SUPPRF87016",82,32,100,30,20,"67",80,70,8,9,"high"
11,"SUPPRF87016",89,26,34,9,-12,"76",46,25,8,9,"high"
12,"SUPPRF87016",70,15,54,-6,0,"64",54,60,8,9,"high"
13,"SUPPRF87016",78,22,29,5,0,"67",29,24,8,9,"high"
14,"SUPPRF87016",78,19,66,0,12,"78",54,66,8,9,"high"
15,"SUPPRF87016",82,13,38,0,1,"75",37,38,8,9,"high"
16,"SUPPRF87016",71,16,55,-7,1,"77",54,62,8,9,"high"
17,"SUPPRF87016",84,18,70,-2,-1,"76",71,72,8,9,"high"
18,"SUPPRF87016",75,13,71,2,0,"67",71,69,8,9,"high"
19,"SUPPRF87016",82,18,68,30,-12,"39",80,38,8,9,"high"
20,"SUPPRF87016",73,18,67,0,-13,"69",80,67,8,9,"high"
21,"SUPPRF87016",81,19,58,16,12,"81",46,42,8,9,"high"
22,"SUPPRF87016",71,20,35,5,15,"74",20,30,8,9,"high"
23,"SUPPRF87016",77,23,50,9,-13,"75",63,41,8,9,"high"
24,"SUPPRF87016",86,17,75,48,29,"71",46,27,8,9,"high"
25,"SUPPRF87016",85,14,80,-2,0,"81",80,82,8,9,"high"
26,"SUPPRF87016",71,21,45,2,-1,"86",46,43,8,9,"high"
27,"SUPPRF87016",83,24,94,19,23,"81",71,75,8,9,"high"
28,"SUPPRF87016",67,23,38,-37,-16,"76",54,75,8,9,"high"
29,"SUPPRF87016",79,21,62,25,-1,"73",63,37,8,9,"high"
30,"SUPPRF87016",80,27,46,16,17,"76",29,30,8,9,"high"
31,"SUPPRF87016",56,24,8,-23,-12,"75",20,31,8,9,"high"
32,"SUPPRF87016",59,35,15,-1,-14,"79",29,16,8,9,"high"
33,"SUPPRF87016",69,28,20,-2,0,"79",20,22,8,9,"high"
34,"SUPPRF87016",78,26,46,8,0,"67",46,38,8,9,"high"
35,"SUPPRF87016",61,27,77,13,14,"72",63,64,8,9,"high"
36,"SUPPRF87016",64,36,47,-5,-16,"36",63,52,8,9,"high"
37,"SUPPRF87016",65,31,33,-16,-13,"30",46,49,8,9,"high"
38,"SUPPRF87016",61,36,81,3,1,"76",80,78,8,9,"high"
39,"SUPPRF87016",61,33,63,-4,0,"71",63,67,8,9,"high"
40,"SUPPRF87016",53,42,16,-16,-13,"58",29,32,8,9,"high"
41,"SUPPRF87016",46,42,37,-21,0,"38",37,58,8,9,"high"
42,"SUPPRF87016",55,42,24,-3,-13,"68",37,27,8,9,"high"
43,"SUPPRF87016",55,43,78,33,24,"65",54,45,8,9,"high"
44,"SUPPRF87016",58,46,41,-31,-13,"72",54,72,8,9,"high"
45,"SUPPRF87016",44,38,47,25,27,"38",20,22,8,9,"high"
46,"SUPPRF87016",42,53,49,9,12,"39",37,40,8,9,"high"
47,"SUPPRF87016",45,53,6,-23,-14,"36",20,29,8,9,"high"
48,"SUPPRF87016",50,55,55,-22,-16,"80",71,77,8,9,"high"
1,"SUPPRF93511",71,31,55,-2,-16,"65",71,57,5,9,"low"
2,"SUPPRF93511",72,25,56,-7,-15,"72",71,63,5,9,"low"
3,"SUPPRF93511",2,11,8,-58,-12,"69",20,66,5,9,"low"
4,"SUPPRF93511",32,27,22,-21,-15,"43",37,43,5,9,"low"
5,"SUPPRF93511",66,24,66,15,12,"52",54,51,5,9,"low"
6,"SUPPRF93511",62,14,58,41,29,"61",29,17,5,9,"low"
7,"SUPPRF93511",72,21,88,37,25,"68",63,51,5,9,"low"
8,"SUPPRF93511",86,29,75,7,29,"75",46,68,5,9,"low"
9,"SUPPRF93511",74,20,46,-26,0,"65",46,72,5,9,"low"
10,"SUPPRF93511",70,17,68,-6,-12,"33",80,74,5,9,"low"
11,"SUPPRF93511",19,74,70,-14,-1,"42",71,84,5,9,"low"
12,"SUPPRF93511",39,8,29,-32,0,"30",29,61,5,9,"low"
13,"SUPPRF93511",78,13,58,10,12,"19",46,48,5,9,"low"
14,"SUPPRF93511",64,16,83,6,12,"29",71,77,5,9,"low"
15,"SUPPRF93511",0,0,28,-54,-1,"70",29,82,5,9,"low"
16,"SUPPRF93511",0,0,45,-43,-1,"23",46,88,5,9,"low"
17,"SUPPRF93511",75,11,6,-36,-14,"16",20,42,5,9,"low"
18,"SUPPRF93511",71,6,49,-14,12,"7",37,63,5,9,"low"
19,"SUPPRF93511",71,1,67,15,-13,"16",80,52,5,9,"low"
20,"SUPPRF93511",68,4,38,-12,1,"10",37,50,5,9,"low"
21,"SUPPRF93511",70,2,38,-35,-16,"11",54,73,5,9,"low"
22,"SUPPRF93511",74,0,62,-11,-1,"0",63,73,5,9,"low"
23,"SUPPRF93511",73,0,47,-19,-16,"12",63,66,5,9,"low"
24,"SUPPRF93511",73,0,37,-20,0,"9",37,57,5,9,"low"
25,"SUPPRF93511",50,0,94,47,23,"15",71,47,5,9,"low"
26,"SUPPRF93511",50,1,78,18,24,"4",54,60,5,9,"low"
27,"SUPPRF93511",50,0,61,7,24,"0",37,54,5,9,"low"
28,"SUPPRF93511",51,16,50,-7,-13,"0",63,57,5,9,"low"
29,"SUPPRF93511",51,18,77,7,14,"8",63,70,5,9,"low"
30,"SUPPRF93511",51,12,41,-20,-13,"5",54,61,5,9,"low"
31,"SUPPRF93511",51,13,35,-2,15,"5",20,37,5,9,"low"
32,"SUPPRF93511",50,15,71,18,0,"17",71,53,5,9,"low"
33,"SUPPRF93511",36,28,34,-17,-12,"10",46,51,5,9,"low"
34,"SUPPRF93511",38,25,20,-36,0,"17",20,56,5,9,"low"
35,"SUPPRF93511",39,35,81,31,1,"14",80,50,5,9,"low"
36,"SUPPRF93511",38,35,24,-40,-13,"18",37,64,5,9,"low"
37,"SUPPRF93511",35,35,15,-47,-14,"21",29,62,5,9,"low"
38,"SUPPRF93511",17,30,46,21,17,"0",29,25,5,9,"low"
39,"SUPPRF93511",14,26,55,0,1,"0",54,55,5,9,"low"
40,"SUPPRF93511",16,22,80,30,0,"0",80,50,5,9,"low"
41,"SUPPRF93511",16,31,33,-4,-13,"0",46,37,5,9,"low"
42,"SUPPRF93511",22,16,19,-40,-1,"0",20,59,5,9,"low"
43,"SUPPRF93511",10,51,16,-39,-13,"6",29,55,5,9,"low"
44,"SUPPRF93511",23,15,47,-8,27,"0",20,55,5,9,"low"
45,"SUPPRF93511",7,43,100,56,20,"4",80,44,5,9,"low"
46,"SUPPRF93511",11,40,54,-8,0,"6",54,62,5,9,"low"
47,"SUPPRF93511",13,19,96,47,16,"7",80,49,5,9,"low"
48,"SUPPRF93511",10,29,63,20,0,"3",63,43,5,9,"low"
1,"SUPPRF45424",76,20,8,-16,-12,"83",20,24,7,10,"high"
2,"SUPPRF45424",83,14,70,-14,-1,"89",71,84,7,10,"high"
3,"SUPPRF45424",86,15,19,-4,-1,"89",20,23,7,10,"high"
4,"SUPPRF45424",90,6,58,16,12,"85",46,42,7,10,"high"
5,"SUPPRF45424",87,16,47,24,27,"88",20,23,7,10,"high"
6,"SUPPRF45424",80,11,62,-15,-1,"71",63,77,7,10,"high"
7,"SUPPRF45424",87,8,71,-10,0,"69",71,81,7,10,"high"
8,"SUPPRF45424",90,7,20,4,0,"91",20,16,7,10,"high"
9,"SUPPRF45424",38,6,16,-19,-13,"85",29,35,7,10,"high"
10,"SUPPRF45424",74,18,46,14,17,"28",29,32,7,10,"high"
11,"SUPPRF45424",81,11,88,12,25,"86",63,76,7,10,"high"
12,"SUPPRF45424",75,18,34,-43,-12,"68",46,77,7,10,"high"
13,"SUPPRF45424",79,16,56,-28,-15,"16",71,84,7,10,"high"
14,"SUPPRF45424",41,30,75,33,29,"84",46,42,7,10,"high"
15,"SUPPRF45424",82,15,55,-25,-16,"76",71,80,7,10,"high"
16,"SUPPRF45424",73,17,63,10,0,"64",63,53,7,10,"high"
17,"SUPPRF45424",85,9,38,-2,-16,"69",54,40,7,10,"high"
18,"SUPPRF45424",72,26,66,23,12,"62",54,43,7,10,"high"
19,"SUPPRF45424",69,27,83,-2,12,"41",71,85,7,10,"high"
20,"SUPPRF45424",77,16,100,9,20,"62",80,91,7,10,"high"
21,"SUPPRF45424",75,18,58,39,29,"56",29,19,7,10,"high"
22,"SUPPRF45424",89,8,80,-10,0,"79",80,90,7,10,"high"
23,"SUPPRF45424",77,15,45,-40,-1,"16",46,85,7,10,"high"
24,"SUPPRF45424",89,10,38,-1,1,"77",37,39,7,10,"high"
25,"SUPPRF45424",75,27,41,0,-13,"67",54,41,7,10,"high"
26,"SUPPRF45424",73,24,68,36,-12,"70",80,32,7,10,"high"
27,"SUPPRF45424",82,14,81,-7,1,"82",80,88,7,10,"high"
28,"SUPPRF45424",77,20,24,7,-13,"79",37,17,7,10,"high"
29,"SUPPRF45424",73,17,15,-26,-14,"73",29,41,7,10,"high"
30,"SUPPRF45424",61,26,55,16,1,"56",54,39,7,10,"high"
31,"SUPPRF45424",80,22,46,10,0,"68",46,36,7,10,"high"
32,"SUPPRF45424",68,17,96,15,16,"81",80,81,7,10,"high"
33,"SUPPRF45424",76,28,37,-9,0,"60",37,46,7,10,"high"
34,"SUPPRF45424",70,32,54,22,0,"50",54,32,7,10,"high"
35,"SUPPRF45424",77,21,47,-7,-16,"73",63,54,7,10,"high"
36,"SUPPRF45424",81,18,49,9,12,"78",37,40,7,10,"high"
37,"SUPPRF45424",78,23,78,29,24,"80",54,49,7,10,"high"
38,"SUPPRF45424",69,32,50,-21,-13,"77",63,71,7,10,"high"
39,"SUPPRF45424",82,13,67,-12,-13,"83",80,79,7,10,"high"
40,"SUPPRF45424",27,25,29,-48,0,"84",29,77,7,10,"high"
41,"SUPPRF45424",77,23,22,-22,-15,"45",37,44,7,10,"high"
42,"SUPPRF45424",87,17,77,16,14,"48",63,61,7,10,"high"
43,"SUPPRF45424",74,29,35,-28,15,"39",20,63,7,10,"high"
44,"SUPPRF45424",91,11,6,-4,-14,"76",20,10,7,10,"high"
45,"SUPPRF45424",86,12,28,-6,-1,"93",29,34,7,10,"high"
46,"SUPPRF45424",74,28,61,22,24,"80",37,39,7,10,"high"
47,"SUPPRF45424",80,8,94,11,23,"86",71,83,7,10,"high"
48,"SUPPRF45424",67,17,33,-23,-13,"43",46,56,7,10,"high"
1,"SUPPRF89348",60,39,55,-6,-16,"76",71,61,3,10,"low"
2,"SUPPRF89348",27,14,47,-35,27,"80",20,82,3,10,"low"
3,"SUPPRF89348",16,26,29,-3,0,"62",29,32,3,10,"low"
4,"SUPPRF89348",34,23,94,54,23,"19",71,40,3,10,"low"
5,"SUPPRF89348",47,16,78,-12,24,"7",54,90,3,10,"low"
6,"SUPPRF89348",49,11,50,-40,-13,"2",63,90,3,10,"low"
7,"SUPPRF89348",57,21,70,-8,-1,"3",71,78,3,10,"low"
8,"SUPPRF89348",43,13,67,22,-13,"1",80,45,3,10,"low"
9,"SUPPRF89348",42,26,55,-35,1,"4",54,90,3,10,"low"
10,"SUPPRF89348",33,18,37,-50,0,"1",37,87,3,10,"low"
11,"SUPPRF89348",14,19,38,-37,1,"13",37,75,3,10,"low"
12,"SUPPRF89348",34,11,34,-30,-12,"5",46,64,3,10,"low"
13,"SUPPRF89348",39,41,62,18,-1,"9",63,44,3,10,"low"
14,"SUPPRF89348",26,9,20,-28,0,"5",20,48,3,10,"low"
15,"SUPPRF89348",54,22,81,64,1,"4",80,17,3,10,"low"
16,"SUPPRF89348",28,13,22,-21,-15,"7",37,43,3,10,"low"
17,"SUPPRF89348",46,8,58,6,12,"1",46,52,3,10,"low"
18,"SUPPRF89348",66,30,88,27,25,"2",63,61,3,10,"low"
19,"SUPPRF89348",6,10,6,-41,-14,"11",20,47,3,10,"low"
20,"SUPPRF89348",48,8,66,-12,12,"3",54,78,3,10,"low"
21,"SUPPRF89348",45,16,46,-32,0,"6",46,78,3,10,"low"
22,"SUPPRF89348",54,18,83,51,12,"9",71,32,3,10,"low"
23,"SUPPRF89348",39,12,15,-1,-14,"15",29,16,3,10,"low"
24,"SUPPRF89348",48,13,75,68,29,"5",46,7,3,10,"low"
25,"SUPPRF89348",47,11,35,-56,15,"5",20,91,3,10,"low"
26,"SUPPRF89348",46,9,33,-8,-13,"6",46,41,3,10,"low"
27,"SUPPRF89348",46,47,46,-1,17,"4",29,47,3,10,"low"
28,"SUPPRF89348",21,16,16,-54,-13,"6",29,70,3,10,"low"
29,"SUPPRF89348",37,70,54,-26,0,"12",54,80,3,10,"low"
30,"SUPPRF89348",44,8,45,-42,-1,"8",46,87,3,10,"low"
31,"SUPPRF89348",13,12,24,-65,-13,"7",37,89,3,10,"low"
32,"SUPPRF89348",6,10,8,-54,-12,"10",20,62,3,10,"low"
33,"SUPPRF89348",66,28,100,29,20,"16",80,71,3,10,"low"
34,"SUPPRF89348",54,17,47,-10,-16,"7",63,57,3,10,"low"
35,"SUPPRF89348",61,18,71,-6,0,"10",71,77,3,10,"low"
36,"SUPPRF89348",47,28,56,9,-15,"4",71,47,3,10,"low"
37,"SUPPRF89348",70,25,77,55,14,"4",63,22,3,10,"low"
38,"SUPPRF89348",44,15,19,-26,-1,"8",20,45,3,10,"low"
39,"SUPPRF89348",80,14,80,25,0,"3",80,55,3,10,"low"
40,"SUPPRF89348",41,16,68,-10,-12,"3",80,78,3,10,"low"
41,"SUPPRF89348",25,34,61,41,24,"6",37,20,3,10,"low"
42,"SUPPRF89348",20,21,28,-14,-1,"4",29,42,3,10,"low"
43,"SUPPRF89348",45,39,38,-16,-16,"2",54,54,3,10,"low"
44,"SUPPRF89348",39,22,58,35,29,"4",29,23,3,10,"low"
45,"SUPPRF89348",47,46,49,-14,12,"2",37,63,3,10,"low"
46,"SUPPRF89348",87,18,96,8,16,"3",80,88,3,10,"low"
47,"SUPPRF89348",41,46,41,-6,-13,"6",54,47,3,10,"low"
48,"SUPPRF89348",55,25,63,19,0,"3",63,44,3,10,"low"
1,"SUPPRF45704",51,55,22,-14,-15,"51",37,36,4,10,"low"
2,"SUPPRF45704",47,51,47,-15,-16,"50",63,62,4,10,"low"
3,"SUPPRF45704",48,47,19,1,-1,"47",20,18,4,10,"low"
4,"SUPPRF45704",52,37,62,29,-1,"45",63,33,4,10,"low"
5,"SUPPRF45704",56,36,46,-8,17,"49",29,54,4,10,"low"
6,"SUPPRF45704",60,31,58,31,29,"48",29,27,4,10,"low"
7,"SUPPRF45704",59,31,41,-18,-13,"52",54,59,4,10,"low"
8,"SUPPRF45704",62,34,49,0,12,"48",37,49,4,10,"low"
9,"SUPPRF45704",57,40,20,-43,0,"13",20,63,4,10,"low"
10,"SUPPRF45704",48,48,67,18,-13,"51",80,49,4,10,"low"
11,"SUPPRF45704",48,52,78,27,24,"49",54,51,4,10,"low"
12,"SUPPRF45704",99,0,70,15,-1,"52",71,55,4,10,"low"
13,"SUPPRF45704",60,32,54,3,0,"55",54,51,4,10,"low"
14,"SUPPRF45704",80,17,38,-9,-16,"72",54,47,4,10,"low"
15,"SUPPRF45704",73,26,55,0,1,"66",54,55,4,10,"low"
16,"SUPPRF45704",69,22,77,22,14,"52",63,55,4,10,"low"
17,"SUPPRF45704",67,21,71,45,0,"75",71,26,4,10,"low"
18,"SUPPRF45704",77,0,75,34,29,"81",46,41,4,10,"low"
19,"SUPPRF45704",70,3,50,9,-13,"83",63,41,4,10,"low"
20,"SUPPRF45704",51,2,33,-12,-13,"86",46,45,4,10,"low"
21,"SUPPRF45704",53,11,24,-1,-13,"47",37,25,4,10,"low"
22,"SUPPRF45704",44,3,15,9,-14,"79",29,6,4,10,"low"
23,"SUPPRF45704",73,22,81,3,1,"80",80,78,4,10,"low"
24,"SUPPRF45704",47,7,37,-1,0,"70",37,38,4,10,"low"
25,"SUPPRF45704",49,2,29,-21,0,"45",29,50,4,10,"low"
26,"SUPPRF45704",57,34,66,18,12,"48",54,48,4,10,"low"
27,"SUPPRF45704",51,49,38,4,1,"45",37,34,4,10,"low"
28,"SUPPRF45704",48,14,83,17,12,"68",71,66,4,10,"low"
29,"SUPPRF45704",60,23,34,-3,-12,"48",46,37,4,10,"low"
30,"SUPPRF45704",58,30,94,24,23,"74",71,70,4,10,"low"
31,"SUPPRF45704",65,29,68,1,-12,"65",80,67,4,10,"low"
32,"SUPPRF45704",52,23,45,-24,-1,"56",46,69,4,10,"low"
33,"SUPPRF45704",52,25,55,-20,-16,"80",71,75,4,10,"low"
34,"SUPPRF45704",63,28,100,30,20,"77",80,70,4,10,"low"
35,"SUPPRF45704",51,44,46,-18,0,"62",46,64,4,10,"low"
36,"SUPPRF45704",27,37,6,-31,-14,"54",20,37,4,10,"low"
37,"SUPPRF45704",5,32,58,43,12,"52",46,15,4,10,"low"
38,"SUPPRF45704",2,45,96,50,16,"45",80,46,4,10,"low"
39,"SUPPRF45704",69,37,35,-16,15,"51",20,51,4,10,"low"
40,"SUPPRF45704",50,49,88,37,25,"49",63,51,4,10,"low"
41,"SUPPRF45704",49,51,61,-4,24,"53",37,65,4,10,"low"
42,"SUPPRF45704",51,52,47,-6,27,"48",20,53,4,10,"low"
43,"SUPPRF45704",47,38,28,-21,-1,"48",29,49,4,10,"low"
44,"SUPPRF45704",43,33,16,-13,-13,"29",29,29,4,10,"low"
45,"SUPPRF45704",50,47,8,-37,-12,"44",20,45,4,10,"low"
46,"SUPPRF45704",41,53,56,4,-15,"49",71,52,4,10,"low"
47,"SUPPRF45704",50,49,63,12,0,"48",63,51,4,10,"low"
48,"SUPPRF45704",44,41,80,36,0,"51",80,44,4,10,"low"
1,"SUPPRF70595",39,45,16,-13,-13,"57",29,29,4,10,"low"
2,"SUPPRF70595",51,36,78,18,24,"57",54,60,4,10,"low"
3,"SUPPRF70595",52,34,70,1,-1,"65",71,69,4,10,"low"
4,"SUPPRF70595",49,46,20,3,0,"81",20,17,4,10,"low"
5,"SUPPRF70595",54,48,83,16,12,"66",71,67,4,10,"low"
6,"SUPPRF70595",59,35,80,3,0,"41",80,77,4,10,"low"
7,"SUPPRF70595",51,40,58,44,29,"68",29,14,4,10,"low"
8,"SUPPRF70595",56,36,62,3,-1,"49",63,59,4,10,"low"
9,"SUPPRF70595",53,40,67,9,-13,"37",80,58,4,10,"low"
10,"SUPPRF70595",39,54,8,-11,-12,"75",20,19,4,10,"low"
11,"SUPPRF70595",46,44,33,-29,-13,"42",46,62,4,10,"low"
12,"SUPPRF70595",43,51,35,28,15,"69",20,7,4,10,"low"
13,"SUPPRF70595",43,57,46,4,0,"45",46,42,4,10,"low"
14,"SUPPRF70595",52,54,56,-4,-15,"53",71,60,4,10,"low"
15,"SUPPRF70595",47,62,50,0,-13,"36",63,50,4,10,"low"
16,"SUPPRF70595",49,53,61,42,24,"65",37,19,4,10,"low"
17,"SUPPRF70595",49,64,63,9,0,"50",63,54,4,10,"low"
18,"SUPPRF70595",56,38,71,-2,0,"76",71,73,4,10,"low"
19,"SUPPRF70595",47,67,54,1,0,"64",54,53,4,10,"low"
20,"SUPPRF70595",52,65,68,-1,-12,"35",80,69,4,10,"low"
21,"SUPPRF70595",37,71,38,-16,-16,"46",54,54,4,10,"low"
22,"SUPPRF70595",45,64,19,6,-1,"76",20,13,4,10,"low"
23,"SUPPRF70595",31,56,37,-9,0,"31",37,46,4,10,"low"
24,"SUPPRF70595",33,67,66,19,12,"28",54,47,4,10,"low"
25,"SUPPRF70595",56,49,77,36,14,"45",63,41,4,10,"low"
26,"SUPPRF70595",42,57,15,-9,-14,"51",29,24,4,10,"low"
27,"SUPPRF70595",42,64,22,-32,-15,"40",37,54,4,10,"low"
28,"SUPPRF70595",49,53,58,16,12,"54",46,42,4,10,"low"
29,"SUPPRF70595",58,52,81,42,1,"41",80,39,4,10,"low"
30,"SUPPRF70595",57,48,100,29,20,"84",80,71,4,10,"low"
31,"SUPPRF70595",51,54,75,24,29,"59",46,51,4,10,"low"
32,"SUPPRF70595",51,56,49,-7,12,"41",37,56,4,10,"low"
33,"SUPPRF70595",52,54,38,-11,1,"45",37,49,4,10,"low"
34,"SUPPRF70595",43,56,46,40,17,"73",29,6,4,10,"low"
35,"SUPPRF70595",43,53,41,-10,-13,"54",54,51,4,10,"low"
36,"SUPPRF70595",38,60,45,0,-1,"60",46,45,4,10,"low"
37,"SUPPRF70595",34,64,88,46,25,"41",63,42,4,10,"low"
38,"SUPPRF70595",34,62,6,-38,-14,"28",20,44,4,10,"low"
39,"SUPPRF70595",34,57,47,41,27,"81",20,6,4,10,"low"
40,"SUPPRF70595",30,56,29,9,0,"34",29,20,4,10,"low"
41,"SUPPRF70595",52,55,94,29,23,"34",71,65,4,10,"low"
42,"SUPPRF70595",39,71,47,9,-16,"14",63,38,4,10,"low"
43,"SUPPRF70595",42,67,34,-12,-12,"58",46,46,4,10,"low"
44,"SUPPRF70595",46,63,96,29,16,"55",80,67,4,10,"low"
45,"SUPPRF70595",35,64,55,-19,-16,"62",71,74,4,10,"low"
46,"SUPPRF70595",42,58,55,1,1,"43",54,54,4,10,"low"
47,"SUPPRF70595",29,72,28,-27,-1,"43",29,55,4,10,"low"
48,"SUPPRF70595",27,71,24,-19,-13,"62",37,43,4,10,"low"
1,"SUPPRF54185",69,11,58,24,29,"68",29,34,0,10,"low"
2,"SUPPRF54185",70,10,46,-17,0,"64",46,63,0,10,"low"
3,"SUPPRF54185",68,5,83,17,12,"58",71,66,0,10,"low"
4,"SUPPRF54185",69,9,41,-21,-13,"55",54,62,0,10,"low"
5,"SUPPRF54185",70,5,67,2,-13,"49",80,65,0,10,"low"
6,"SUPPRF54185",71,7,16,-44,-13,"49",29,60,0,10,"low"
7,"SUPPRF54185",69,6,88,33,25,"47",63,55,0,10,"low"
8,"SUPPRF54185",67,3,71,4,0,"49",71,67,0,10,"low"
9,"SUPPRF54185",70,7,22,-40,-15,"56",37,62,0,10,"low"
10,"SUPPRF54185",75,8,56,-14,-15,"62",71,70,0,10,"low"
11,"SUPPRF54185",74,6,38,-28,1,"61",37,66,0,10,"low"
12,"SUPPRF54185",72,5,80,33,0,"60",80,47,0,10,"low"
13,"SUPPRF54185",67,6,28,-24,-1,"67",29,52,0,10,"low"
14,"SUPPRF54185",68,4,29,-1,0,"68",29,30,0,10,"low"
15,"SUPPRF54185",68,6,94,42,23,"54",71,52,0,10,"low"
16,"SUPPRF54185",70,6,77,18,14,"66",63,59,0,10,"low"
17,"SUPPRF54185",69,6,37,-25,0,"49",37,62,0,10,"low"
18,"SUPPRF54185",70,6,61,8,24,"64",37,53,0,10,"low"
19,"SUPPRF54185",72,4,24,-22,-13,"62",37,46,0,10,"low"
20,"SUPPRF54185",70,8,70,16,-1,"62",71,54,0,10,"low"
21,"SUPPRF54185",71,4,46,-20,17,"68",29,66,0,10,"low"
22,"SUPPRF54185",73,8,8,-56,-12,"16",20,64,0,10,"low"
23,"SUPPRF54185",75,9,55,-4,1,"63",54,59,0,10,"low"
24,"SUPPRF54185",84,6,47,-11,-16,"5",63,58,0,10,"low"
25,"SUPPRF54185",74,5,62,9,-1,"63",63,53,0,10,"low"
26,"SUPPRF54185",73,5,63,5,0,"57",63,58,0,10,"low"
27,"SUPPRF54185",84,5,33,-21,-13,"64",46,54,0,10,"low"
28,"SUPPRF54185",71,6,45,-19,-1,"67",46,64,0,10,"low"
29,"SUPPRF54185",82,6,81,-1,1,"81",80,82,0,10,"low"
30,"SUPPRF54185",79,6,6,-61,-14,"19",20,67,0,10,"low"
31,"SUPPRF54185",78,10,15,-8,-14,"59",29,23,0,10,"low"
32,"SUPPRF54185",77,4,35,-28,15,"60",20,63,0,10,"low"
33,"SUPPRF54185",69,4,100,24,20,"70",80,76,0,10,"low"
34,"SUPPRF54185",73,7,96,17,16,"74",80,79,0,10,"low"
35,"SUPPRF54185",72,1,34,-18,-12,"62",46,52,0,10,"low"
36,"SUPPRF54185",74,6,50,-16,-13,"56",63,66,0,10,"low"
37,"SUPPRF54185",4,5,54,0,0,"62",54,54,0,10,"low"
38,"SUPPRF54185",59,9,58,3,12,"55",46,55,0,10,"low"
39,"SUPPRF54185",63,9,75,20,29,"53",46,55,0,10,"low"
40,"SUPPRF54185",61,5,38,-18,-16,"60",54,56,0,10,"low"
41,"SUPPRF54185",59,5,47,33,27,"59",20,14,0,10,"low"
42,"SUPPRF54185",61,2,20,5,0,"61",20,15,0,10,"low"
43,"SUPPRF54185",4,4,68,-5,-12,"78",80,73,0,10,"low"
44,"SUPPRF54185",53,5,78,24,24,"53",54,54,0,10,"low"
45,"SUPPRF54185",61,6,66,13,12,"54",54,53,0,10,"low"
46,"SUPPRF54185",47,5,49,-9,12,"53",37,58,0,10,"low"
47,"SUPPRF54185",10,7,19,-11,-1,"52",20,30,0,10,"low"
48,"SUPPRF54185",15,5,55,-7,-16,"58",71,62,0,10,"low"
1,"SUPPRF14173",53,53,54,0,0,"77",54,54,2,10,"low"
2,"SUPPRF14173",54,50,71,-2,0,"52",71,73,2,10,"low"
3,"SUPPRF14173",52,53,94,14,23,"73",71,80,2,10,"low"
4,"SUPPRF14173",52,53,66,-9,12,"64",54,75,2,10,"low"
5,"SUPPRF14173",51,52,15,-15,-14,"78",29,30,2,10,"low"
6,"SUPPRF14173",51,51,62,14,-1,"59",63,48,2,10,"low"
7,"SUPPRF14173",52,51,46,23,17,"56",29,23,2,10,"low"
8,"SUPPRF14173",50,53,41,-17,-13,"58",54,58,2,10,"low"
9,"SUPPRF14173",50,43,63,8,0,"74",63,55,2,10,"low"
10,"SUPPRF14173",61,49,61,-12,24,"21",37,73,2,10,"low"
11,"SUPPRF14173",59,45,47,-2,27,"36",20,49,2,10,"low"
12,"SUPPRF14173",58,41,56,1,-15,"46",71,55,2,10,"low"
13,"SUPPRF14173",65,41,70,7,-1,"47",71,63,2,10,"low"
14,"SUPPRF14173",66,43,58,4,12,"66",46,54,2,10,"low"
15,"SUPPRF14173",58,37,28,2,-1,"74",29,26,2,10,"low"
16,"SUPPRF14173",51,52,45,-40,-1,"74",46,85,2,10,"low"
17,"SUPPRF14173",67,35,83,30,12,"63",71,53,2,10,"low"
18,"SUPPRF14173",53,49,67,0,-13,"77",80,67,2,10,"low"
19,"SUPPRF14173",36,60,22,-42,-15,"37",37,64,2,10,"low"
20,"SUPPRF14173",65,40,81,-1,1,"79",80,82,2,10,"low"
21,"SUPPRF14173",50,63,24,-47,-13,"75",37,71,2,10,"low"
22,"SUPPRF14173",51,50,46,-27,0,"69",46,73,2,10,"low"
23,"SUPPRF14173",33,47,38,-37,-16,"63",54,75,2,10,"low"
24,"SUPPRF14173",44,54,8,-12,-12,"85",20,20,2,10,"low"
25,"SUPPRF14173",47,51,20,3,0,"75",20,17,2,10,"low"
26,"SUPPRF14173",42,62,16,-33,-13,"52",29,49,2,10,"low"
27,"SUPPRF14173",67,52,77,3,14,"69",63,74,2,10,"low"
28,"SUPPRF14173",61,41,78,17,24,"59",54,61,2,10,"low"
29,"SUPPRF14173",59,41,49,12,12,"57",37,37,2,10,"low"
30,"SUPPRF14173",44,40,33,-16,-13,"46",46,49,2,10,"low"
31,"SUPPRF14173",64,43,75,7,29,"53",46,68,2,10,"low"
32,"SUPPRF14173",52,62,68,0,-12,"74",80,68,2,10,"low"
33,"SUPPRF14173",53,47,47,-13,-16,"68",63,60,2,10,"low"
34,"SUPPRF14173",44,53,34,-28,-12,"62",46,62,2,10,"low"
35,"SUPPRF14173",47,67,6,-9,-14,"49",20,15,2,10,"low"
36,"SUPPRF14173",50,55,58,-5,29,"65",29,63,2,10,"low"
37,"SUPPRF14173",51,39,35,10,15,"49",20,25,2,10,"low"
38,"SUPPRF14173",71,42,96,34,16,"72",80,62,2,10,"low"
39,"SUPPRF14173",63,40,55,-15,1,"61",54,70,2,10,"low"
40,"SUPPRF14173",53,51,37,-19,0,"61",37,56,2,10,"low"
41,"SUPPRF14173",51,52,55,0,-16,"30",71,55,2,10,"low"
42,"SUPPRF14173",53,56,50,8,-13,"38",63,42,2,10,"low"
43,"SUPPRF14173",43,65,38,16,1,"66",37,22,2,10,"low"
44,"SUPPRF14173",31,63,19,-4,-1,"53",20,23,2,10,"low"
45,"SUPPRF14173",52,51,29,-23,0,"69",29,52,2,10,"low"
46,"SUPPRF14173",36,48,100,42,20,"68",80,58,2,10,"low"
47,"SUPPRF14173",57,51,80,5,0,"61",80,75,2,10,"low"
48,"SUPPRF14173",52,48,88,35,25,"32",63,53,2,10,"low"
1,"SUPPRF70880",45,47,68,45,-12,"2",80,23,12,10,"high"
2,"SUPPRF70880",37,43,63,5,0,"38",63,58,12,10,"high"
3,"SUPPRF70880",26,71,15,-25,-14,"0",29,40,12,10,"high"
4,"SUPPRF70880",46,61,77,31,14,"28",63,46,12,10,"high"
5,"SUPPRF70880",65,60,46,5,17,"52",29,41,12,10,"high"
6,"SUPPRF70880",53,39,83,47,12,"11",71,36,12,10,"high"
7,"SUPPRF70880",59,54,58,15,29,"50",29,43,12,10,"high"
8,"SUPPRF70880",63,21,75,42,29,"62",46,33,12,10,"high"
9,"SUPPRF70880",62,15,33,-1,-13,"59",46,34,12,10,"high"
10,"SUPPRF70880",17,58,16,-24,-13,"64",29,40,12,10,"high"
11,"SUPPRF70880",17,64,61,19,24,"70",37,42,12,10,"high"
12,"SUPPRF70880",34,44,54,14,0,"51",54,40,12,10,"high"
13,"SUPPRF70880",50,47,46,-8,0,"67",46,54,12,10,"high"
14,"SUPPRF70880",39,63,88,41,25,"24",63,47,12,10,"high"
15,"SUPPRF70880",57,57,81,61,1,"22",80,20,12,10,"high"
16,"SUPPRF70880",67,35,37,-11,0,"29",37,48,12,10,"high"
17,"SUPPRF70880",45,51,24,-22,-13,"0",37,46,12,10,"high"
18,"SUPPRF70880",37,47,29,-26,0,"29",29,55,12,10,"high"
19,"SUPPRF70880",50,1,96,49,16,"18",80,47,12,10,"high"
20,"SUPPRF70880",74,64,71,29,0,"25",71,42,12,10,"high"
21,"SUPPRF70880",35,75,62,15,-1,"66",63,47,12,10,"high"
22,"SUPPRF70880",64,50,34,-12,-12,"52",46,46,12,10,"high"
23,"SUPPRF70880",98,53,94,34,23,"33",71,60,12,10,"high"
24,"SUPPRF70880",44,39,66,8,12,"34",54,58,12,10,"high"
25,"SUPPRF70880",46,82,67,23,-13,"0",80,44,12,10,"high"
26,"SUPPRF70880",13,84,8,-54,-12,"33",20,62,12,10,"high"
27,"SUPPRF70880",68,43,70,27,-1,"60",71,43,12,10,"high"
28,"SUPPRF70880",71,27,38,-2,-16,"44",54,40,12,10,"high"
29,"SUPPRF70880",30,66,78,26,24,"63",54,52,12,10,"high"
30,"SUPPRF70880",49,41,80,19,0,"58",80,61,12,10,"high"
31,"SUPPRF70880",40,66,45,0,-1,"65",46,45,12,10,"high"
32,"SUPPRF70880",27,56,49,9,12,"75",37,40,12,10,"high"
33,"SUPPRF70880",55,37,35,-9,15,"26",20,44,12,10,"high"
34,"SUPPRF70880",52,75,50,9,-13,"25",63,41,12,10,"high"
35,"SUPPRF70880",82,32,55,13,1,"0",54,42,12,10,"high"
36,"SUPPRF70880",24,67,55,-1,-16,"27",71,56,12,10,"high"
37,"SUPPRF70880",47,52,22,-21,-15,"0",37,43,12,10,"high"
38,"SUPPRF70880",1,49,6,-47,-14,"17",20,53,12,10,"high"
39,"SUPPRF70880",64,63,38,-9,1,"31",37,47,12,10,"high"
40,"SUPPRF70880",41,57,20,14,0,"90",20,6,12,10,"high"
41,"SUPPRF70880",100,7,100,53,20,"67",80,47,12,10,"high"
42,"SUPPRF70880",78,43,56,11,-15,"76",71,45,12,10,"high"
43,"SUPPRF70880",60,79,47,37,27,"67",20,10,12,10,"high"
44,"SUPPRF70880",64,66,41,5,-13,"70",54,36,12,10,"high"
45,"SUPPRF70880",79,40,47,4,-16,"65",63,43,12,10,"high"
46,"SUPPRF70880",34,88,19,-18,-1,"65",20,37,12,10,"high"
47,"SUPPRF70880",69,77,28,-18,-1,"15",29,46,12,10,"high"
48,"SUPPRF70880",79,34,58,13,12,"25",46,45,12,10,"high"
1,"SUPPRF18662",67,4,47,27,27,"70",20,20,0,10,"low"
2,"SUPPRF18662",49,6,68,-12,-12,"80",80,80,0,10,"low"
3,"SUPPRF18662",52,4,62,7,-1,"60",63,55,0,10,"low"
4,"SUPPRF18662",49,7,29,9,0,"75",29,20,0,10,"low"
5,"SUPPRF18662",50,4,34,-21,-12,"70",46,55,0,10,"low"
6,"SUPPRF18662",36,8,8,-14,-12,"90",20,22,0,10,"low"
7,"SUPPRF18662",51,4,35,21,15,"72",20,14,0,10,"low"
8,"SUPPRF18662",43,22,41,-14,-13,"68",54,55,0,10,"low"
9,"SUPPRF18662",53,11,88,28,25,"56",63,60,0,10,"low"
10,"SUPPRF18662",49,9,83,3,12,"70",71,80,0,10,"low"
11,"SUPPRF18662",53,5,67,-3,-13,"65",80,70,0,10,"low"
12,"SUPPRF18662",49,9,77,17,14,"65",63,60,0,10,"low"
13,"SUPPRF18662",47,8,46,26,17,"75",29,20,0,10,"low"
14,"SUPPRF18662",35,7,38,-22,-16,"75",54,60,0,10,"low"
15,"SUPPRF18662",48,10,45,4,-1,"75",46,41,0,10,"low"
16,"SUPPRF18662",49,6,61,31,24,"69",37,30,0,10,"low"
17,"SUPPRF18662",43,6,38,-12,1,"60",37,50,0,10,"low"
18,"SUPPRF18662",51,6,75,37,29,"74",46,38,0,10,"low"
19,"SUPPRF18662",49,7,80,0,0,"81",80,80,0,10,"low"
20,"SUPPRF18662",50,6,47,-3,-16,"65",63,50,0,10,"low"
21,"SUPPRF18662",33,7,16,-17,-13,"54",29,33,0,10,"low"
22,"SUPPRF18662",38,5,20,1,0,"74",20,19,0,10,"low"
23,"SUPPRF18662",44,6,33,-2,-13,"50",46,35,0,10,"low"
24,"SUPPRF18662",50,6,78,28,24,"72",54,50,0,10,"low"
25,"SUPPRF18662",49,7,56,-14,-15,"70",71,70,0,10,"low"
26,"SUPPRF18662",33,5,6,-12,-14,"80",20,18,0,10,"low"
27,"SUPPRF18662",46,6,46,-2,0,"73",46,48,0,10,"low"
28,"SUPPRF18662",50,6,49,-3,12,"69",37,52,0,10,"low"
29,"SUPPRF18662",51,7,66,11,12,"70",54,55,0,10,"low"
30,"SUPPRF18662",45,9,22,-23,-15,"76",37,45,0,10,"low"
31,"SUPPRF18662",42,9,15,-20,-14,"79",29,35,0,10,"low"
32,"SUPPRF18662",53,7,70,-9,-1,"81",71,79,0,10,"low"
33,"SUPPRF18662",50,6,54,-2,0,"73",54,56,0,10,"low"
34,"SUPPRF18662",51,6,81,2,1,"80",80,79,0,10,"low"
35,"SUPPRF18662",50,9,63,11,0,"75",63,52,0,10,"low"
36,"SUPPRF18662",33,5,28,-31,-1,"70",29,59,0,10,"low"
37,"SUPPRF18662",52,6,50,9,-13,"80",63,41,0,10,"low"
38,"SUPPRF18662",50,5,37,2,0,"81",37,35,0,10,"low"
39,"SUPPRF18662",39,9,55,-15,-16,"48",71,70,0,10,"low"
40,"SUPPRF18662",64,9,96,21,16,"75",80,75,0,10,"low"
41,"SUPPRF18662",51,8,55,0,1,"80",54,55,0,10,"low"
42,"SUPPRF18662",59,5,94,14,23,"83",71,80,0,10,"low"
43,"SUPPRF18662",45,9,19,-3,-1,"76",20,22,0,10,"low"
44,"SUPPRF18662",47,5,24,-1,-13,"84",37,25,0,10,"low"
45,"SUPPRF18662",48,9,58,37,29,"85",29,21,0,10,"low"
46,"SUPPRF18662",46,6,71,-9,0,"80",71,80,0,10,"low"
47,"SUPPRF18662",53,8,58,14,12,"81",46,44,0,10,"low"
48,"SUPPRF18662",62,6,100,15,20,"85",80,85,0,10,"low"
1,"SUPPRF78305",10,91,63,0,0,"73",63,63,11,10,"high"
2,"SUPPRF78305",31,73,47,29,27,"89",20,18,11,10,"high"
3,"SUPPRF78305",38,64,80,4,0,"89",80,76,11,10,"high"
4,"SUPPRF78305",36,68,78,53,24,"19",54,25,11,10,"high"
5,"SUPPRF78305",30,79,49,-21,12,"11",37,70,11,10,"high"
6,"SUPPRF78305",17,78,55,-19,-16,"98",71,74,11,10,"high"
7,"SUPPRF78305",74,42,46,6,17,"86",29,40,11,10,"high"
8,"SUPPRF78305",31,69,66,16,12,"56",54,50,11,10,"high"
9,"SUPPRF78305",31,67,38,-2,1,"93",37,40,11,10,"high"
10,"SUPPRF78305",11,81,33,-9,-13,"92",46,42,11,10,"high"
11,"SUPPRF78305",12,80,38,-24,-16,"85",54,62,11,10,"high"
12,"SUPPRF78305",6,88,24,-6,-13,"91",37,30,11,10,"high"
13,"SUPPRF78305",36,63,77,15,14,"80",63,62,11,10,"high"
14,"SUPPRF78305",29,77,62,-1,-1,"93",63,63,11,10,"high"
15,"SUPPRF78305",29,71,46,-5,0,"96",46,51,11,10,"high"
16,"SUPPRF78305",34,81,68,-5,-12,"84",80,73,11,10,"high"
17,"SUPPRF78305",21,74,58,4,12,"95",46,54,11,10,"high"
18,"SUPPRF78305",8,83,34,-18,-12,"93",46,52,11,10,"high"
19,"SUPPRF78305",28,67,100,25,20,"84",80,75,11,10,"high"
20,"SUPPRF78305",4,83,19,-1,-1,"87",20,20,11,10,"high"
21,"SUPPRF78305",4,88,28,-7,-1,"39",29,35,11,10,"high"
22,"SUPPRF78305",7,44,61,26,24,"82",37,35,11,10,"high"
23,"SUPPRF78305",5,46,45,2,-1,"89",46,43,11,10,"high"
24,"SUPPRF78305",1,39,15,-36,-14,"35",29,51,11,10,"high"
25,"SUPPRF78305",0,41,71,2,0,"82",71,69,11,10,"high"
26,"SUPPRF78305",4,37,50,0,-13,"76",63,50,11,10,"high"
27,"SUPPRF78305",1,41,22,-17,-15,"77",37,39,11,10,"high"
28,"SUPPRF78305",2,34,8,-14,-12,"89",20,22,11,10,"high"
29,"SUPPRF78305",0,27,88,26,25,"35",63,62,11,10,"high"
30,"SUPPRF78305",4,31,54,-6,0,"89",54,60,11,10,"high"
31,"SUPPRF78305",3,28,55,2,1,"89",54,53,11,10,"high"
32,"SUPPRF78305",2,16,75,25,29,"61",46,50,11,10,"high"
33,"SUPPRF78305",11,32,96,27,16,"89",80,69,11,10,"high"
34,"SUPPRF78305",2,26,35,13,15,"97",20,22,11,10,"high"
35,"SUPPRF78305",8,33,81,-5,1,"95",80,86,11,10,"high"
36,"SUPPRF78305",1,24,67,-23,-13,"90",80,90,11,10,"high"
37,"SUPPRF78305",2,30,58,35,29,"92",29,23,11,10,"high"
38,"SUPPRF78305",1,24,70,8,-1,"95",71,62,11,10,"high"
39,"SUPPRF78305",0,30,41,-13,-13,"82",54,54,11,10,"high"
40,"SUPPRF78305",1,22,83,13,12,"95",71,70,11,10,"high"
41,"SUPPRF78305",0,23,16,-11,-13,"77",29,27,11,10,"high"
42,"SUPPRF78305",0,22,6,-10,-14,"89",20,16,11,10,"high"
43,"SUPPRF78305",7,26,94,26,23,"87",71,68,11,10,"high"
44,"SUPPRF78305",2,20,37,4,0,"75",37,33,11,10,"high"
45,"SUPPRF78305",0,24,56,-18,-15,"93",71,74,11,10,"high"
46,"SUPPRF78305",0,24,29,-8,0,"82",29,37,11,10,"high"
47,"SUPPRF78305",0,24,20,0,0,"88",20,20,11,10,"high"
48,"SUPPRF78305",0,22,47,15,-16,"82",63,32,11,10,"high"
1,"SUPPRF71639",49,76,49,-7,12,"58",37,56,11,10,"high"
2,"SUPPRF71639",61,70,77,0,14,"65",63,77,11,10,"high"
3,"SUPPRF71639",52,78,56,20,-15,"69",71,36,11,10,"high"
4,"SUPPRF71639",38,63,58,-28,29,"74",29,86,11,10,"high"
5,"SUPPRF71639",79,51,81,-8,1,"64",80,89,11,10,"high"
6,"SUPPRF71639",84,46,96,9,16,"74",80,87,11,10,"high"
7,"SUPPRF71639",87,43,80,-12,0,"77",80,92,11,10,"high"
8,"SUPPRF71639",69,50,24,-43,-13,"62",37,67,11,10,"high"
9,"SUPPRF71639",95,22,94,-1,23,"91",71,95,11,10,"high"
10,"SUPPRF71639",69,27,50,-35,-13,"90",63,85,11,10,"high"
11,"SUPPRF71639",58,22,58,-13,12,"79",46,71,11,10,"high"
12,"SUPPRF71639",62,14,62,-32,-1,"49",63,94,11,10,"high"
13,"SUPPRF71639",51,24,68,16,-12,"39",80,52,11,10,"high"
14,"SUPPRF71639",51,10,35,-39,15,"64",20,74,11,10,"high"
15,"SUPPRF71639",73,7,71,-3,0,"39",71,74,11,10,"high"
16,"SUPPRF71639",74,15,88,14,25,"54",63,74,11,10,"high"
17,"SUPPRF71639",58,21,63,-29,0,"80",63,92,11,10,"high"
18,"SUPPRF71639",72,3,78,34,24,"27",54,44,11,10,"high"
19,"SUPPRF71639",86,2,16,-54,-13,"53",29,70,11,10,"high"
20,"SUPPRF71639",94,7,75,-6,29,"50",46,81,11,10,"high"
21,"SUPPRF71639",77,5,29,-2,0,"41",29,31,11,10,"high"
22,"SUPPRF71639",60,10,41,-42,-13,"51",54,83,11,10,"high"
23,"SUPPRF71639",86,5,100,27,20,"48",80,73,11,10,"high"
24,"SUPPRF71639",99,8,6,-89,-14,"55",20,95,11,10,"high"
25,"SUPPRF71639",89,13,61,25,24,"13",37,36,11,10,"high"
26,"SUPPRF71639",74,6,33,21,-13,"5",46,12,11,10,"high"
27,"SUPPRF71639",88,1,8,-67,-12,"28",20,75,11,10,"high"
28,"SUPPRF71639",59,8,15,-63,-14,"59",29,78,11,10,"high"
29,"SUPPRF71639",52,10,38,-21,-16,"17",54,59,11,10,"high"
30,"SUPPRF71639",53,14,67,-12,-13,"47",80,79,11,10,"high"
31,"SUPPRF71639",54,9,45,-16,-1,"14",46,61,11,10,"high"
32,"SUPPRF71639",50,12,19,-49,-1,"40",20,68,11,10,"high"
33,"SUPPRF71639",50,10,34,-42,-12,"65",46,76,11,10,"high"
34,"SUPPRF71639",60,11,55,-2,1,"69",54,57,11,10,"high"
35,"SUPPRF71639",69,9,38,-7,1,"57",37,45,11,10,"high"
36,"SUPPRF71639",50,4,46,-8,0,"38",46,54,11,10,"high"
37,"SUPPRF71639",58,7,70,31,-1,"60",71,39,11,10,"high"
38,"SUPPRF71639",58,9,22,-15,-15,"81",37,37,11,10,"high"
39,"SUPPRF71639",54,6,28,-7,-1,"53",29,35,11,10,"high"
40,"SUPPRF71639",56,6,55,15,-16,"63",71,40,11,10,"high"
41,"SUPPRF71639",78,7,46,5,17,"54",29,41,11,10,"high"
42,"SUPPRF71639",59,4,37,-8,0,"67",37,45,11,10,"high"
43,"SUPPRF71639",82,5,54,-1,0,"56",54,55,11,10,"high"
44,"SUPPRF71639",55,24,20,-28,0,"66",20,48,11,10,"high"
45,"SUPPRF71639",56,14,47,-3,-16,"19",63,50,11,10,"high"
46,"SUPPRF71639",53,29,47,-10,27,"31",20,57,11,10,"high"
47,"SUPPRF71639",48,15,66,13,12,"40",54,53,11,10,"high"
48,"SUPPRF71639",50,22,83,27,12,"39",71,56,11,10,"high"
1,"SUPPRF56870",77,2,94,61,23,"21",71,33,4,10,"low"
2,"SUPPRF56870",72,0,46,6,17,"12",29,40,4,10,"low"
3,"SUPPRF56870",70,0,61,14,24,"2",37,47,4,10,"low"
4,"SUPPRF56870",87,0,34,-5,-12,"50",46,39,4,10,"low"
5,"SUPPRF56870",94,0,37,-5,0,"65",37,42,4,10,"low"
6,"SUPPRF56870",88,0,70,-12,-1,"82",71,82,4,10,"low"
7,"SUPPRF56870",96,0,47,9,27,"24",20,38,4,10,"low"
8,"SUPPRF56870",82,0,58,-18,12,"6",46,76,4,10,"low"
9,"SUPPRF56870",100,0,28,-23,-1,"47",29,51,4,10,"low"
10,"SUPPRF56870",100,0,49,7,12,"66",37,42,4,10,"low"
11,"SUPPRF56870",100,0,38,-13,1,"72",37,51,4,10,"low"
12,"SUPPRF56870",100,0,63,-27,0,"43",63,90,4,10,"low"
13,"SUPPRF56870",100,0,15,-32,-14,"20",29,47,4,10,"low"
14,"SUPPRF56870",100,0,54,-23,0,"54",54,77,4,10,"low"
15,"SUPPRF56870",100,0,62,-21,-1,"22",63,83,4,10,"low"
16,"SUPPRF56870",100,0,67,-25,-13,"33",80,92,4,10,"low"
17,"SUPPRF56870",100,0,78,54,24,"50",54,24,4,10,"low"
18,"SUPPRF56870",100,0,45,15,-1,"14",46,30,4,10,"low"
19,"SUPPRF56870",100,0,80,-10,0,"90",80,90,4,10,"low"
20,"SUPPRF56870",100,0,56,8,-15,"46",71,48,4,10,"low"
21,"SUPPRF56870",100,0,19,-65,-1,"18",20,84,4,10,"low"
22,"SUPPRF56870",100,0,88,-6,25,"5",63,94,4,10,"low"
23,"SUPPRF56870",100,0,22,12,-15,"4",37,10,4,10,"low"
24,"SUPPRF56870",100,0,96,74,16,"15",80,22,4,10,"low"
25,"SUPPRF56870",100,0,6,-24,-14,"50",20,30,4,10,"low"
26,"SUPPRF56870",100,0,38,-2,-16,"0",54,40,4,10,"low"
27,"SUPPRF56870",100,0,8,-58,-12,"3",20,66,4,10,"low"
28,"SUPPRF56870",100,0,20,9,0,"75",20,11,4,10,"low"
29,"SUPPRF56870",100,0,24,-29,-13,"18",37,53,4,10,"low"
30,"SUPPRF56870",100,0,75,5,29,"100",46,70,4,10,"low"
31,"SUPPRF56870",100,0,16,-38,-13,"34",29,54,4,10,"low"
32,"SUPPRF56870",100,0,47,29,-16,"15",63,18,4,10,"low"
33,"SUPPRF56870",100,0,81,-19,1,"0",80,100,4,10,"low"
34,"SUPPRF56870",100,0,66,58,12,"0",54,8,4,10,"low"
35,"SUPPRF56870",98,0,55,-9,1,"1",54,64,4,10,"low"
36,"SUPPRF56870",100,0,41,-47,-13,"0",54,88,4,10,"low"
37,"SUPPRF56870",94,0,68,-32,-12,"0",80,100,4,10,"low"
38,"SUPPRF56870",100,8,77,-5,14,"0",63,82,4,10,"low"
39,"SUPPRF56870",100,9,58,53,29,"0",29,5,4,10,"low"
40,"SUPPRF56870",100,0,100,3,20,"16",80,97,4,10,"low"
41,"SUPPRF56870",100,0,50,-27,-13,"6",63,77,4,10,"low"
42,"SUPPRF56870",100,0,83,2,12,"0",71,81,4,10,"low"
43,"SUPPRF56870",100,0,71,-10,0,"0",71,81,4,10,"low"
44,"SUPPRF56870",100,0,55,20,-16,"0",71,35,4,10,"low"
45,"SUPPRF56870",100,0,46,-50,0,"1",46,96,4,10,"low"
46,"SUPPRF56870",100,0,29,-63,0,"93",29,92,4,10,"low"
47,"SUPPRF56870",100,0,35,25,15,"77",20,10,4,10,"low"
48,"SUPPRF56870",100,0,33,-23,-13,"0",46,56,4,10,"low"
1,"SUPPRF86502",57,17,63,-6,0,"53",63,69,2,10,"low"
2,"SUPPRF86502",61,14,58,29,29,"73",29,29,2,10,"low"
3,"SUPPRF86502",63,27,83,26,12,"17",71,57,2,10,"low"
4,"SUPPRF86502",62,4,70,11,-1,"36",71,59,2,10,"low"
5,"SUPPRF86502",71,19,47,-12,-16,"13",63,59,2,10,"low"
6,"SUPPRF86502",65,16,78,21,24,"31",54,57,2,10,"low"
7,"SUPPRF86502",61,23,41,-16,-13,"50",54,57,2,10,"low"
8,"SUPPRF86502",74,23,67,-2,-13,"20",80,69,2,10,"low"
9,"SUPPRF86502",72,20,16,-38,-13,"59",29,54,2,10,"low"
10,"SUPPRF86502",67,9,81,2,1,"66",80,79,2,10,"low"
11,"SUPPRF86502",79,12,46,7,0,"28",46,39,2,10,"low"
12,"SUPPRF86502",73,17,58,12,12,"29",46,46,2,10,"low"
13,"SUPPRF86502",84,16,45,-11,-1,"78",46,56,2,10,"low"
14,"SUPPRF86502",47,19,61,28,24,"55",37,33,2,10,"low"
15,"SUPPRF86502",72,13,38,9,1,"74",37,29,2,10,"low"
16,"SUPPRF86502",62,12,94,51,23,"59",71,43,2,10,"low"
17,"SUPPRF86502",54,24,37,1,0,"85",37,36,2,10,"low"
18,"SUPPRF86502",59,16,29,-2,0,"37",29,31,2,10,"low"
19,"SUPPRF86502",13,10,56,22,-15,"36",71,34,2,10,"low"
20,"SUPPRF86502",21,18,66,23,12,"37",54,43,2,10,"low"
21,"SUPPRF86502",73,25,38,-13,-16,"11",54,51,2,10,"low"
22,"SUPPRF86502",8,16,33,-13,-13,"39",46,46,2,10,"low"
23,"SUPPRF86502",1,57,100,50,20,"32",80,50,2,10,"low"
24,"SUPPRF86502",0,5,24,-2,-13,"24",37,26,2,10,"low"
25,"SUPPRF86502",0,10,8,-41,-12,"24",20,49,2,10,"low"
26,"SUPPRF86502",0,94,71,34,0,"16",71,37,2,10,"low"
27,"SUPPRF86502",0,15,55,1,1,"14",54,54,2,10,"low"
28,"SUPPRF86502",0,12,75,36,29,"38",46,39,2,10,"low"
29,"SUPPRF86502",1,7,62,-4,-1,"62",63,66,2,10,"low"
30,"SUPPRF86502",0,5,6,-21,-14,"19",20,27,2,10,"low"
31,"SUPPRF86502",0,8,22,-2,-15,"56",37,24,2,10,"low"
32,"SUPPRF86502",1,5,28,-3,-1,"19",29,31,2,10,"low"
33,"SUPPRF86502",0,7,19,-11,-1,"22",20,30,2,10,"low"
34,"SUPPRF86502",0,7,55,23,-16,"12",71,32,2,10,"low"
35,"SUPPRF86502",13,4,34,2,-12,"11",46,32,2,10,"low"
36,"SUPPRF86502",1,4,49,17,12,"17",37,32,2,10,"low"
37,"SUPPRF86502",0,4,68,34,-12,"9",80,34,2,10,"low"
38,"SUPPRF86502",1,5,35,15,15,"22",20,20,2,10,"low"
39,"SUPPRF86502",7,5,50,-6,-13,"4",63,56,2,10,"low"
40,"SUPPRF86502",0,6,46,27,17,"9",29,19,2,10,"low"
41,"SUPPRF86502",12,6,47,0,27,"32",20,47,2,10,"low"
42,"SUPPRF86502",8,6,15,-14,-14,"11",29,29,2,10,"low"
43,"SUPPRF86502",0,6,20,-10,0,"15",20,30,2,10,"low"
44,"SUPPRF86502",9,9,54,25,0,"28",54,29,2,10,"low"
45,"SUPPRF86502",3,4,96,68,16,"9",80,28,2,10,"low"
46,"SUPPRF86502",3,0,88,52,25,"6",63,36,2,10,"low"
47,"SUPPRF86502",0,3,77,54,14,"5",63,23,2,10,"low"
48,"SUPPRF86502",1,3,80,63,0,"8",80,17,2,10,"low"
1,"SUPPRF12592",72,20,80,17,0,"62",80,63,2,10,"low"
2,"SUPPRF12592",61,27,77,25,14,"64",63,52,2,10,"low"
3,"SUPPRF12592",89,12,96,16,16,"62",80,80,2,10,"low"
4,"SUPPRF12592",81,16,33,-20,-13,"45",46,53,2,10,"low"
5,"SUPPRF12592",93,4,88,32,25,"24",63,56,2,10,"low"
6,"SUPPRF12592",89,5,68,-15,-12,"81",80,83,2,10,"low"
7,"SUPPRF12592",84,7,38,16,1,"35",37,22,2,10,"low"
8,"SUPPRF12592",91,7,78,11,24,"65",54,67,2,10,"low"
9,"SUPPRF12592",98,2,100,43,20,"28",80,57,2,10,"low"
10,"SUPPRF12592",94,6,71,10,0,"62",71,61,2,10,"low"
11,"SUPPRF12592",96,1,58,15,29,"24",29,43,2,10,"low"
12,"SUPPRF12592",94,4,56,-10,-15,"78",71,66,2,10,"low"
13,"SUPPRF12592",99,2,83,17,12,"86",71,66,2,10,"low"
14,"SUPPRF12592",90,5,22,-14,-15,"8",37,36,2,10,"low"
15,"SUPPRF12592",94,3,63,13,0,"31",63,50,2,10,"low"
16,"SUPPRF12592",95,3,15,-40,-14,"73",29,55,2,10,"low"
17,"SUPPRF12592",92,3,47,16,-16,"19",63,31,2,10,"low"
18,"SUPPRF12592",79,3,19,-42,-1,"32",20,61,2,10,"low"
19,"SUPPRF12592",90,1,20,-2,0,"93",20,22,2,10,"low"
20,"SUPPRF12592",90,3,24,-13,-13,"12",37,37,2,10,"low"
21,"SUPPRF12592",84,0,81,-12,1,"92",80,93,2,10,"low"
22,"SUPPRF12592",69,1,8,-8,-12,"90",20,16,2,10,"low"
23,"SUPPRF12592",72,5,28,-34,-1,"32",29,62,2,10,"low"
24,"SUPPRF12592",97,0,61,39,24,"82",37,22,2,10,"low"
25,"SUPPRF12592",88,4,75,14,29,"60",46,61,2,10,"low"
26,"SUPPRF12592",90,2,46,-1,0,"80",46,47,2,10,"low"
27,"SUPPRF12592",94,1,35,-2,15,"81",20,37,2,10,"low"
28,"SUPPRF12592",95,0,66,-11,12,"73",54,77,2,10,"low"
29,"SUPPRF12592",83,3,16,-22,-13,"36",29,38,2,10,"low"
30,"SUPPRF12592",87,3,70,-1,-1,"76",71,71,2,10,"low"
31,"SUPPRF12592",95,2,62,24,-1,"17",63,38,2,10,"low"
32,"SUPPRF12592",93,1,55,-21,-16,"85",71,76,2,10,"low"
33,"SUPPRF12592",93,2,37,-18,0,"40",37,55,2,10,"low"
34,"SUPPRF12592",95,1,47,20,27,"80",20,27,2,10,"low"
35,"SUPPRF12592",94,3,29,-27,0,"60",29,56,2,10,"low"
36,"SUPPRF12592",88,3,38,-10,-16,"71",54,48,2,10,"low"
37,"SUPPRF12592",100,0,94,44,23,"34",71,50,2,10,"low"
38,"SUPPRF12592",87,0,50,-5,-13,"21",63,55,2,10,"low"
39,"SUPPRF12592",86,0,45,-16,-1,"35",46,61,2,10,"low"
40,"SUPPRF12592",80,0,55,-10,1,"84",54,65,2,10,"low"
41,"SUPPRF12592",75,2,46,14,17,"80",29,32,2,10,"low"
42,"SUPPRF12592",73,0,49,11,12,"65",37,38,2,10,"low"
43,"SUPPRF12592",75,6,58,16,12,"73",46,42,2,10,"low"
44,"SUPPRF12592",75,4,34,-15,-12,"71",46,49,2,10,"low"
45,"SUPPRF12592",84,0,6,-26,-14,"82",20,32,2,10,"low"
46,"SUPPRF12592",88,0,41,-9,-13,"75",54,50,2,10,"low"
47,"SUPPRF12592",75,5,54,9,0,"65",54,45,2,10,"low"
48,"SUPPRF12592",80,0,67,-10,-13,"74",80,77,2,10,"low"
1,"SUPPRF53463",99,2,6,-14,-14,"1",20,20,5,10,"low"
2,"SUPPRF53463",99,1,96,16,16,"1",80,80,5,10,"low"
3,"SUPPRF53463",98,1,81,13,1,"1",80,68,5,10,"low"
4,"SUPPRF53463",98,1,94,24,23,"0",71,70,5,10,"low"
5,"SUPPRF53463",99,0,56,-26,-15,"1",71,82,5,10,"low"
6,"SUPPRF53463",99,0,15,-10,-14,"0",29,25,5,10,"low"
7,"SUPPRF53463",98,1,83,61,12,"1",71,22,5,10,"low"
8,"SUPPRF53463",99,0,8,-9,-12,"1",20,17,5,10,"low"
9,"SUPPRF53463",99,1,22,-9,-15,"1",37,31,5,10,"low"
10,"SUPPRF53463",98,2,20,1,0,"1",20,19,5,10,"low"
11,"SUPPRF53463",99,1,71,4,0,"1",71,67,5,10,"low"
12,"SUPPRF53463",98,1,63,-13,0,"1",63,76,5,10,"low"
13,"SUPPRF53463",99,0,47,27,27,"3",20,20,5,10,"low"
14,"SUPPRF53463",100,0,29,9,0,"0",29,20,5,10,"low"
15,"SUPPRF53463",98,1,80,15,0,"1",80,65,5,10,"low"
16,"SUPPRF53463",98,1,47,-20,-16,"2",63,67,5,10,"low"
17,"SUPPRF53463",98,1,37,9,0,"3",37,28,5,10,"low"
18,"SUPPRF53463",98,1,35,15,15,"5",20,20,5,10,"low"
19,"SUPPRF53463",98,1,78,20,24,"6",54,58,5,10,"low"
20,"SUPPRF53463",98,1,66,9,12,"6",54,57,5,10,"low"
21,"SUPPRF53463",99,1,88,29,25,"5",63,59,5,10,"low"
22,"SUPPRF53463",99,1,62,-9,-1,"9",63,71,5,10,"low"
23,"SUPPRF53463",97,0,61,18,24,"7",37,43,5,10,"low"
24,"SUPPRF53463",99,1,50,-19,-13,"6",63,69,5,10,"low"
25,"SUPPRF53463",98,1,45,-2,-1,"5",46,47,5,10,"low"
26,"SUPPRF53463",98,0,28,-2,-1,"5",29,30,5,10,"low"
27,"SUPPRF53463",99,1,46,20,17,"6",29,26,5,10,"low"
28,"SUPPRF53463",99,1,38,-18,-16,"5",54,56,5,10,"low"
29,"SUPPRF53463",99,1,16,-10,-13,"4",29,26,5,10,"low"
30,"SUPPRF53463",99,1,55,0,1,"8",54,55,5,10,"low"
31,"SUPPRF53463",99,0,49,1,12,"5",37,48,5,10,"low"
32,"SUPPRF53463",98,1,54,-1,0,"8",54,55,5,10,"low"
33,"SUPPRF53463",98,0,34,-11,-12,"9",46,45,5,10,"low"
34,"SUPPRF53463",99,1,100,20,20,"7",80,80,5,10,"low"
35,"SUPPRF53463",99,0,75,32,29,"6",46,43,5,10,"low"
36,"SUPPRF53463",99,1,58,28,29,"6",29,30,5,10,"low"
37,"SUPPRF53463",98,1,19,0,-1,"8",20,19,5,10,"low"
38,"SUPPRF53463",98,0,33,-15,-13,"12",46,48,5,10,"low"
39,"SUPPRF53463",99,2,24,-16,-13,"8",37,40,5,10,"low"
40,"SUPPRF53463",100,1,67,-16,-13,"10",80,83,5,10,"low"
41,"SUPPRF53463",98,2,41,-13,-13,"11",54,54,5,10,"low"
42,"SUPPRF53463",98,1,38,0,1,"8",37,38,5,10,"low"
43,"SUPPRF53463",98,0,70,0,-1,"9",71,70,5,10,"low"
44,"SUPPRF53463",99,1,68,-15,-12,"8",80,83,5,10,"low"
45,"SUPPRF53463",99,0,46,3,0,"7",46,43,5,10,"low"
46,"SUPPRF53463",98,2,55,-17,-16,"11",71,72,5,10,"low"
47,"SUPPRF53463",98,0,77,11,14,"8",63,66,5,10,"low"
48,"SUPPRF53463",99,2,58,-7,12,"10",46,65,5,10,"low"
1,"SUPPRF17225",65,13,61,19,24,"66",37,42,1,10,"low"
2,"SUPPRF17225",73,7,80,-8,0,"76",80,88,1,10,"low"
3,"SUPPRF17225",80,11,77,12,14,"54",63,65,1,10,"low"
4,"SUPPRF17225",84,10,56,-17,-15,"65",71,73,1,10,"low"
5,"SUPPRF17225",80,8,37,5,0,"76",37,32,1,10,"low"
6,"SUPPRF17225",86,5,55,-28,-16,"71",71,83,1,10,"low"
7,"SUPPRF17225",84,7,46,6,17,"55",29,40,1,10,"low"
8,"SUPPRF17225",86,5,63,-8,0,"51",63,71,1,10,"low"
9,"SUPPRF17225",86,5,50,-4,-13,"50",63,54,1,10,"low"
10,"SUPPRF17225",89,8,83,5,12,"55",71,78,1,10,"low"
11,"SUPPRF17225",89,11,96,9,16,"54",80,87,1,10,"low"
12,"SUPPRF17225",90,7,15,-13,-14,"52",29,28,1,10,"low"
13,"SUPPRF17225",78,18,46,-6,0,"54",46,52,1,10,"low"
14,"SUPPRF17225",82,18,54,10,0,"52",54,44,1,10,"low"
15,"SUPPRF17225",84,18,29,7,0,"50",29,22,1,10,"low"
16,"SUPPRF17225",92,8,24,-20,-13,"52",37,44,1,10,"low"
17,"SUPPRF17225",76,18,58,28,29,"31",29,30,1,10,"low"
18,"SUPPRF17225",84,19,22,-14,-15,"35",37,36,1,10,"low"
19,"SUPPRF17225",80,26,70,25,-1,"30",71,45,1,10,"low"
20,"SUPPRF17225",81,21,33,-14,-13,"37",46,47,1,10,"low"
21,"SUPPRF17225",86,16,58,22,12,"31",46,36,1,10,"low"
22,"SUPPRF17225",86,16,6,-17,-14,"25",20,23,1,10,"low"
23,"SUPPRF17225",85,19,75,26,29,"25",46,49,1,10,"low"
24,"SUPPRF17225",87,17,67,-15,-13,"21",80,82,1,10,"low"
25,"SUPPRF17225",84,16,62,0,-1,"23",63,62,1,10,"low"
26,"SUPPRF17225",87,18,47,-5,-16,"23",63,52,1,10,"low"
27,"SUPPRF17225",88,13,100,23,20,"20",80,77,1,10,"low"
28,"SUPPRF17225",90,16,49,14,12,"20",37,35,1,10,"low"
29,"SUPPRF17225",87,12,78,21,24,"23",54,57,1,10,"low"
30,"SUPPRF17225",89,17,19,-7,-1,"19",20,26,1,10,"low"
31,"SUPPRF17225",87,13,38,-3,1,"23",37,41,1,10,"low"
32,"SUPPRF17225",87,16,16,-16,-13,"19",29,32,1,10,"low"
33,"SUPPRF17225",86,12,68,-13,-12,"11",80,81,1,10,"low"
34,"SUPPRF17225",77,34,45,9,-1,"15",46,36,1,10,"low"
35,"SUPPRF17225",66,23,28,-4,-1,"18",29,32,1,10,"low"
36,"SUPPRF17225",69,34,66,14,12,"19",54,52,1,10,"low"
37,"SUPPRF17225",81,36,34,-15,-12,"19",46,49,1,10,"low"
38,"SUPPRF17225",75,28,20,-13,0,"29",20,33,1,10,"low"
39,"SUPPRF17225",76,31,55,-1,1,"16",54,56,1,10,"low"
40,"SUPPRF17225",69,34,38,-21,-16,"15",54,59,1,10,"low"
41,"SUPPRF17225",68,28,71,25,0,"23",71,46,1,10,"low"
42,"SUPPRF17225",69,31,81,-5,1,"16",80,86,1,10,"low"
43,"SUPPRF17225",60,47,35,12,15,"13",20,23,1,10,"low"
44,"SUPPRF17225",63,21,88,30,25,"13",63,58,1,10,"low"
45,"SUPPRF17225",71,32,94,11,23,"15",71,83,1,10,"low"
46,"SUPPRF17225",84,28,8,-29,-12,"15",20,37,1,10,"low"
47,"SUPPRF17225",83,21,41,-21,-13,"18",54,62,1,10,"low"
48,"SUPPRF17225",85,14,47,26,27,"16",20,21,1,10,"low"
1,"SUPPRF34408",1,100,66,56,12,"14",54,10,12,10,"high"
2,"SUPPRF34408",1,99,75,58,29,"61",46,17,12,10,"high"
3,"SUPPRF34408",2,98,41,9,-13,"60",54,32,12,10,"high"
4,"SUPPRF34408",1,98,100,81,20,"19",80,19,12,10,"high"
5,"SUPPRF34408",3,97,70,56,-1,"21",71,14,12,10,"high"
6,"SUPPRF34408",2,97,33,18,-13,"18",46,15,12,10,"high"
7,"SUPPRF34408",0,99,38,23,-16,"22",54,15,12,10,"high"
8,"SUPPRF34408",0,100,35,19,15,"15",20,16,12,10,"high"
9,"SUPPRF34408",2,98,71,61,0,"18",71,10,12,10,"high"
10,"SUPPRF34408",1,99,61,40,24,"22",37,21,12,10,"high"
11,"SUPPRF34408",2,99,47,32,27,"22",20,15,12,10,"high"
12,"SUPPRF34408",1,99,55,35,1,"9",54,20,12,10,"high"
13,"SUPPRF34408",1,99,34,20,-12,"19",46,14,12,10,"high"
14,"SUPPRF34408",2,99,49,34,12,"15",37,15,12,10,"high"
15,"SUPPRF34408",0,99,45,24,-1,"16",46,21,12,10,"high"
16,"SUPPRF34408",2,98,19,8,-1,"26",20,11,12,10,"high"
17,"SUPPRF34408",1,99,29,8,0,"25",29,21,12,10,"high"
18,"SUPPRF34408",0,99,24,11,-13,"17",37,13,12,10,"high"
19,"SUPPRF34408",1,100,6,-20,-14,"17",20,26,12,10,"high"
20,"SUPPRF34408",1,100,20,7,0,"18",20,13,12,10,"high"
21,"SUPPRF34408",2,99,22,9,-15,"14",37,13,12,10,"high"
22,"SUPPRF34408",3,97,81,67,1,"19",80,14,12,10,"high"
23,"SUPPRF34408",2,99,83,73,12,"16",71,10,12,10,"high"
24,"SUPPRF34408",1,99,68,56,-12,"11",80,12,12,10,"high"
25,"SUPPRF34408",1,98,88,78,25,"23",63,10,12,10,"high"
26,"SUPPRF34408",2,99,67,56,-13,"14",80,11,12,10,"high"
27,"SUPPRF34408",4,89,94,82,23,"16",71,12,12,10,"high"
28,"SUPPRF34408",0,99,28,25,-1,"29",29,3,12,10,"high"
29,"SUPPRF34408",2,99,15,4,-14,"9",29,11,12,10,"high"
30,"SUPPRF34408",1,99,58,45,29,"18",29,13,12,10,"high"
31,"SUPPRF34408",19,99,37,21,0,"20",37,16,12,10,"high"
32,"SUPPRF34408",1,99,55,45,-16,"19",71,10,12,10,"high"
33,"SUPPRF34408",1,99,54,43,0,"23",54,11,12,10,"high"
34,"SUPPRF34408",0,99,38,24,1,"20",37,14,12,10,"high"
35,"SUPPRF34408",3,100,16,-2,-13,"19",29,18,12,10,"high"
36,"SUPPRF34408",2,99,46,32,0,"12",46,14,12,10,"high"
37,"SUPPRF34408",1,99,80,69,0,"28",80,11,12,10,"high"
38,"SUPPRF34408",2,97,77,54,14,"25",63,23,12,10,"high"
39,"SUPPRF34408",2,99,8,-12,-12,"29",20,20,12,10,"high"
40,"SUPPRF34408",2,99,78,53,24,"26",54,25,12,10,"high"
41,"SUPPRF34408",1,98,63,41,0,"10",63,22,12,10,"high"
42,"SUPPRF34408",2,98,50,24,-13,"36",63,26,12,10,"high"
43,"SUPPRF34408",2,100,56,38,-15,"21",71,18,12,10,"high"
44,"SUPPRF34408",1,99,96,68,16,"31",80,28,12,10,"high"
45,"SUPPRF34408",3,98,46,23,17,"20",29,23,12,10,"high"
46,"SUPPRF34408",1,100,47,25,-16,"17",63,22,12,10,"high"
47,"SUPPRF34408",1,98,58,41,12,"38",46,17,12,10,"high"
48,"SUPPRF34408",2,99,62,39,-1,"32",63,23,12,10,"high"
1,"SUPPRF78865",45,70,15,-12,-14,"55",29,27,7,10,"high"
2,"SUPPRF78865",41,70,80,7,0,"43",80,73,7,10,"high"
3,"SUPPRF78865",46,67,49,19,12,"38",37,30,7,10,"high"
4,"SUPPRF78865",35,69,47,-18,-16,"60",63,65,7,10,"high"
5,"SUPPRF78865",43,72,56,6,-15,"27",71,50,7,10,"high"
6,"SUPPRF78865",42,73,50,-10,-13,"64",63,60,7,10,"high"
7,"SUPPRF78865",31,74,67,-12,-13,"63",80,79,7,10,"high"
8,"SUPPRF78865",47,82,16,-11,-13,"67",29,27,7,10,"high"
9,"SUPPRF78865",43,81,6,-35,-14,"29",20,41,7,10,"high"
10,"SUPPRF78865",40,74,61,28,24,"39",37,33,7,10,"high"
11,"SUPPRF78865",31,77,35,-3,15,"29",20,38,7,10,"high"
12,"SUPPRF78865",29,78,81,52,1,"27",80,29,7,10,"high"
13,"SUPPRF78865",43,80,88,38,25,"11",63,50,7,10,"high"
14,"SUPPRF78865",40,80,100,27,20,"65",80,73,7,10,"high"
15,"SUPPRF78865",32,78,46,15,17,"50",29,31,7,10,"high"
16,"SUPPRF78865",39,78,77,12,14,"58",63,65,7,10,"high"
17,"SUPPRF78865",41,78,34,-24,-12,"24",46,58,7,10,"high"
18,"SUPPRF78865",42,70,83,17,12,"53",71,66,7,10,"high"
19,"SUPPRF78865",37,74,55,-1,1,"60",54,56,7,10,"high"
20,"SUPPRF78865",37,80,37,-13,0,"28",37,50,7,10,"high"
21,"SUPPRF78865",36,72,75,16,29,"26",46,59,7,10,"high"
22,"SUPPRF78865",34,74,29,0,0,"54",29,29,7,10,"high"
23,"SUPPRF78865",42,67,66,13,12,"56",54,53,7,10,"high"
24,"SUPPRF78865",30,68,71,5,0,"66",71,66,7,10,"high"
25,"SUPPRF78865",35,73,20,-30,0,"12",20,50,7,10,"high"
26,"SUPPRF78865",39,74,62,7,-1,"45",63,55,7,10,"high"
27,"SUPPRF78865",26,78,96,42,16,"31",80,54,7,10,"high"
28,"SUPPRF78865",34,87,68,-11,-12,"72",80,79,7,10,"high"
29,"SUPPRF78865",25,88,78,27,24,"59",54,51,7,10,"high"
30,"SUPPRF78865",25,81,94,43,23,"27",71,51,7,10,"high"
31,"SUPPRF78865",37,83,33,-15,-13,"56",46,48,7,10,"high"
32,"SUPPRF78865",33,81,24,-24,-13,"57",37,48,7,10,"high"
33,"SUPPRF78865",25,79,63,0,0,"50",63,63,7,10,"high"
34,"SUPPRF78865",36,75,41,-10,-13,"67",54,51,7,10,"high"
35,"SUPPRF78865",29,82,54,3,0,"63",54,51,7,10,"high"
36,"SUPPRF78865",38,75,47,29,27,"63",20,18,7,10,"high"
37,"SUPPRF78865",32,79,22,-11,-15,"67",37,33,7,10,"high"
38,"SUPPRF78865",27,78,38,1,1,"70",37,37,7,10,"high"
39,"SUPPRF78865",28,60,58,30,29,"70",29,28,7,10,"high"
40,"SUPPRF78865",41,68,70,34,-1,"50",71,36,7,10,"high"
41,"SUPPRF78865",44,78,28,2,-1,"71",29,26,7,10,"high"
42,"SUPPRF78865",26,77,8,-7,-12,"66",20,15,7,10,"high"
43,"SUPPRF78865",33,73,58,19,12,"64",46,39,7,10,"high"
44,"SUPPRF78865",26,78,55,5,-16,"23",71,50,7,10,"high"
45,"SUPPRF78865",31,68,38,-12,-16,"65",54,50,7,10,"high"
46,"SUPPRF78865",23,71,45,9,-1,"72",46,36,7,10,"high"
47,"SUPPRF78865",29,74,19,2,-1,"80",20,17,7,10,"high"
48,"SUPPRF78865",27,78,46,6,0,"75",46,40,7,10,"high"
1,"SUPPRF62860",48,36,66,23,12,"65",54,43,5,10,"low"
2,"SUPPRF62860",72,22,100,39,20,"70",80,61,5,10,"low"
3,"SUPPRF62860",72,8,96,12,16,"86",80,84,5,10,"low"
4,"SUPPRF62860",52,19,63,-14,0,"52",63,77,5,10,"low"
5,"SUPPRF62860",77,21,81,0,1,"82",80,81,5,10,"low"
6,"SUPPRF62860",74,25,70,9,-1,"55",71,61,5,10,"low"
7,"SUPPRF62860",49,20,35,-15,15,"49",20,50,5,10,"low"
8,"SUPPRF62860",71,11,78,5,24,"55",54,73,5,10,"low"
9,"SUPPRF62860",57,15,8,-59,-12,"25",20,67,5,10,"low"
10,"SUPPRF62860",54,40,56,-24,-15,"73",71,80,5,10,"low"
11,"SUPPRF62860",55,43,58,5,29,"51",29,53,5,10,"low"
12,"SUPPRF62860",52,50,24,-29,-13,"51",37,53,5,10,"low"
13,"SUPPRF62860",51,47,46,-2,0,"48",46,48,5,10,"low"
14,"SUPPRF62860",50,52,29,-21,0,"50",29,50,5,10,"low"
15,"SUPPRF62860",63,52,54,2,0,"54",54,52,5,10,"low"
16,"SUPPRF62860",49,50,16,-31,-13,"50",29,47,5,10,"low"
17,"SUPPRF62860",50,50,20,-29,0,"47",20,49,5,10,"low"
18,"SUPPRF62860",48,49,38,-17,1,"50",37,55,5,10,"low"
19,"SUPPRF62860",59,43,61,14,24,"38",37,47,5,10,"low"
20,"SUPPRF62860",63,37,47,-4,-16,"55",63,51,5,10,"low"
21,"SUPPRF62860",61,38,55,1,1,"59",54,54,5,10,"low"
22,"SUPPRF62860",40,57,45,4,-1,"66",46,41,5,10,"low"
23,"SUPPRF62860",57,42,49,-12,12,"61",37,61,5,10,"low"
24,"SUPPRF62860",61,45,46,-8,17,"57",29,54,5,10,"low"
25,"SUPPRF62860",46,39,77,24,14,"43",63,53,5,10,"low"
26,"SUPPRF62860",41,56,6,-53,-14,"53",20,59,5,10,"low"
27,"SUPPRF62860",37,50,55,0,-16,"42",71,55,5,10,"low"
28,"SUPPRF62860",53,44,71,16,0,"54",71,55,5,10,"low"
29,"SUPPRF62860",55,40,83,28,12,"42",71,55,5,10,"low"
30,"SUPPRF62860",38,35,37,-15,0,"54",37,52,5,10,"low"
31,"SUPPRF62860",55,48,28,-26,-1,"46",29,54,5,10,"low"
32,"SUPPRF62860",45,44,19,-8,-1,"74",20,27,5,10,"low"
33,"SUPPRF62860",61,34,94,28,23,"57",71,66,5,10,"low"
34,"SUPPRF62860",55,42,38,-18,-16,"56",54,56,5,10,"low"
35,"SUPPRF62860",56,41,75,21,29,"35",46,54,5,10,"low"
36,"SUPPRF62860",56,47,68,23,-12,"45",80,45,5,10,"low"
37,"SUPPRF62860",34,43,47,28,27,"84",20,19,5,10,"low"
38,"SUPPRF62860",48,44,22,-29,-15,"49",37,51,5,10,"low"
39,"SUPPRF62860",53,52,50,-8,-13,"60",63,58,5,10,"low"
40,"SUPPRF62860",47,55,58,1,12,"44",46,57,5,10,"low"
41,"SUPPRF62860",50,43,62,1,-1,"55",63,61,5,10,"low"
42,"SUPPRF62860",41,37,34,-22,-12,"45",46,56,5,10,"low"
43,"SUPPRF62860",42,59,67,11,-13,"64",80,56,5,10,"low"
44,"SUPPRF62860",30,41,15,-18,-14,"62",29,33,5,10,"low"
45,"SUPPRF62860",52,42,80,24,0,"53",80,56,5,10,"low"
46,"SUPPRF62860",36,33,33,-12,-13,"58",46,45,5,10,"low"
47,"SUPPRF62860",38,35,88,36,25,"42",63,52,5,10,"low"
48,"SUPPRF62860",55,38,41,4,-13,"40",54,37,5,10,"low"
1,"SUPPRF65333",44,55,16,-9,-13,"59",29,25,9,10,"high"
2,"SUPPRF65333",50,52,75,48,29,"49",46,27,9,10,"high"
3,"SUPPRF65333",50,49,15,-7,-14,"55",29,22,9,10,"high"
4,"SUPPRF65333",50,53,80,7,0,"55",80,73,9,10,"high"
5,"SUPPRF65333",51,52,37,9,0,"54",37,28,9,10,"high"
6,"SUPPRF65333",52,39,81,30,1,"28",80,51,9,10,"high"
7,"SUPPRF65333",50,47,33,4,-13,"58",46,29,9,10,"high"
8,"SUPPRF65333",47,48,46,1,0,"56",46,45,9,10,"high"
9,"SUPPRF65333",50,52,6,-11,-14,"56",20,17,9,10,"high"
10,"SUPPRF65333",51,43,54,20,0,"19",54,34,9,10,"high"
11,"SUPPRF65333",60,40,96,22,16,"56",80,74,9,10,"high"
12,"SUPPRF65333",64,40,20,9,0,"64",20,11,9,10,"high"
13,"SUPPRF65333",64,34,50,-6,-13,"58",63,56,9,10,"high"
14,"SUPPRF65333",60,36,34,-4,-12,"58",46,38,9,10,"high"
15,"SUPPRF65333",58,36,55,14,1,"40",54,41,9,10,"high"
16,"SUPPRF65333",56,42,24,-7,-13,"57",37,31,9,10,"high"
17,"SUPPRF65333",54,40,49,18,12,"60",37,31,9,10,"high"
18,"SUPPRF65333",51,24,47,35,27,"64",20,12,9,10,"high"
19,"SUPPRF65333",60,28,28,-11,-1,"21",29,39,9,10,"high"
20,"SUPPRF65333",57,29,61,22,24,"36",37,39,9,10,"high"
21,"SUPPRF65333",56,34,45,15,-1,"55",46,30,9,10,"high"
22,"SUPPRF65333",57,34,66,21,12,"62",54,45,9,10,"high"
23,"SUPPRF65333",51,27,67,-9,-13,"68",80,76,9,10,"high"
24,"SUPPRF65333",51,33,47,2,-16,"37",63,45,9,10,"high"
25,"SUPPRF65333",56,32,55,-6,-16,"71",71,61,9,10,"high"
26,"SUPPRF65333",58,37,71,15,0,"69",71,56,9,10,"high"
27,"SUPPRF65333",52,41,77,21,14,"55",63,56,9,10,"high"
28,"SUPPRF65333",62,28,100,25,20,"75",80,75,9,10,"high"
29,"SUPPRF65333",61,40,94,29,23,"71",71,65,9,10,"high"
30,"SUPPRF65333",36,35,38,-24,1,"56",37,62,9,10,"high"
31,"SUPPRF65333",55,31,62,10,-1,"55",63,52,9,10,"high"
32,"SUPPRF65333",37,31,22,-11,-15,"65",37,33,9,10,"high"
33,"SUPPRF65333",38,40,56,-3,-15,"62",71,59,9,10,"high"
34,"SUPPRF65333",50,27,58,12,12,"48",46,46,9,10,"high"
35,"SUPPRF65333",52,43,63,11,0,"64",63,52,9,10,"high"
36,"SUPPRF65333",62,30,68,5,-12,"70",80,63,9,10,"high"
37,"SUPPRF65333",33,44,41,-11,-13,"57",54,52,9,10,"high"
38,"SUPPRF65333",52,28,88,36,25,"65",63,52,9,10,"high"
39,"SUPPRF65333",55,35,8,-10,-12,"52",20,18,9,10,"high"
40,"SUPPRF65333",55,32,78,25,24,"49",54,53,9,10,"high"
41,"SUPPRF65333",52,36,19,8,-1,"73",20,11,9,10,"high"
42,"SUPPRF65333",59,26,46,27,17,"58",29,19,9,10,"high"
43,"SUPPRF65333",54,34,35,20,15,"64",20,15,9,10,"high"
44,"SUPPRF65333",64,38,70,6,-1,"66",71,64,9,10,"high"
45,"SUPPRF65333",60,42,58,34,29,"69",29,24,9,10,"high"
46,"SUPPRF65333",57,26,38,-6,-16,"27",54,44,9,10,"high"
47,"SUPPRF65333",56,25,29,11,0,"58",29,18,9,10,"high"
48,"SUPPRF65333",63,39,83,35,12,"36",71,48,9,10,"high"
1,"SUPPRF82563",36,35,71,32,0,"37",71,39,7,10,"high"
2,"SUPPRF82563",35,28,38,-13,-16,"3",54,51,7,10,"high"
3,"SUPPRF82563",34,33,46,11,17,"59",29,35,7,10,"high"
4,"SUPPRF82563",33,27,68,20,-12,"40",80,48,7,10,"high"
5,"SUPPRF82563",28,27,81,34,1,"46",80,47,7,10,"high"
6,"SUPPRF82563",36,25,34,3,-12,"40",46,31,7,10,"high"
7,"SUPPRF82563",30,21,41,20,-13,"61",54,21,7,10,"high"
8,"SUPPRF82563",30,20,58,27,29,"56",29,31,7,10,"high"
9,"SUPPRF82563",30,19,38,-2,1,"16",37,40,7,10,"high"
10,"SUPPRF82563",27,31,37,23,0,"32",37,14,7,10,"high"
11,"SUPPRF82563",40,31,77,44,14,"62",63,33,7,10,"high"
12,"SUPPRF82563",32,30,46,-11,0,"55",46,57,7,10,"high"
13,"SUPPRF82563",35,37,67,11,-13,"72",80,56,7,10,"high"
14,"SUPPRF82563",33,32,33,8,-13,"54",46,25,7,10,"high"
15,"SUPPRF82563",36,37,56,28,-15,"50",71,28,7,10,"high"
16,"SUPPRF82563",34,36,47,20,-16,"37",63,27,7,10,"high"
17,"SUPPRF82563",38,32,28,1,-1,"43",29,27,7,10,"high"
18,"SUPPRF82563",32,35,66,44,12,"32",54,22,7,10,"high"
19,"SUPPRF82563",35,31,80,14,0,"67",80,66,7,10,"high"
20,"SUPPRF82563",32,34,63,12,0,"42",63,51,7,10,"high"
21,"SUPPRF82563",32,32,54,16,0,"13",54,38,7,10,"high"
22,"SUPPRF82563",30,33,50,10,-13,"26",63,40,7,10,"high"
23,"SUPPRF82563",33,34,55,24,-16,"9",71,31,7,10,"high"
24,"SUPPRF82563",32,35,88,65,25,"18",63,23,7,10,"high"
25,"SUPPRF82563",34,43,20,-18,0,"39",20,38,7,10,"high"
26,"SUPPRF82563",32,33,24,-14,-13,"9",37,38,7,10,"high"
27,"SUPPRF82563",36,34,70,27,-1,"18",71,43,7,10,"high"
28,"SUPPRF82563",38,35,22,-44,-15,"26",37,66,7,10,"high"
29,"SUPPRF82563",36,34,61,13,24,"63",37,48,7,10,"high"
30,"SUPPRF82563",33,34,55,16,1,"20",54,39,7,10,"high"
31,"SUPPRF82563",36,42,16,-13,-13,"71",29,29,7,10,"high"
32,"SUPPRF82563",35,37,96,62,16,"26",80,34,7,10,"high"
33,"SUPPRF82563",39,39,49,-9,12,"66",37,58,7,10,"high"
34,"SUPPRF82563",37,38,94,59,23,"33",71,35,7,10,"high"
35,"SUPPRF82563",31,21,29,2,0,"13",29,27,7,10,"high"
36,"SUPPRF82563",34,35,35,-15,15,"61",20,50,7,10,"high"
37,"SUPPRF82563",29,31,47,32,27,"13",20,15,7,10,"high"
38,"SUPPRF82563",37,38,75,16,29,"57",46,59,7,10,"high"
39,"SUPPRF82563",35,38,19,6,-1,"32",20,13,7,10,"high"
40,"SUPPRF82563",30,33,83,53,12,"9",71,30,7,10,"high"
41,"SUPPRF82563",36,34,78,48,24,"18",54,30,7,10,"high"
42,"SUPPRF82563",34,36,58,40,12,"68",46,18,7,10,"high"
43,"SUPPRF82563",34,35,45,-18,-1,"54",46,63,7,10,"high"
44,"SUPPRF82563",26,43,8,-25,-12,"56",20,33,7,10,"high"
45,"SUPPRF82563",34,33,15,-5,-14,"57",29,20,7,10,"high"
46,"SUPPRF82563",25,42,6,-34,-14,"23",20,40,7,10,"high"
47,"SUPPRF82563",49,27,100,72,20,"24",80,28,7,10,"high"
48,"SUPPRF82563",39,39,62,31,-1,"14",63,31,7,10,"high"
1,"SUPPRF61122",55,46,100,34,20,"60",80,66,4,10,"low"
2,"SUPPRF61122",50,51,55,6,1,"49",54,49,4,10,"low"
3,"SUPPRF61122",41,62,33,-7,-13,"48",46,40,4,10,"low"
4,"SUPPRF61122",51,50,83,26,12,"50",71,57,4,10,"low"
5,"SUPPRF61122",53,48,81,32,1,"49",80,49,4,10,"low"
6,"SUPPRF61122",59,41,47,27,27,"49",20,20,4,10,"low"
7,"SUPPRF61122",45,56,58,26,12,"52",46,32,4,10,"low"
8,"SUPPRF61122",65,31,62,11,-1,"52",63,51,4,10,"low"
9,"SUPPRF61122",32,69,22,-26,-15,"49",37,48,4,10,"low"
10,"SUPPRF61122",50,51,38,7,1,"64",37,31,4,10,"low"
11,"SUPPRF61122",33,60,34,-17,-12,"67",46,51,4,10,"low"
12,"SUPPRF61122",87,42,20,2,0,"72",20,18,4,10,"low"
13,"SUPPRF61122",23,51,15,-35,-14,"50",29,50,4,10,"low"
14,"SUPPRF61122",71,41,58,28,29,"66",29,30,4,10,"low"
15,"SUPPRF61122",55,43,49,6,12,"67",37,43,4,10,"low"
16,"SUPPRF61122",37,53,8,-10,-12,"82",20,18,4,10,"low"
17,"SUPPRF61122",54,48,29,8,0,"80",29,21,4,10,"low"
18,"SUPPRF61122",71,39,70,1,-1,"75",71,69,4,10,"low"
19,"SUPPRF61122",94,18,94,18,23,"54",71,76,4,10,"low"
20,"SUPPRF61122",37,57,24,-13,-13,"55",37,37,4,10,"low"
21,"SUPPRF61122",88,26,66,17,12,"69",54,49,4,10,"low"
22,"SUPPRF61122",71,39,37,0,0,"76",37,37,4,10,"low"
23,"SUPPRF61122",90,16,54,4,0,"56",54,50,4,10,"low"
24,"SUPPRF61122",58,42,35,34,15,"87",20,1,4,10,"low"
25,"SUPPRF61122",41,61,41,-8,-13,"70",54,49,4,10,"low"
26,"SUPPRF61122",27,56,50,-8,-13,"63",63,58,4,10,"low"
27,"SUPPRF61122",25,76,38,-17,-16,"67",54,55,4,10,"low"
28,"SUPPRF61122",27,79,16,-26,-13,"66",29,42,4,10,"low"
29,"SUPPRF61122",43,53,68,-5,-12,"77",80,73,4,10,"low"
30,"SUPPRF61122",97,6,78,35,24,"79",54,43,4,10,"low"
31,"SUPPRF61122",55,42,61,20,24,"66",37,41,4,10,"low"
32,"SUPPRF61122",40,62,46,-6,17,"50",29,52,4,10,"low"
33,"SUPPRF61122",55,43,45,6,-1,"59",46,39,4,10,"low"
34,"SUPPRF61122",54,49,19,2,-1,"85",20,17,4,10,"low"
35,"SUPPRF61122",75,37,63,8,0,"80",63,55,4,10,"low"
36,"SUPPRF61122",53,46,55,6,-16,"45",71,49,4,10,"low"
37,"SUPPRF61122",53,41,6,3,-14,"58",20,3,4,10,"low"
38,"SUPPRF61122",98,13,96,14,16,"87",80,82,4,10,"low"
39,"SUPPRF61122",66,39,46,5,0,"95",46,41,4,10,"low"
40,"SUPPRF61122",77,30,77,27,14,"48",63,50,4,10,"low"
41,"SUPPRF61122",80,32,80,-2,0,"87",80,82,4,10,"low"
42,"SUPPRF61122",81,25,67,0,-13,"59",80,67,4,10,"low"
43,"SUPPRF61122",80,32,75,27,29,"57",46,48,4,10,"low"
44,"SUPPRF61122",52,51,47,-5,-16,"71",63,52,4,10,"low"
45,"SUPPRF61122",57,46,71,4,0,"46",71,67,4,10,"low"
46,"SUPPRF61122",53,52,56,-15,-15,"66",71,71,4,10,"low"
47,"SUPPRF61122",40,54,28,-22,-1,"50",29,50,4,10,"low"
48,"SUPPRF61122",55,43,88,35,25,"80",63,53,4,10,"low"
1,"SUPPRF20210",85,74,62,-10,-1,"67",63,72,3,10,"low"
2,"SUPPRF20210",75,63,56,-19,-15,"72",71,75,3,10,"low"
3,"SUPPRF20210",62,68,88,27,25,"55",63,61,3,10,"low"
4,"SUPPRF20210",69,74,77,0,14,"73",63,77,3,10,"low"
5,"SUPPRF20210",65,71,8,-54,-12,"71",20,62,3,10,"low"
6,"SUPPRF20210",71,60,81,0,1,"73",80,81,3,10,"low"
7,"SUPPRF20210",80,50,54,-12,0,"80",54,66,3,10,"low"
8,"SUPPRF20210",55,63,16,-65,-13,"75",29,81,3,10,"low"
9,"SUPPRF20210",49,52,28,7,-1,"45",29,21,3,10,"low"
10,"SUPPRF20210",51,55,46,19,17,"54",29,27,3,10,"low"
11,"SUPPRF20210",52,70,50,-10,-13,"54",63,60,3,10,"low"
12,"SUPPRF20210",52,52,66,20,12,"57",54,46,3,10,"low"
13,"SUPPRF20210",57,41,19,-13,-1,"60",20,32,3,10,"low"
14,"SUPPRF20210",53,41,61,13,24,"54",37,48,3,10,"low"
15,"SUPPRF20210",71,36,100,20,20,"60",80,80,3,10,"low"
16,"SUPPRF20210",63,36,70,15,-1,"54",71,55,3,10,"low"
17,"SUPPRF20210",50,42,68,4,-12,"61",80,64,3,10,"low"
18,"SUPPRF20210",53,55,75,39,29,"57",46,36,3,10,"low"
19,"SUPPRF20210",48,52,38,-23,-16,"57",54,61,3,10,"low"
20,"SUPPRF20210",62,55,78,37,24,"51",54,41,3,10,"low"
21,"SUPPRF20210",69,75,80,0,0,"69",80,80,3,10,"low"
22,"SUPPRF20210",66,50,46,-7,0,"63",46,53,3,10,"low"
23,"SUPPRF20210",57,50,29,0,0,"54",29,29,3,10,"low"
24,"SUPPRF20210",62,49,94,21,23,"61",71,73,3,10,"low"
25,"SUPPRF20210",52,52,35,0,15,"57",20,35,3,10,"low"
26,"SUPPRF20210",44,46,34,-15,-12,"48",46,49,3,10,"low"
27,"SUPPRF20210",54,54,38,0,1,"34",37,38,3,10,"low"
28,"SUPPRF20210",67,67,20,-3,0,"39",20,23,3,10,"low"
29,"SUPPRF20210",52,51,24,-33,-13,"48",37,57,3,10,"low"
30,"SUPPRF20210",58,33,47,24,27,"44",20,23,3,10,"low"
31,"SUPPRF20210",55,50,58,20,29,"38",29,38,3,10,"low"
32,"SUPPRF20210",48,45,37,-6,0,"32",37,43,3,10,"low"
33,"SUPPRF20210",52,48,22,-18,-15,"28",37,40,3,10,"low"
34,"SUPPRF20210",53,60,67,-19,-13,"74",80,86,3,10,"low"
35,"SUPPRF20210",56,68,33,-9,-13,"66",46,42,3,10,"low"
36,"SUPPRF20210",63,16,47,-20,-16,"68",63,67,3,10,"low"
37,"SUPPRF20210",65,73,63,-18,0,"63",63,81,3,10,"low"
38,"SUPPRF20210",76,26,49,2,12,"52",37,47,3,10,"low"
39,"SUPPRF20210",62,20,58,-19,12,"63",46,77,3,10,"low"
40,"SUPPRF20210",29,26,83,6,12,"55",71,77,3,10,"low"
41,"SUPPRF20210",60,29,55,-5,1,"59",54,60,3,10,"low"
42,"SUPPRF20210",29,35,96,19,16,"63",80,77,3,10,"low"
43,"SUPPRF20210",47,38,45,1,-1,"44",46,44,3,10,"low"
44,"SUPPRF20210",51,25,71,3,0,"50",71,68,3,10,"low"
45,"SUPPRF20210",46,14,6,-19,-14,"63",20,25,3,10,"low"
46,"SUPPRF20210",38,56,15,-23,-14,"54",29,38,3,10,"low"
47,"SUPPRF20210",53,26,55,-15,-16,"69",71,70,3,10,"low"
48,"SUPPRF20210",63,46,41,-13,-13,"40",54,54,3,10,"low"
1,"SUPPRF37840",51,9,37,-3,0,"80",37,40,2,10,"low"
2,"SUPPRF37840",50,8,46,21,0,"40",46,25,2,10,"low"
3,"SUPPRF37840",51,8,54,-6,0,"80",54,60,2,10,"low"
4,"SUPPRF37840",61,5,100,20,20,"80",80,80,2,10,"low"
5,"SUPPRF37840",51,7,28,-2,-1,"80",29,30,2,10,"low"
6,"SUPPRF37840",50,7,33,-12,-13,"60",46,45,2,10,"low"
7,"SUPPRF37840",50,5,62,12,-1,"60",63,50,2,10,"low"
8,"SUPPRF37840",49,7,38,-12,1,"20",37,50,2,10,"low"
9,"SUPPRF37840",49,5,46,21,17,"75",29,25,2,10,"low"
10,"SUPPRF37840",51,6,58,28,29,"50",29,30,2,10,"low"
11,"SUPPRF37840",51,5,55,-23,-16,"80",71,78,2,10,"low"
12,"SUPPRF37840",50,6,66,16,12,"30",54,50,2,10,"low"
13,"SUPPRF37840",51,5,81,1,1,"85",80,80,2,10,"low"
14,"SUPPRF37840",50,5,67,-13,-13,"90",80,80,2,10,"low"
15,"SUPPRF37840",49,6,29,-1,0,"25",29,30,2,10,"low"
16,"SUPPRF37840",51,5,77,17,14,"45",63,60,2,10,"low"
17,"SUPPRF37840",51,6,55,0,1,"65",54,55,2,10,"low"
18,"SUPPRF37840",49,5,47,-13,-16,"40",63,60,2,10,"low"
19,"SUPPRF37840",52,6,41,-25,-13,"85",54,66,2,10,"low"
20,"SUPPRF37840",51,8,19,-1,-1,"75",20,20,2,10,"low"
21,"SUPPRF37840",52,5,94,24,23,"65",71,70,2,10,"low"
22,"SUPPRF37840",51,8,70,0,-1,"75",71,70,2,10,"low"
23,"SUPPRF37840",49,8,63,-2,0,"45",63,65,2,10,"low"
24,"SUPPRF37840",49,9,47,32,27,"30",20,15,2,10,"low"
25,"SUPPRF37840",49,10,50,-15,-13,"50",63,65,2,10,"low"
26,"SUPPRF37840",50,9,8,-12,-12,"25",20,20,2,10,"low"
27,"SUPPRF37840",49,11,80,0,0,"75",80,80,2,10,"low"
28,"SUPPRF37840",51,12,68,-12,-12,"90",80,80,2,10,"low"
29,"SUPPRF37840",49,11,20,0,0,"10",20,20,2,10,"low"
30,"SUPPRF37840",49,12,16,-24,-13,"10",29,40,2,10,"low"
31,"SUPPRF37840",49,9,22,-28,-15,"0",37,50,2,10,"low"
32,"SUPPRF37840",46,10,15,-10,-14,"10",29,25,2,10,"low"
33,"SUPPRF37840",49,13,58,8,12,"10",46,50,2,10,"low"
34,"SUPPRF37840",43,16,38,-32,-16,"80",54,70,2,10,"low"
35,"SUPPRF37840",39,17,35,15,15,"75",20,20,2,10,"low"
36,"SUPPRF37840",38,29,75,35,29,"40",46,40,2,10,"low"
37,"SUPPRF37840",38,23,96,21,16,"80",80,75,2,10,"low"
38,"SUPPRF37840",42,28,61,31,24,"70",37,30,2,10,"low"
39,"SUPPRF37840",38,32,71,-9,0,"80",71,80,2,10,"low"
40,"SUPPRF37840",37,37,24,-16,-13,"30",37,40,2,10,"low"
41,"SUPPRF37840",39,36,34,-16,-12,"80",46,50,2,10,"low"
42,"SUPPRF37840",38,40,49,19,12,"85",37,30,2,10,"low"
43,"SUPPRF37840",38,46,78,18,24,"75",54,60,2,10,"low"
44,"SUPPRF37840",40,45,88,38,25,"10",63,50,2,10,"low"
45,"SUPPRF37840",39,45,45,15,-1,"40",46,30,2,10,"low"
46,"SUPPRF37840",40,53,83,11,12,"80",71,72,2,10,"low"
47,"SUPPRF37840",33,49,6,-14,-14,"85",20,20,2,10,"low"
48,"SUPPRF37840",41,54,56,-24,-15,"90",71,80,2,10,"low"
1,"SUPPRF61000",34,40,22,-13,-15,"34",37,35,5,10,"low"
2,"SUPPRF61000",70,37,100,64,20,"30",80,36,5,10,"low"
3,"SUPPRF61000",54,35,66,31,12,"41",54,35,5,10,"low"
4,"SUPPRF61000",54,44,75,33,29,"54",46,42,5,10,"low"
5,"SUPPRF61000",46,56,50,-3,-13,"46",63,53,5,10,"low"
6,"SUPPRF61000",54,44,46,27,17,"28",29,19,5,10,"low"
7,"SUPPRF61000",51,44,58,25,12,"32",46,33,5,10,"low"
8,"SUPPRF61000",32,39,20,7,0,"20",20,13,5,10,"low"
9,"SUPPRF61000",49,53,38,4,1,"39",37,34,5,10,"low"
10,"SUPPRF61000",52,47,80,33,0,"60",80,47,5,10,"low"
11,"SUPPRF61000",45,42,24,-15,-13,"33",37,39,5,10,"low"
12,"SUPPRF61000",51,47,33,0,-13,"42",46,33,5,10,"low"
13,"SUPPRF61000",54,50,96,58,16,"16",80,38,5,10,"low"
14,"SUPPRF61000",44,46,37,5,0,"34",37,32,5,10,"low"
15,"SUPPRF61000",33,71,15,-9,-14,"44",29,24,5,10,"low"
16,"SUPPRF61000",29,49,29,3,0,"31",29,26,5,10,"low"
17,"SUPPRF61000",45,48,47,12,-16,"40",63,35,5,10,"low"
18,"SUPPRF61000",50,46,62,21,-1,"19",63,41,5,10,"low"
19,"SUPPRF61000",38,45,55,20,1,"33",54,35,5,10,"low"
20,"SUPPRF61000",17,62,83,57,12,"16",71,26,5,10,"low"
21,"SUPPRF61000",29,26,56,25,-15,"26",71,31,5,10,"low"
22,"SUPPRF61000",24,36,54,17,0,"43",54,37,5,10,"low"
23,"SUPPRF61000",29,65,28,11,-1,"44",29,17,5,10,"low"
24,"SUPPRF61000",32,60,35,22,15,"79",20,13,5,10,"low"
25,"SUPPRF61000",28,58,68,0,-12,"53",80,68,5,10,"low"
26,"SUPPRF61000",41,63,46,22,0,"33",46,24,5,10,"low"
27,"SUPPRF61000",56,53,61,40,24,"11",37,21,5,10,"low"
28,"SUPPRF61000",50,49,45,19,-1,"62",46,26,5,10,"low"
29,"SUPPRF61000",23,51,8,-1,-12,"60",20,9,5,10,"low"
30,"SUPPRF61000",48,47,67,30,-13,"31",80,37,5,10,"low"
31,"SUPPRF61000",47,53,55,14,-16,"42",71,41,5,10,"low"
32,"SUPPRF61000",64,46,71,35,0,"37",71,36,5,10,"low"
33,"SUPPRF61000",52,45,41,6,-13,"33",54,35,5,10,"low"
34,"SUPPRF61000",19,60,6,-9,-14,"30",20,15,5,10,"low"
35,"SUPPRF61000",29,57,49,29,12,"47",37,20,5,10,"low"
36,"SUPPRF61000",32,57,34,7,-12,"36",46,27,5,10,"low"
37,"SUPPRF61000",55,52,58,41,29,"16",29,17,5,10,"low"
38,"SUPPRF61000",33,55,38,8,-16,"29",54,30,5,10,"low"
39,"SUPPRF61000",26,51,81,45,1,"20",80,36,5,10,"low"
40,"SUPPRF61000",43,61,19,14,-1,"79",20,5,5,10,"low"
41,"SUPPRF61000",46,56,78,32,24,"65",54,46,5,10,"low"
42,"SUPPRF61000",52,61,63,17,0,"54",63,46,5,10,"low"
43,"SUPPRF61000",54,54,94,46,23,"38",71,48,5,10,"low"
44,"SUPPRF61000",52,54,77,44,14,"48",63,33,5,10,"low"
45,"SUPPRF61000",16,76,16,-16,-13,"74",29,32,5,10,"low"
46,"SUPPRF61000",58,60,88,58,25,"40",63,30,5,10,"low"
47,"SUPPRF61000",62,54,70,9,-1,"63",71,61,5,10,"low"
48,"SUPPRF61000",55,58,47,40,27,"87",20,7,5,10,"low"
1,"SUPPRF77020",21,51,15,-14,-14,"62",29,29,4,10,"low"
2,"SUPPRF77020",57,45,38,2,-16,"34",54,36,4,10,"low"
3,"SUPPRF77020",77,38,63,1,0,"58",63,62,4,10,"low"
4,"SUPPRF77020",43,42,47,-19,-16,"62",63,66,4,10,"low"
5,"SUPPRF77020",62,37,37,8,0,"65",37,29,4,10,"low"
6,"SUPPRF77020",48,30,62,20,-1,"31",63,42,4,10,"low"
7,"SUPPRF77020",53,40,67,0,-13,"71",80,67,4,10,"low"
8,"SUPPRF77020",97,21,19,-1,-1,"69",20,20,4,10,"low"
9,"SUPPRF77020",47,34,33,0,-13,"27",46,33,4,10,"low"
10,"SUPPRF77020",46,35,46,7,0,"32",46,39,4,10,"low"
11,"SUPPRF77020",45,19,38,13,1,"71",37,25,4,10,"low"
12,"SUPPRF77020",47,19,50,-24,-13,"67",63,74,4,10,"low"
13,"SUPPRF77020",34,26,58,34,29,"36",29,24,4,10,"low"
14,"SUPPRF77020",67,33,77,34,14,"10",63,43,4,10,"low"
15,"SUPPRF77020",52,22,96,15,16,"71",80,81,4,10,"low"
16,"SUPPRF77020",47,35,35,17,15,"58",20,18,4,10,"low"
17,"SUPPRF77020",66,30,70,-3,-1,"77",71,73,4,10,"low"
18,"SUPPRF77020",47,34,55,-2,1,"31",54,57,4,10,"low"
19,"SUPPRF77020",49,48,46,9,17,"9",29,37,4,10,"low"
20,"SUPPRF77020",66,35,68,-6,-12,"67",80,74,4,10,"low"
21,"SUPPRF77020",55,48,49,19,12,"61",37,30,4,10,"low"
22,"SUPPRF77020",46,40,45,5,-1,"23",46,40,4,10,"low"
23,"SUPPRF77020",38,39,24,-9,-13,"71",37,33,4,10,"low"
24,"SUPPRF77020",48,49,75,38,29,"63",46,37,4,10,"low"
25,"SUPPRF77020",45,39,28,-7,-1,"60",29,35,4,10,"low"
26,"SUPPRF77020",38,35,61,31,24,"29",37,30,4,10,"low"
27,"SUPPRF77020",44,42,94,35,23,"40",71,59,4,10,"low"
28,"SUPPRF77020",75,47,54,-4,0,"78",54,58,4,10,"low"
29,"SUPPRF77020",29,38,47,26,27,"78",20,21,4,10,"low"
30,"SUPPRF77020",53,35,41,-16,-13,"93",54,57,4,10,"low"
31,"SUPPRF77020",76,38,100,26,20,"81",80,74,4,10,"low"
32,"SUPPRF77020",33,44,56,-15,-15,"82",71,71,4,10,"low"
33,"SUPPRF77020",48,47,20,0,0,"85",20,20,4,10,"low"
34,"SUPPRF77020",56,35,66,8,12,"77",54,58,4,10,"low"
35,"SUPPRF77020",54,43,88,13,25,"67",63,75,4,10,"low"
36,"SUPPRF77020",77,31,71,-5,0,"70",71,76,4,10,"low"
37,"SUPPRF77020",50,35,80,-3,0,"83",80,83,4,10,"low"
38,"SUPPRF77020",46,50,16,-8,-13,"66",29,24,4,10,"low"
39,"SUPPRF77020",43,47,34,-40,-12,"72",46,74,4,10,"low"
40,"SUPPRF77020",52,44,78,16,24,"67",54,62,4,10,"low"
41,"SUPPRF77020",49,41,22,-8,-15,"12",37,30,4,10,"low"
42,"SUPPRF77020",44,39,58,0,12,"40",46,58,4,10,"low"
43,"SUPPRF77020",44,54,55,-20,-16,"64",71,75,4,10,"low"
44,"SUPPRF77020",49,49,81,6,1,"52",80,75,4,10,"low"
45,"SUPPRF77020",36,36,6,-27,-14,"27",20,33,4,10,"low"
46,"SUPPRF77020",53,67,83,9,12,"69",71,74,4,10,"low"
47,"SUPPRF77020",39,55,29,-29,0,"5",29,58,4,10,"low"
48,"SUPPRF77020",42,65,8,-64,-12,"26",20,72,4,10,"low"
1,"SUPPRF13951",54,13,94,24,23,"88",71,70,9,10,"high"
2,"SUPPRF13951",58,11,96,21,16,"78",80,75,9,10,"high"
3,"SUPPRF13951",55,5,62,2,-1,"80",63,60,9,10,"high"
4,"SUPPRF13951",58,5,58,10,12,"83",46,48,9,10,"high"
5,"SUPPRF13951",57,2,75,22,29,"83",46,53,9,10,"high"
6,"SUPPRF13951",59,0,47,22,27,"91",20,25,9,10,"high"
7,"SUPPRF13951",57,0,70,20,-1,"15",71,50,9,10,"high"
8,"SUPPRF13951",59,0,29,-6,0,"75",29,35,9,10,"high"
9,"SUPPRF13951",55,0,68,-12,-12,"80",80,80,9,10,"high"
10,"SUPPRF13951",55,0,16,-19,-13,"58",29,35,9,10,"high"
11,"SUPPRF13951",50,0,50,-28,-13,"64",63,78,9,10,"high"
12,"SUPPRF13951",51,0,38,-18,-16,"74",54,56,9,10,"high"
13,"SUPPRF13951",50,0,35,12,15,"62",20,23,9,10,"high"
14,"SUPPRF13951",50,0,34,-25,-12,"29",46,59,9,10,"high"
15,"SUPPRF13951",50,0,19,-9,-1,"41",20,28,9,10,"high"
16,"SUPPRF13951",50,0,6,-19,-14,"30",20,25,9,10,"high"
17,"SUPPRF13951",50,0,71,3,0,"7",71,68,9,10,"high"
18,"SUPPRF13951",51,0,67,-12,-13,"21",80,79,9,10,"high"
19,"SUPPRF13951",50,0,38,-14,1,"15",37,52,9,10,"high"
20,"SUPPRF13951",49,0,46,-5,0,"19",46,51,9,10,"high"
21,"SUPPRF13951",48,0,49,6,12,"15",37,43,9,10,"high"
22,"SUPPRF13951",47,0,58,31,29,"7",29,27,9,10,"high"
23,"SUPPRF13951",48,0,54,-2,0,"28",54,56,9,10,"high"
24,"SUPPRF13951",45,0,56,-14,-15,"23",71,70,9,10,"high"
25,"SUPPRF13951",48,0,28,2,-1,"20",29,26,9,10,"high"
26,"SUPPRF13951",48,0,100,75,20,"26",80,25,9,10,"high"
27,"SUPPRF13951",46,0,33,-11,-13,"17",46,44,9,10,"high"
28,"SUPPRF13951",46,0,47,-7,-16,"22",63,54,9,10,"high"
29,"SUPPRF13951",46,0,63,8,0,"19",63,55,9,10,"high"
30,"SUPPRF13951",45,0,22,-37,-15,"23",37,59,9,10,"high"
31,"SUPPRF13951",45,0,78,46,24,"21",54,32,9,10,"high"
32,"SUPPRF13951",43,0,45,-1,-1,"25",46,46,9,10,"high"
33,"SUPPRF13951",43,0,46,17,17,"29",29,29,9,10,"high"
34,"SUPPRF13951",44,0,15,-15,-14,"22",29,30,9,10,"high"
35,"SUPPRF13951",42,0,77,10,14,"6",63,67,9,10,"high"
36,"SUPPRF13951",44,0,61,19,24,"3",37,42,9,10,"high"
37,"SUPPRF13951",41,0,80,-2,0,"9",80,82,9,10,"high"
38,"SUPPRF13951",43,0,20,-5,0,"16",20,25,9,10,"high"
39,"SUPPRF13951",42,0,81,1,1,"21",80,80,9,10,"high"
40,"SUPPRF13951",38,0,37,-26,0,"8",37,63,9,10,"high"
41,"SUPPRF13951",42,0,41,-23,-13,"14",54,64,9,10,"high"
42,"SUPPRF13951",43,0,83,19,12,"16",71,64,9,10,"high"
43,"SUPPRF13951",42,0,88,18,25,"4",63,70,9,10,"high"
44,"SUPPRF13951",42,0,24,-32,-13,"16",37,56,9,10,"high"
45,"SUPPRF13951",40,0,66,8,12,"13",54,58,9,10,"high"
46,"SUPPRF13951",42,0,55,-5,1,"14",54,60,9,10,"high"
47,"SUPPRF13951",40,0,8,-19,-12,"15",20,27,9,10,"high"
48,"SUPPRF13951",37,0,55,-13,-16,"17",71,68,9,10,"high"
1,"SUPPRF79160",67,50,61,20,24,"70",37,41,8,10,"high"
2,"SUPPRF79160",61,34,55,0,1,"71",54,55,8,10,"high"
3,"SUPPRF79160",71,28,46,-1,0,"75",46,47,8,10,"high"
4,"SUPPRF79160",68,21,58,8,12,"65",46,50,8,10,"high"
5,"SUPPRF79160",26,8,15,-7,-14,"75",29,22,8,10,"high"
6,"SUPPRF79160",52,36,67,-8,-13,"60",80,75,8,10,"high"
7,"SUPPRF79160",50,59,54,14,0,"55",54,40,8,10,"high"
8,"SUPPRF79160",24,71,24,-16,-13,"50",37,40,8,10,"high"
9,"SUPPRF79160",39,64,37,10,0,"60",37,27,8,10,"high"
10,"SUPPRF79160",80,40,81,1,1,"61",80,80,8,10,"high"
11,"SUPPRF79160",30,67,29,5,0,"70",29,24,8,10,"high"
12,"SUPPRF79160",50,62,20,3,0,"70",20,17,8,10,"high"
13,"SUPPRF79160",52,49,28,6,-1,"69",29,22,8,10,"high"
14,"SUPPRF79160",51,50,38,-2,1,"48",37,40,8,10,"high"
15,"SUPPRF79160",68,31,78,34,24,"38",54,44,8,10,"high"
16,"SUPPRF79160",50,50,49,9,12,"60",37,40,8,10,"high"
17,"SUPPRF79160",0,69,6,-17,-14,"70",20,23,8,10,"high"
18,"SUPPRF79160",99,25,96,20,16,"82",80,76,8,10,"high"
19,"SUPPRF79160",52,49,62,-3,-1,"74",63,65,8,10,"high"
20,"SUPPRF79160",48,59,45,5,-1,"71",46,40,8,10,"high"
21,"SUPPRF79160",66,48,77,22,14,"41",63,55,8,10,"high"
22,"SUPPRF79160",51,50,66,6,12,"50",54,60,8,10,"high"
23,"SUPPRF79160",38,65,56,-14,-15,"60",71,70,8,10,"high"
24,"SUPPRF79160",51,73,35,20,15,"50",20,15,8,10,"high"
25,"SUPPRF79160",59,57,70,3,-1,"50",71,67,8,10,"high"
26,"SUPPRF79160",71,50,83,23,12,"38",71,60,8,10,"high"
27,"SUPPRF79160",14,74,8,-12,-12,"40",20,20,8,10,"high"
28,"SUPPRF79160",47,74,16,-9,-13,"70",29,25,8,10,"high"
29,"SUPPRF79160",66,72,58,37,29,"37",29,21,8,10,"high"
30,"SUPPRF79160",51,58,50,-18,-13,"71",63,68,8,10,"high"
31,"SUPPRF79160",67,34,47,30,27,"60",20,17,8,10,"high"
32,"SUPPRF79160",65,49,46,21,17,"50",29,25,8,10,"high"
33,"SUPPRF79160",26,63,38,-24,-16,"52",54,62,8,10,"high"
34,"SUPPRF79160",73,23,75,29,29,"65",46,46,8,10,"high"
35,"SUPPRF79160",52,63,63,8,0,"30",63,55,8,10,"high"
36,"SUPPRF79160",9,76,22,-22,-15,"70",37,44,8,10,"high"
37,"SUPPRF79160",33,78,19,3,-1,"78",20,16,8,10,"high"
38,"SUPPRF79160",54,34,71,-5,0,"70",71,76,8,10,"high"
39,"SUPPRF79160",50,60,41,-16,-13,"66",54,57,8,10,"high"
40,"SUPPRF79160",31,50,33,-17,-13,"31",46,50,8,10,"high"
41,"SUPPRF79160",100,18,100,26,20,"81",80,74,8,10,"high"
42,"SUPPRF79160",78,35,88,28,25,"50",63,60,8,10,"high"
43,"SUPPRF79160",100,11,94,11,23,"71",71,83,8,10,"high"
44,"SUPPRF79160",48,65,47,-13,-16,"28",63,60,8,10,"high"
45,"SUPPRF79160",26,59,68,-16,-12,"80",80,84,8,10,"high"
46,"SUPPRF79160",72,51,80,3,0,"41",80,77,8,10,"high"
47,"SUPPRF79160",34,65,34,-18,-12,"26",46,52,8,10,"high"
48,"SUPPRF79160",13,78,55,-23,-16,"59",71,78,8,10,"high"
1,"SUPPRF57557",74,27,81,2,1,"72",80,79,8,10,"high"
2,"SUPPRF57557",72,25,38,2,1,"33",37,36,8,10,"high"
3,"SUPPRF57557",76,28,8,-20,-12,"35",20,28,8,10,"high"
4,"SUPPRF57557",40,22,67,-15,-13,"75",80,82,8,10,"high"
5,"SUPPRF57557",51,21,47,22,27,"45",20,25,8,10,"high"
6,"SUPPRF57557",69,23,83,41,12,"23",71,42,8,10,"high"
7,"SUPPRF57557",77,24,68,-6,-12,"69",80,74,8,10,"high"
8,"SUPPRF57557",43,20,100,29,20,"57",80,71,8,10,"high"
9,"SUPPRF57557",68,20,61,-8,24,"62",37,69,8,10,"high"
10,"SUPPRF57557",58,20,6,-63,-14,"29",20,69,8,10,"high"
11,"SUPPRF57557",64,27,75,36,29,"32",46,39,8,10,"high"
12,"SUPPRF57557",84,25,50,-19,-13,"67",63,69,8,10,"high"
13,"SUPPRF57557",69,30,45,-19,-1,"24",46,64,8,10,"high"
14,"SUPPRF57557",71,26,70,6,-1,"26",71,64,8,10,"high"
15,"SUPPRF57557",66,31,55,-10,1,"52",54,65,8,10,"high"
16,"SUPPRF57557",58,31,33,-12,-13,"60",46,45,8,10,"high"
17,"SUPPRF57557",57,23,58,33,29,"72",29,25,8,10,"high"
18,"SUPPRF57557",58,25,41,-17,-13,"34",54,58,8,10,"high"
19,"SUPPRF57557",67,33,29,-10,0,"30",29,39,8,10,"high"
20,"SUPPRF57557",69,24,88,36,25,"65",63,52,8,10,"high"
21,"SUPPRF57557",69,24,66,1,12,"48",54,65,8,10,"high"
22,"SUPPRF57557",72,22,28,0,-1,"62",29,28,8,10,"high"
23,"SUPPRF57557",64,25,54,0,0,"69",54,54,8,10,"high"
24,"SUPPRF57557",70,35,38,-5,-16,"52",54,43,8,10,"high"
25,"SUPPRF57557",63,27,47,5,-16,"61",63,42,8,10,"high"
26,"SUPPRF57557",80,37,71,-2,0,"46",71,73,8,10,"high"
27,"SUPPRF57557",46,22,16,-47,-13,"42",29,63,8,10,"high"
28,"SUPPRF57557",65,27,24,-15,-13,"47",37,39,8,10,"high"
29,"SUPPRF57557",77,17,55,1,-16,"61",71,54,8,10,"high"
30,"SUPPRF57557",67,25,62,-11,-1,"64",63,73,8,10,"high"
31,"SUPPRF57557",69,15,94,36,23,"68",71,58,8,10,"high"
32,"SUPPRF57557",72,26,20,-17,0,"50",20,37,8,10,"high"
33,"SUPPRF57557",52,23,15,-18,-14,"64",29,33,8,10,"high"
34,"SUPPRF57557",44,29,19,-16,-1,"41",20,35,8,10,"high"
35,"SUPPRF57557",60,22,37,4,0,"61",37,33,8,10,"high"
36,"SUPPRF57557",77,35,77,7,14,"71",63,70,8,10,"high"
37,"SUPPRF57557",70,27,80,0,0,"73",80,80,8,10,"high"
38,"SUPPRF57557",71,24,63,0,0,"66",63,63,8,10,"high"
39,"SUPPRF57557",65,37,22,-12,-15,"55",37,34,8,10,"high"
40,"SUPPRF57557",57,23,35,-5,15,"32",20,40,8,10,"high"
41,"SUPPRF57557",66,25,34,-3,-12,"68",46,37,8,10,"high"
42,"SUPPRF57557",74,34,78,35,24,"35",54,43,8,10,"high"
43,"SUPPRF57557",73,31,96,40,16,"38",80,56,8,10,"high"
44,"SUPPRF57557",58,4,58,2,12,"39",46,56,8,10,"high"
45,"SUPPRF57557",69,27,56,21,-15,"26",71,35,8,10,"high"
46,"SUPPRF57557",66,11,49,6,12,"72",37,43,8,10,"high"
47,"SUPPRF57557",68,23,46,5,17,"57",29,41,8,10,"high"
48,"SUPPRF57557",78,27,46,-7,0,"62",46,53,8,10,"high"
1,"SUPPRF12856",49,54,46,6,17,"60",29,40,1,10,"low"
2,"SUPPRF12856",52,47,54,6,0,"43",54,48,1,10,"low"
3,"SUPPRF12856",39,62,38,-14,-16,"68",54,52,1,10,"low"
4,"SUPPRF12856",51,55,71,11,0,"55",71,60,1,10,"low"
5,"SUPPRF12856",37,65,55,-15,1,"32",54,70,1,10,"low"
6,"SUPPRF12856",40,63,68,-12,-12,"32",80,80,1,10,"low"
7,"SUPPRF12856",19,72,6,-24,-14,"62",20,30,1,10,"low"
8,"SUPPRF12856",42,73,56,-19,-15,"68",71,75,1,10,"low"
9,"SUPPRF12856",41,63,63,-12,0,"39",63,75,1,10,"low"
10,"SUPPRF12856",39,48,80,15,0,"35",80,65,1,10,"low"
11,"SUPPRF12856",40,43,45,-11,-1,"49",46,56,1,10,"low"
12,"SUPPRF12856",43,48,58,8,12,"37",46,50,1,10,"low"
13,"SUPPRF12856",37,59,38,5,1,"31",37,33,1,10,"low"
14,"SUPPRF12856",38,54,61,35,24,"38",37,26,1,10,"low"
15,"SUPPRF12856",47,51,81,14,1,"60",80,67,1,10,"low"
16,"SUPPRF12856",43,66,34,13,-12,"16",46,21,1,10,"low"
17,"SUPPRF12856",45,55,41,-12,-13,"52",54,53,1,10,"low"
18,"SUPPRF12856",56,43,88,28,25,"60",63,60,1,10,"low"
19,"SUPPRF12856",37,59,8,-2,-12,"75",20,10,1,10,"low"
20,"SUPPRF12856",46,51,47,-16,-16,"33",63,63,1,10,"low"
21,"SUPPRF12856",50,39,46,-10,0,"52",46,56,1,10,"low"
22,"SUPPRF12856",43,56,28,-22,-1,"62",29,50,1,10,"low"
23,"SUPPRF12856",53,59,62,17,-1,"54",63,45,1,10,"low"
24,"SUPPRF12856",39,43,33,-27,-13,"44",46,60,1,10,"low"
25,"SUPPRF12856",34,37,37,-5,0,"22",37,42,1,10,"low"
26,"SUPPRF12856",38,59,55,-15,-16,"65",71,70,1,10,"low"
27,"SUPPRF12856",42,57,49,10,12,"27",37,39,1,10,"low"
28,"SUPPRF12856",55,49,100,40,20,"60",80,60,1,10,"low"
29,"SUPPRF12856",48,64,67,-18,-13,"74",80,85,1,10,"low"
30,"SUPPRF12856",38,54,50,0,-13,"39",63,50,1,10,"low"
31,"SUPPRF12856",57,51,94,26,23,"65",71,68,1,10,"low"
32,"SUPPRF12856",56,50,77,37,14,"28",63,40,1,10,"low"
33,"SUPPRF12856",41,41,29,-6,0,"67",29,35,1,10,"low"
34,"SUPPRF12856",41,42,70,10,-1,"46",71,60,1,10,"low"
35,"SUPPRF12856",40,44,78,28,24,"28",54,50,1,10,"low"
36,"SUPPRF12856",39,47,66,6,12,"62",54,60,1,10,"low"
37,"SUPPRF12856",33,41,35,19,15,"71",20,16,1,10,"low"
38,"SUPPRF12856",45,39,75,21,29,"39",46,54,1,10,"low"
39,"SUPPRF12856",58,47,96,16,16,"79",80,80,1,10,"low"
40,"SUPPRF12856",38,52,19,4,-1,"69",20,15,1,10,"low"
41,"SUPPRF12856",36,40,15,-5,-14,"72",29,20,1,10,"low"
42,"SUPPRF12856",42,41,47,36,27,"75",20,11,1,10,"low"
43,"SUPPRF12856",33,61,24,-33,-13,"17",37,57,1,10,"low"
44,"SUPPRF12856",42,61,58,26,29,"56",29,32,1,10,"low"
45,"SUPPRF12856",54,59,83,1,12,"65",71,82,1,10,"low"
46,"SUPPRF12856",43,60,16,-14,-13,"39",29,30,1,10,"low"
47,"SUPPRF12856",39,66,22,-48,-15,"40",37,70,1,10,"low"
48,"SUPPRF12856",41,51,20,13,0,"73",20,7,1,10,"low"
1,"SUPPRF26467",93,9,28,-19,-1,"78",29,47,3,10,"low"
2,"SUPPRF26467",49,0,47,13,27,"60",20,34,3,10,"low"
3,"SUPPRF26467",100,9,35,-26,15,"40",20,61,3,10,"low"
4,"SUPPRF26467",93,0,94,6,23,"88",71,88,3,10,"low"
5,"SUPPRF26467",79,0,38,-8,-16,"4",54,46,3,10,"low"
6,"SUPPRF26467",50,0,29,-28,0,"37",29,57,3,10,"low"
7,"SUPPRF26467",75,7,49,-20,12,"51",37,69,3,10,"low"
8,"SUPPRF26467",75,0,75,2,29,"52",46,73,3,10,"low"
9,"SUPPRF26467",68,0,37,-19,0,"28",37,56,3,10,"low"
10,"SUPPRF26467",65,4,58,-15,29,"68",29,73,3,10,"low"
11,"SUPPRF26467",86,14,16,-53,-13,"46",29,69,3,10,"low"
12,"SUPPRF26467",90,6,19,-32,-1,"63",20,51,3,10,"low"
13,"SUPPRF26467",81,5,55,-9,-16,"48",71,64,3,10,"low"
14,"SUPPRF26467",89,0,88,14,25,"15",63,74,3,10,"low"
15,"SUPPRF26467",92,0,83,10,12,"7",71,73,3,10,"low"
16,"SUPPRF26467",95,3,15,-34,-14,"10",29,49,3,10,"low"
17,"SUPPRF26467",75,10,46,-12,17,"36",29,58,3,10,"low"
18,"SUPPRF26467",94,11,66,0,12,"27",54,66,3,10,"low"
19,"SUPPRF26467",67,26,45,-20,-1,"12",46,65,3,10,"low"
20,"SUPPRF26467",87,15,54,-4,0,"26",54,58,3,10,"low"
21,"SUPPRF26467",77,12,55,0,1,"14",54,55,3,10,"low"
22,"SUPPRF26467",29,47,62,2,-1,"17",63,60,3,10,"low"
23,"SUPPRF26467",71,15,80,18,0,"44",80,62,3,10,"low"
24,"SUPPRF26467",15,69,50,-17,-13,"21",63,67,3,10,"low"
25,"SUPPRF26467",21,78,78,11,24,"35",54,67,3,10,"low"
26,"SUPPRF26467",51,53,81,5,1,"32",80,76,3,10,"low"
27,"SUPPRF26467",86,1,6,-48,-14,"17",20,54,3,10,"low"
28,"SUPPRF26467",74,20,61,12,24,"15",37,49,3,10,"low"
29,"SUPPRF26467",76,13,33,31,-13,"36",46,2,3,10,"low"
30,"SUPPRF26467",64,20,38,-15,1,"24",37,53,3,10,"low"
31,"SUPPRF26467",41,36,47,4,-16,"44",63,43,3,10,"low"
32,"SUPPRF26467",48,44,46,-10,0,"24",46,56,3,10,"low"
33,"SUPPRF26467",5,70,8,-45,-12,"36",20,53,3,10,"low"
34,"SUPPRF26467",49,47,58,-3,12,"41",46,61,3,10,"low"
35,"SUPPRF26467",50,23,63,15,0,"11",63,48,3,10,"low"
36,"SUPPRF26467",51,23,22,-31,-15,"40",37,53,3,10,"low"
37,"SUPPRF26467",97,3,100,3,20,"21",80,97,3,10,"low"
38,"SUPPRF26467",87,15,20,-27,0,"8",20,47,3,10,"low"
39,"SUPPRF26467",72,19,24,-34,-13,"35",37,58,3,10,"low"
40,"SUPPRF26467",70,16,67,-8,-13,"23",80,75,3,10,"low"
41,"SUPPRF26467",85,10,96,3,16,"4",80,93,3,10,"low"
42,"SUPPRF26467",45,31,34,-35,-12,"28",46,69,3,10,"low"
43,"SUPPRF26467",70,5,70,17,-1,"22",71,53,3,10,"low"
44,"SUPPRF26467",46,51,56,-3,-15,"38",71,59,3,10,"low"
45,"SUPPRF26467",55,39,71,21,0,"47",71,50,3,10,"low"
46,"SUPPRF26467",43,51,68,16,-12,"23",80,52,3,10,"low"
47,"SUPPRF26467",67,33,41,-8,-13,"29",54,49,3,10,"low"
48,"SUPPRF26467",52,37,77,14,14,"40",63,63,3,10,"low"
1,"SUPPRF12547",68,67,81,6,1,"80",80,75,4,10,"low"
2,"SUPPRF12547",66,53,6,-19,-14,"88",20,25,4,10,"low"
3,"SUPPRF12547",65,51,77,17,14,"62",63,60,4,10,"low"
4,"SUPPRF12547",68,52,67,-10,-13,"60",80,77,4,10,"low"
5,"SUPPRF12547",51,37,8,-7,-12,"22",20,15,4,10,"low"
6,"SUPPRF12547",53,36,83,13,12,"30",71,70,4,10,"low"
7,"SUPPRF12547",51,24,46,11,17,"35",29,35,4,10,"low"
8,"SUPPRF12547",62,12,88,23,25,"60",63,65,4,10,"low"
9,"SUPPRF12547",68,13,94,24,23,"73",71,70,4,10,"low"
10,"SUPPRF12547",60,1,33,-17,-13,"50",46,50,4,10,"low"
11,"SUPPRF12547",52,3,37,-3,0,"31",37,40,4,10,"low"
12,"SUPPRF12547",62,7,50,-25,-13,"69",63,75,4,10,"low"
13,"SUPPRF12547",69,1,100,20,20,"75",80,80,4,10,"low"
14,"SUPPRF12547",63,0,24,4,-13,"66",37,20,4,10,"low"
15,"SUPPRF12547",67,0,45,21,-1,"80",46,24,4,10,"low"
16,"SUPPRF12547",66,3,41,-9,-13,"80",54,50,4,10,"low"
17,"SUPPRF12547",59,0,47,-20,-16,"68",63,67,4,10,"low"
18,"SUPPRF12547",54,0,46,3,0,"66",46,43,4,10,"low"
19,"SUPPRF12547",53,0,22,-5,-15,"74",37,27,4,10,"low"
20,"SUPPRF12547",68,0,78,21,24,"65",54,57,4,10,"low"
21,"SUPPRF12547",55,0,29,-8,0,"70",29,37,4,10,"low"
22,"SUPPRF12547",52,0,49,34,12,"73",37,15,4,10,"low"
23,"SUPPRF12547",51,0,62,-3,-1,"61",63,65,4,10,"low"
24,"SUPPRF12547",50,1,55,-10,-16,"56",71,65,4,10,"low"
25,"SUPPRF12547",49,0,54,-16,0,"70",54,70,4,10,"low"
26,"SUPPRF12547",53,0,61,36,24,"75",37,25,4,10,"low"
27,"SUPPRF12547",58,0,58,3,12,"69",46,55,4,10,"low"
28,"SUPPRF12547",50,0,20,12,0,"86",20,8,4,10,"low"
29,"SUPPRF12547",52,0,28,-2,-1,"70",29,30,4,10,"low"
30,"SUPPRF12547",51,1,56,-19,-15,"80",71,75,4,10,"low"
31,"SUPPRF12547",51,1,75,47,29,"27",46,28,4,10,"low"
32,"SUPPRF12547",52,1,63,-2,0,"78",63,65,4,10,"low"
33,"SUPPRF12547",45,0,70,16,-1,"87",71,54,4,10,"low"
34,"SUPPRF12547",48,0,16,-20,-13,"60",29,36,4,10,"low"
35,"SUPPRF12547",56,1,71,1,0,"98",71,70,4,10,"low"
36,"SUPPRF12547",48,0,34,-3,-12,"25",46,37,4,10,"low"
37,"SUPPRF12547",50,0,55,0,1,"51",54,55,4,10,"low"
38,"SUPPRF12547",45,0,19,-1,-1,"61",20,20,4,10,"low"
39,"SUPPRF12547",40,1,68,3,-12,"51",80,65,4,10,"low"
40,"SUPPRF12547",47,0,38,2,1,"75",37,36,4,10,"low"
41,"SUPPRF12547",51,1,58,31,29,"77",29,27,4,10,"low"
42,"SUPPRF12547",53,1,80,10,0,"72",80,70,4,10,"low"
43,"SUPPRF12547",51,1,96,16,16,"79",80,80,4,10,"low"
44,"SUPPRF12547",52,1,66,10,12,"71",54,56,4,10,"low"
45,"SUPPRF12547",50,0,35,15,15,"80",20,20,4,10,"low"
46,"SUPPRF12547",46,3,15,-35,-14,"50",29,50,4,10,"low"
47,"SUPPRF12547",49,6,38,-22,-16,"76",54,60,4,10,"low"
48,"SUPPRF12547",50,10,47,32,27,"82",20,15,4,10,"low"
1,"SUPPRF33361",53,32,15,-10,-14,"43",29,25,4,10,"low"
2,"SUPPRF33361",50,27,20,2,0,"16",20,18,4,10,"low"
3,"SUPPRF33361",57,9,28,6,-1,"17",29,22,4,10,"low"
4,"SUPPRF33361",57,27,8,-34,-12,"18",20,42,4,10,"low"
5,"SUPPRF33361",61,28,50,14,-13,"24",63,36,4,10,"low"
6,"SUPPRF33361",57,31,49,16,12,"17",37,33,4,10,"low"
7,"SUPPRF33361",64,30,46,-22,0,"20",46,68,4,10,"low"
8,"SUPPRF33361",64,23,24,-9,-13,"28",37,33,4,10,"low"
9,"SUPPRF33361",60,29,35,26,15,"67",20,9,4,10,"low"
10,"SUPPRF33361",74,28,94,63,23,"15",71,31,4,10,"low"
11,"SUPPRF33361",65,33,70,14,-1,"15",71,56,4,10,"low"
12,"SUPPRF33361",58,36,47,22,27,"25",20,25,4,10,"low"
13,"SUPPRF33361",54,38,47,-10,-16,"53",63,57,4,10,"low"
14,"SUPPRF33361",47,57,81,20,1,"53",80,61,4,10,"low"
15,"SUPPRF33361",39,56,55,-3,-16,"5",71,58,4,10,"low"
16,"SUPPRF33361",67,79,38,2,1,"84",37,36,4,10,"low"
17,"SUPPRF33361",34,66,56,-19,-15,"67",71,75,4,10,"low"
18,"SUPPRF33361",42,60,78,11,24,"69",54,67,4,10,"low"
19,"SUPPRF33361",39,63,46,3,17,"51",29,43,4,10,"low"
20,"SUPPRF33361",33,63,45,-10,-1,"49",46,55,4,10,"low"
21,"SUPPRF33361",27,71,33,-21,-13,"17",46,54,4,10,"low"
22,"SUPPRF33361",32,63,77,7,14,"52",63,70,4,10,"low"
23,"SUPPRF33361",37,59,67,-11,-13,"18",80,78,4,10,"low"
24,"SUPPRF33361",34,64,34,-8,-12,"28",46,42,4,10,"low"
25,"SUPPRF33361",51,47,63,0,0,"29",63,63,4,10,"low"
26,"SUPPRF33361",47,48,83,15,12,"71",71,68,4,10,"low"
27,"SUPPRF33361",37,62,55,-14,1,"51",54,69,4,10,"low"
28,"SUPPRF33361",43,66,41,-9,-13,"3",54,50,4,10,"low"
29,"SUPPRF33361",52,50,16,-14,-13,"52",29,30,4,10,"low"
30,"SUPPRF33361",32,59,75,24,29,"55",46,51,4,10,"low"
31,"SUPPRF33361",38,55,66,17,12,"24",54,49,4,10,"low"
32,"SUPPRF33361",5,68,37,-26,0,"53",37,63,4,10,"low"
33,"SUPPRF33361",22,71,96,24,16,"14",80,72,4,10,"low"
34,"SUPPRF33361",0,64,38,-31,-16,"45",54,69,4,10,"low"
35,"SUPPRF33361",2,61,58,-3,29,"34",29,61,4,10,"low"
36,"SUPPRF33361",1,62,29,-4,0,"35",29,33,4,10,"low"
37,"SUPPRF33361",7,79,88,40,25,"16",63,48,4,10,"low"
38,"SUPPRF33361",1,98,71,6,0,"71",71,65,4,10,"low"
39,"SUPPRF33361",6,95,19,-38,-1,"32",20,57,4,10,"low"
40,"SUPPRF33361",41,78,54,-4,0,"26",54,58,4,10,"low"
41,"SUPPRF33361",5,86,100,13,20,"77",80,87,4,10,"low"
42,"SUPPRF33361",0,98,58,17,12,"13",46,41,4,10,"low"
43,"SUPPRF33361",2,80,62,3,-1,"19",63,59,4,10,"low"
44,"SUPPRF33361",1,84,80,34,0,"12",80,46,4,10,"low"
45,"SUPPRF33361",3,88,22,-39,-15,"33",37,61,4,10,"low"
46,"SUPPRF33361",1,98,68,-18,-12,"16",80,86,4,10,"low"
47,"SUPPRF33361",6,65,61,-8,24,"34",37,69,4,10,"low"
48,"SUPPRF33361",15,75,6,-68,-14,"38",20,74,4,10,"low"
1,"SUPPRF71005",50,65,55,15,1,"80",54,40,2,10,"low"
2,"SUPPRF71005",52,50,38,18,1,"80",37,20,2,10,"low"
3,"SUPPRF71005",50,50,35,20,15,"81",20,15,2,10,"low"
4,"SUPPRF71005",60,42,29,-2,0,"68",29,31,2,10,"low"
5,"SUPPRF71005",53,45,62,7,-1,"70",63,55,2,10,"low"
6,"SUPPRF71005",55,42,80,10,0,"73",80,70,2,10,"low"
7,"SUPPRF71005",63,37,88,18,25,"75",63,70,2,10,"low"
8,"SUPPRF71005",39,48,28,-26,-1,"63",29,54,2,10,"low"
9,"SUPPRF71005",57,50,56,-9,-15,"54",71,65,2,10,"low"
10,"SUPPRF71005",59,48,77,8,14,"64",63,69,2,10,"low"
11,"SUPPRF71005",58,50,46,-22,0,"70",46,68,2,10,"low"
12,"SUPPRF71005",56,50,55,11,-16,"44",71,44,2,10,"low"
13,"SUPPRF71005",54,44,70,18,-1,"60",71,52,2,10,"low"
14,"SUPPRF71005",56,41,47,25,27,"74",20,22,2,10,"low"
15,"SUPPRF71005",61,45,34,-16,-12,"40",46,50,2,10,"low"
16,"SUPPRF71005",51,50,33,-2,-13,"40",46,35,2,10,"low"
17,"SUPPRF71005",50,50,46,10,17,"43",29,36,2,10,"low"
18,"SUPPRF71005",34,56,15,-46,-14,"35",29,61,2,10,"low"
19,"SUPPRF71005",31,62,6,-14,-14,"69",20,20,2,10,"low"
20,"SUPPRF71005",51,49,20,12,0,"58",20,8,2,10,"low"
21,"SUPPRF71005",53,51,66,28,12,"33",54,38,2,10,"low"
22,"SUPPRF71005",57,58,58,27,12,"61",46,31,2,10,"low"
23,"SUPPRF71005",50,51,19,-1,-1,"41",20,20,2,10,"low"
24,"SUPPRF71005",53,49,37,7,0,"51",37,30,2,10,"low"
25,"SUPPRF71005",25,42,8,-6,-12,"67",20,14,2,10,"low"
26,"SUPPRF71005",56,45,58,30,29,"55",29,28,2,10,"low"
27,"SUPPRF71005",60,44,96,66,16,"54",80,30,2,10,"low"
28,"SUPPRF71005",56,48,16,11,-13,"31",29,5,2,10,"low"
29,"SUPPRF71005",39,58,47,22,-16,"55",63,25,2,10,"low"
30,"SUPPRF71005",50,40,68,53,-12,"38",80,15,2,10,"low"
31,"SUPPRF71005",44,44,38,5,-16,"52",54,33,2,10,"low"
32,"SUPPRF71005",78,42,100,24,20,"72",80,76,2,10,"low"
33,"SUPPRF71005",56,43,75,42,29,"45",46,33,2,10,"low"
34,"SUPPRF71005",61,44,67,-15,-13,"76",80,82,2,10,"low"
35,"SUPPRF71005",60,50,50,-14,-13,"71",63,64,2,10,"low"
36,"SUPPRF71005",59,45,71,35,0,"46",71,36,2,10,"low"
37,"SUPPRF71005",46,55,24,-23,-13,"45",37,47,2,10,"low"
38,"SUPPRF71005",52,41,22,16,-15,"34",37,6,2,10,"low"
39,"SUPPRF71005",51,52,49,-25,12,"65",37,74,2,10,"low"
40,"SUPPRF71005",49,57,54,15,0,"53",54,39,2,10,"low"
41,"SUPPRF71005",52,50,45,29,-1,"31",46,16,2,10,"low"
42,"SUPPRF71005",50,50,61,20,24,"42",37,41,2,10,"low"
43,"SUPPRF71005",51,51,78,25,24,"52",54,53,2,10,"low"
44,"SUPPRF71005",49,48,94,76,23,"51",71,18,2,10,"low"
45,"SUPPRF71005",52,39,83,11,12,"72",71,72,2,10,"low"
46,"SUPPRF71005",48,42,63,14,0,"52",63,49,2,10,"low"
47,"SUPPRF71005",53,50,41,-30,-13,"55",54,71,2,10,"low"
48,"SUPPRF71005",47,33,81,13,1,"67",80,68,2,10,"low"
1,"SUPPRF51078",58,54,70,1,-1,"61",71,69,6,10,"high"
2,"SUPPRF51078",47,49,66,13,12,"54",54,53,6,10,"high"
3,"SUPPRF51078",49,42,29,-30,0,"66",29,59,6,10,"high"
4,"SUPPRF51078",46,50,83,4,12,"65",71,79,6,10,"high"
5,"SUPPRF51078",45,54,35,-24,15,"57",20,59,6,10,"high"
6,"SUPPRF51078",59,60,47,-19,-16,"68",63,66,6,10,"high"
7,"SUPPRF51078",53,55,55,-9,1,"61",54,64,6,10,"high"
8,"SUPPRF51078",56,57,33,-25,-13,"54",46,58,6,10,"high"
9,"SUPPRF51078",47,44,94,26,23,"49",71,68,6,10,"high"
10,"SUPPRF51078",57,50,61,1,24,"66",37,60,6,10,"high"
11,"SUPPRF51078",54,59,50,-14,-13,"60",63,64,6,10,"high"
12,"SUPPRF51078",45,52,22,-44,-15,"65",37,66,6,10,"high"
13,"SUPPRF51078",49,52,38,-34,-16,"55",54,72,6,10,"high"
14,"SUPPRF51078",45,55,46,-27,0,"67",46,73,6,10,"high"
15,"SUPPRF51078",59,42,68,1,-12,"46",80,67,6,10,"high"
16,"SUPPRF51078",64,47,49,16,12,"45",37,33,6,10,"high"
17,"SUPPRF51078",76,47,96,23,16,"53",80,73,6,10,"high"
18,"SUPPRF51078",48,51,75,15,29,"68",46,60,6,10,"high"
19,"SUPPRF51078",47,56,34,-24,-12,"40",46,58,6,10,"high"
20,"SUPPRF51078",50,41,8,-41,-12,"37",20,49,6,10,"high"
21,"SUPPRF51078",53,53,41,-10,-13,"57",54,51,6,10,"high"
22,"SUPPRF51078",47,47,77,22,14,"43",63,55,6,10,"high"
23,"SUPPRF51078",42,41,15,-33,-14,"48",29,48,6,10,"high"
24,"SUPPRF51078",55,54,63,8,0,"55",63,55,6,10,"high"
25,"SUPPRF51078",45,48,80,27,0,"50",80,53,6,10,"high"
26,"SUPPRF51078",51,52,58,6,29,"47",29,52,6,10,"high"
27,"SUPPRF51078",51,49,47,-9,27,"56",20,56,6,10,"high"
28,"SUPPRF51078",45,47,19,-35,-1,"54",20,54,6,10,"high"
29,"SUPPRF51078",54,59,100,43,20,"57",80,57,6,10,"high"
30,"SUPPRF51078",43,49,45,-15,-1,"46",46,60,6,10,"high"
31,"SUPPRF51078",50,55,58,-2,12,"52",46,60,6,10,"high"
32,"SUPPRF51078",47,54,54,-3,0,"49",54,57,6,10,"high"
33,"SUPPRF51078",47,58,56,8,-15,"47",71,48,6,10,"high"
34,"SUPPRF51078",44,52,28,-32,-1,"56",29,60,6,10,"high"
35,"SUPPRF51078",52,53,55,0,-16,"50",71,55,6,10,"high"
36,"SUPPRF51078",49,55,24,-34,-13,"47",37,58,6,10,"high"
37,"SUPPRF51078",49,48,67,11,-13,"53",80,56,6,10,"high"
38,"SUPPRF51078",54,51,38,-21,1,"60",37,59,6,10,"high"
39,"SUPPRF51078",50,50,16,-34,-13,"54",29,50,6,10,"high"
40,"SUPPRF51078",50,48,20,-29,0,"48",20,49,6,10,"high"
41,"SUPPRF51078",49,49,71,20,0,"50",71,51,6,10,"high"
42,"SUPPRF51078",22,35,37,-12,0,"49",37,49,6,10,"high"
43,"SUPPRF51078",30,58,81,26,1,"49",80,55,6,10,"high"
44,"SUPPRF51078",47,47,62,-3,-1,"45",63,65,6,10,"high"
45,"SUPPRF51078",28,46,46,-4,17,"36",29,50,6,10,"high"
46,"SUPPRF51078",47,53,88,42,25,"46",63,46,6,10,"high"
47,"SUPPRF51078",51,50,78,34,24,"45",54,44,6,10,"high"
48,"SUPPRF51078",21,45,6,-51,-14,"49",20,57,6,10,"high"
1,"SUPPRF89542",87,12,55,-20,-16,"84",71,75,1,10,"low"
2,"SUPPRF89542",81,16,46,-20,17,"48",29,66,1,10,"low"
3,"SUPPRF89542",95,6,88,24,25,"66",63,64,1,10,"low"
4,"SUPPRF89542",82,16,68,-17,-12,"76",80,85,1,10,"low"
5,"SUPPRF89542",78,26,38,-29,1,"25",37,67,1,10,"low"
6,"SUPPRF89542",92,13,75,-2,29,"41",46,77,1,10,"low"
7,"SUPPRF89542",76,24,28,-27,-1,"0",29,55,1,10,"low"
8,"SUPPRF89542",35,20,16,-47,-13,"25",29,63,1,10,"low"
9,"SUPPRF89542",37,52,8,-65,-12,"42",20,73,1,10,"low"
10,"SUPPRF89542",72,43,67,-7,-13,"62",80,74,1,10,"low"
11,"SUPPRF89542",52,35,22,-54,-15,"53",37,76,1,10,"low"
12,"SUPPRF89542",64,44,15,-51,-14,"27",29,66,1,10,"low"
13,"SUPPRF89542",90,13,94,24,23,"41",71,70,1,10,"low"
14,"SUPPRF89542",32,61,29,-41,0,"40",29,70,1,10,"low"
15,"SUPPRF89542",75,21,50,-24,-13,"62",63,74,1,10,"low"
16,"SUPPRF89542",78,14,71,0,0,"56",71,71,1,10,"low"
17,"SUPPRF89542",72,23,61,-7,24,"55",37,68,1,10,"low"
18,"SUPPRF89542",79,10,83,7,12,"63",71,76,1,10,"low"
19,"SUPPRF89542",94,9,100,81,20,"10",80,19,1,10,"low"
20,"SUPPRF89542",60,33,35,-45,15,"53",20,80,1,10,"low"
21,"SUPPRF89542",82,15,70,-3,-1,"35",71,73,1,10,"low"
22,"SUPPRF89542",65,22,54,7,0,"75",54,47,1,10,"low"
23,"SUPPRF89542",60,16,56,-25,-15,"43",71,81,1,10,"low"
24,"SUPPRF89542",75,26,49,-2,12,"22",37,51,1,10,"low"
25,"SUPPRF89542",31,13,6,-62,-14,"82",20,68,1,10,"low"
26,"SUPPRF89542",45,32,38,-43,-16,"69",54,81,1,10,"low"
27,"SUPPRF89542",90,17,96,24,16,"58",80,72,1,10,"low"
28,"SUPPRF89542",67,24,58,-21,29,"72",29,79,1,10,"low"
29,"SUPPRF89542",86,10,81,2,1,"55",80,79,1,10,"low"
30,"SUPPRF89542",37,61,63,-11,0,"59",63,74,1,10,"low"
31,"SUPPRF89542",70,32,24,-40,-13,"48",37,64,1,10,"low"
32,"SUPPRF89542",81,25,33,-46,-13,"58",46,79,1,10,"low"
33,"SUPPRF89542",74,32,47,-21,27,"63",20,68,1,10,"low"
34,"SUPPRF89542",83,26,46,-3,0,"26",46,49,1,10,"low"
35,"SUPPRF89542",79,25,34,-38,-12,"52",46,72,1,10,"low"
36,"SUPPRF89542",77,28,19,-60,-1,"67",20,79,1,10,"low"
37,"SUPPRF89542",70,24,80,7,0,"57",80,73,1,10,"low"
38,"SUPPRF89542",83,35,62,-6,-1,"54",63,68,1,10,"low"
39,"SUPPRF89542",67,19,55,13,1,"11",54,42,1,10,"low"
40,"SUPPRF89542",81,11,47,-29,-16,"34",63,76,1,10,"low"
41,"SUPPRF89542",57,21,41,-29,-13,"37",54,70,1,10,"low"
42,"SUPPRF89542",81,54,58,6,12,"26",46,52,1,10,"low"
43,"SUPPRF89542",72,37,45,-21,-1,"50",46,66,1,10,"low"
44,"SUPPRF89542",81,44,77,5,14,"61",63,72,1,10,"low"
45,"SUPPRF89542",72,34,66,-1,12,"45",54,67,1,10,"low"
46,"SUPPRF89542",28,63,20,-72,0,"65",20,92,1,10,"low"
47,"SUPPRF89542",72,15,78,2,24,"66",54,76,1,10,"low"
48,"SUPPRF89542",76,56,37,-42,0,"60",37,79,1,10,"low"
1,"SUPPRF40116",55,54,6,-13,-14,"62",20,19,8,10,"high"
2,"SUPPRF40116",56,52,96,23,16,"45",80,73,8,10,"high"
3,"SUPPRF40116",51,54,67,-13,-13,"52",80,80,8,10,"high"
4,"SUPPRF40116",53,54,37,6,0,"60",37,31,8,10,"high"
5,"SUPPRF40116",58,55,46,-1,0,"35",46,47,8,10,"high"
6,"SUPPRF40116",61,55,100,11,20,"65",80,89,8,10,"high"
7,"SUPPRF40116",57,60,45,12,-1,"37",46,33,8,10,"high"
8,"SUPPRF40116",60,53,94,30,23,"43",71,64,8,10,"high"
9,"SUPPRF40116",59,54,75,18,29,"28",46,57,8,10,"high"
10,"SUPPRF40116",53,53,33,-7,-13,"57",46,40,8,10,"high"
11,"SUPPRF40116",52,53,66,8,12,"56",54,58,8,10,"high"
12,"SUPPRF40116",52,53,55,-26,-16,"60",71,81,8,10,"high"
13,"SUPPRF40116",51,52,41,-15,-13,"32",54,56,8,10,"high"
14,"SUPPRF40116",54,52,71,4,0,"39",71,67,8,10,"high"
15,"SUPPRF40116",52,54,24,-17,-13,"50",37,41,8,10,"high"
16,"SUPPRF40116",57,49,77,20,14,"61",63,57,8,10,"high"
17,"SUPPRF40116",62,52,8,-4,-12,"64",20,12,8,10,"high"
18,"SUPPRF40116",50,56,54,8,0,"34",54,46,8,10,"high"
19,"SUPPRF40116",51,50,15,-18,-14,"53",29,33,8,10,"high"
20,"SUPPRF40116",56,48,68,12,-12,"30",80,56,8,10,"high"
21,"SUPPRF40116",64,54,50,-4,-13,"73",63,54,8,10,"high"
22,"SUPPRF40116",65,55,58,41,29,"59",29,17,8,10,"high"
23,"SUPPRF40116",58,48,78,19,24,"50",54,59,8,10,"high"
24,"SUPPRF40116",54,47,28,10,-1,"53",29,18,8,10,"high"
25,"SUPPRF40116",50,43,70,10,-1,"60",71,60,8,10,"high"
26,"SUPPRF40116",54,49,38,-19,-16,"44",54,57,8,10,"high"
27,"SUPPRF40116",43,56,38,17,1,"75",37,21,8,10,"high"
28,"SUPPRF40116",60,38,62,6,-1,"46",63,56,8,10,"high"
29,"SUPPRF40116",57,40,80,-3,0,"62",80,83,8,10,"high"
30,"SUPPRF40116",51,41,56,-15,-15,"60",71,71,8,10,"high"
31,"SUPPRF40116",52,55,81,13,1,"78",80,68,8,10,"high"
32,"SUPPRF40116",51,57,19,16,-1,"71",20,3,8,10,"high"
33,"SUPPRF40116",62,43,88,30,25,"62",63,58,8,10,"high"
34,"SUPPRF40116",51,43,35,19,15,"72",20,16,8,10,"high"
35,"SUPPRF40116",56,46,83,25,12,"81",71,58,8,10,"high"
36,"SUPPRF40116",49,48,47,-8,-16,"47",63,55,8,10,"high"
37,"SUPPRF40116",55,44,46,20,17,"76",29,26,8,10,"high"
38,"SUPPRF40116",53,46,58,23,12,"32",46,35,8,10,"high"
39,"SUPPRF40116",54,45,55,-11,1,"59",54,66,8,10,"high"
40,"SUPPRF40116",54,44,61,24,24,"34",37,37,8,10,"high"
41,"SUPPRF40116",63,46,47,26,27,"76",20,21,8,10,"high"
42,"SUPPRF40116",56,58,29,0,0,"56",29,29,8,10,"high"
43,"SUPPRF40116",51,44,22,-2,-15,"56",37,24,8,10,"high"
44,"SUPPRF40116",53,45,16,-18,-13,"50",29,34,8,10,"high"
45,"SUPPRF40116",59,44,49,9,12,"60",37,40,8,10,"high"
46,"SUPPRF40116",48,41,34,-15,-12,"45",46,49,8,10,"high"
47,"SUPPRF40116",55,41,63,6,0,"32",63,57,8,10,"high"
48,"SUPPRF40116",72,40,20,0,0,"58",20,20,8,10,"high"
1,"SUPPRF98981",28,97,35,-50,15,"55",20,85,2,10,"low"
2,"SUPPRF98981",3,98,16,-44,-13,"20",29,60,2,10,"low"
3,"SUPPRF98981",72,80,83,2,12,"49",71,81,2,10,"low"
4,"SUPPRF98981",72,66,67,-6,-13,"51",80,73,2,10,"low"
5,"SUPPRF98981",33,87,8,-66,-12,"37",20,74,2,10,"low"
6,"SUPPRF98981",83,64,71,-6,0,"63",71,77,2,10,"low"
7,"SUPPRF98981",81,59,47,-38,-16,"51",63,85,2,10,"low"
8,"SUPPRF98981",68,51,24,-53,-13,"52",37,77,2,10,"low"
9,"SUPPRF98981",76,34,81,16,1,"37",80,65,2,10,"low"
10,"SUPPRF98981",68,66,47,-30,27,"56",20,77,2,10,"low"
11,"SUPPRF98981",26,77,29,-12,0,"72",29,41,2,10,"low"
12,"SUPPRF98981",69,65,54,37,0,"46",54,17,2,10,"low"
13,"SUPPRF98981",69,70,94,52,23,"53",71,42,2,10,"low"
14,"SUPPRF98981",74,62,78,56,24,"74",54,22,2,10,"low"
15,"SUPPRF98981",98,7,100,57,20,"73",80,43,2,10,"low"
16,"SUPPRF98981",79,72,41,10,-13,"45",54,31,2,10,"low"
17,"SUPPRF98981",65,78,20,4,0,"84",20,16,2,10,"low"
18,"SUPPRF98981",76,75,22,-22,-15,"79",37,44,2,10,"low"
19,"SUPPRF98981",81,65,62,-9,-1,"67",63,71,2,10,"low"
20,"SUPPRF98981",56,52,37,-18,0,"54",37,55,2,10,"low"
21,"SUPPRF98981",61,14,61,-26,24,"22",37,87,2,10,"low"
22,"SUPPRF98981",84,62,70,0,-1,"64",71,70,2,10,"low"
23,"SUPPRF98981",71,22,56,-2,-15,"84",71,58,2,10,"low"
24,"SUPPRF98981",70,48,38,9,1,"92",37,29,2,10,"low"
25,"SUPPRF98981",66,75,38,16,-16,"86",54,22,2,10,"low"
26,"SUPPRF98981",53,45,46,-3,0,"86",46,49,2,10,"low"
27,"SUPPRF98981",87,10,55,1,-16,"90",71,54,2,10,"low"
28,"SUPPRF98981",80,40,49,17,12,"90",37,32,2,10,"low"
29,"SUPPRF98981",86,83,77,24,14,"52",63,53,2,10,"low"
30,"SUPPRF98981",54,71,28,-21,-1,"51",29,49,2,10,"low"
31,"SUPPRF98981",94,4,45,-1,-1,"96",46,46,2,10,"low"
32,"SUPPRF98981",81,6,63,-7,0,"91",63,70,2,10,"low"
33,"SUPPRF98981",82,9,19,5,-1,"72",20,14,2,10,"low"
34,"SUPPRF98981",82,89,55,-8,1,"66",54,63,2,10,"low"
35,"SUPPRF98981",77,78,80,22,0,"63",80,58,2,10,"low"
36,"SUPPRF98981",10,89,50,-30,-13,"91",63,80,2,10,"low"
37,"SUPPRF98981",63,71,68,11,-12,"89",80,57,2,10,"low"
38,"SUPPRF98981",51,62,58,32,12,"70",46,26,2,10,"low"
39,"SUPPRF98981",75,45,46,-10,17,"51",29,56,2,10,"low"
40,"SUPPRF98981",4,81,33,-23,-13,"68",46,56,2,10,"low"
41,"SUPPRF98981",17,76,96,69,16,"91",80,27,2,10,"low"
42,"SUPPRF98981",99,1,88,29,25,"50",63,59,2,10,"low"
43,"SUPPRF98981",58,67,15,-46,-14,"54",29,61,2,10,"low"
44,"SUPPRF98981",81,72,66,12,12,"48",54,54,2,10,"low"
45,"SUPPRF98981",86,27,58,3,29,"68",29,55,2,10,"low"
46,"SUPPRF98981",15,11,34,-28,-12,"54",46,62,2,10,"low"
47,"SUPPRF98981",99,4,75,12,29,"91",46,63,2,10,"low"
48,"SUPPRF98981",2,95,6,-87,-14,"94",20,93,2,10,"low"
1,"SUPPRF06248",55,58,67,-14,-13,"69",80,81,3,10,"low"
2,"SUPPRF06248",53,54,38,-2,1,"61",37,40,3,10,"low"
3,"SUPPRF06248",57,55,29,7,0,"60",29,22,3,10,"low"
4,"SUPPRF06248",59,52,58,23,29,"63",29,35,3,10,"low"
5,"SUPPRF06248",53,59,37,8,0,"61",37,29,3,10,"low"
6,"SUPPRF06248",54,53,45,-20,-1,"51",46,65,3,10,"low"
7,"SUPPRF06248",51,53,41,-3,-13,"50",54,44,3,10,"low"
8,"SUPPRF06248",57,50,81,41,1,"50",80,40,3,10,"low"
9,"SUPPRF06248",52,57,63,10,0,"62",63,53,3,10,"low"
10,"SUPPRF06248",51,50,47,4,-16,"57",63,43,3,10,"low"
11,"SUPPRF06248",50,48,50,10,-13,"58",63,40,3,10,"low"
12,"SUPPRF06248",54,48,46,-4,0,"56",46,50,3,10,"low"
13,"SUPPRF06248",47,49,46,20,17,"53",29,26,3,10,"low"
14,"SUPPRF06248",53,53,22,-28,-15,"64",37,50,3,10,"low"
15,"SUPPRF06248",44,57,49,12,12,"47",37,37,3,10,"low"
16,"SUPPRF06248",40,59,71,16,0,"53",71,55,3,10,"low"
17,"SUPPRF06248",48,58,55,20,1,"52",54,35,3,10,"low"
18,"SUPPRF06248",49,57,83,20,12,"55",71,63,3,10,"low"
19,"SUPPRF06248",44,56,55,-10,-16,"52",71,65,3,10,"low"
20,"SUPPRF06248",43,59,38,-27,-16,"49",54,65,3,10,"low"
21,"SUPPRF06248",44,64,75,20,29,"47",46,55,3,10,"low"
22,"SUPPRF06248",49,51,78,27,24,"47",54,51,3,10,"low"
23,"SUPPRF06248",45,57,100,60,20,"44",80,40,3,10,"low"
24,"SUPPRF06248",47,58,80,6,0,"49",80,74,3,10,"low"
25,"SUPPRF06248",48,51,24,-8,-13,"52",37,32,3,10,"low"
26,"SUPPRF06248",42,51,19,-13,-1,"41",20,32,3,10,"low"
27,"SUPPRF06248",44,50,62,16,-1,"51",63,46,3,10,"low"
28,"SUPPRF06248",42,59,94,30,23,"55",71,64,3,10,"low"
29,"SUPPRF06248",39,58,61,19,24,"55",37,42,3,10,"low"
30,"SUPPRF06248",44,55,96,44,16,"48",80,52,3,10,"low"
31,"SUPPRF06248",48,61,56,-8,-15,"52",71,64,3,10,"low"
32,"SUPPRF06248",36,58,34,-14,-12,"54",46,48,3,10,"low"
33,"SUPPRF06248",40,58,28,6,-1,"47",29,22,3,10,"low"
34,"SUPPRF06248",37,63,66,26,12,"47",54,40,3,10,"low"
35,"SUPPRF06248",41,62,6,-18,-14,"47",20,24,3,10,"low"
36,"SUPPRF06248",29,62,15,-2,-14,"50",29,17,3,10,"low"
37,"SUPPRF06248",26,60,88,48,25,"48",63,40,3,10,"low"
38,"SUPPRF06248",36,52,77,31,14,"50",63,46,3,10,"low"
39,"SUPPRF06248",32,58,20,5,0,"48",20,15,3,10,"low"
40,"SUPPRF06248",29,65,68,58,-12,"70",80,10,3,10,"low"
41,"SUPPRF06248",28,64,54,9,0,"49",54,45,3,10,"low"
42,"SUPPRF06248",25,65,33,-7,-13,"48",46,40,3,10,"low"
43,"SUPPRF06248",25,67,16,-4,-13,"34",29,20,3,10,"low"
44,"SUPPRF06248",17,65,47,35,27,"55",20,12,3,10,"low"
45,"SUPPRF06248",27,62,8,-13,-12,"49",20,21,3,10,"low"
46,"SUPPRF06248",27,63,35,25,15,"46",20,10,3,10,"low"
47,"SUPPRF06248",29,65,70,24,-1,"50",71,46,3,10,"low"
48,"SUPPRF06248",29,56,58,13,12,"50",46,45,3,10,"low"
1,"SUPPRF87563",32,64,24,0,-13,"40",37,24,11,10,"high"
2,"SUPPRF87563",27,75,35,15,15,"65",20,20,11,10,"high"
3,"SUPPRF87563",25,69,20,-10,0,"65",20,30,11,10,"high"
4,"SUPPRF87563",59,60,75,40,29,"60",46,35,11,10,"high"
5,"SUPPRF87563",42,50,54,24,0,"69",54,30,11,10,"high"
6,"SUPPRF87563",29,66,33,-7,-13,"60",46,40,11,10,"high"
7,"SUPPRF87563",26,73,68,45,-12,"66",80,23,11,10,"high"
8,"SUPPRF87563",30,54,47,23,27,"63",20,24,11,10,"high"
9,"SUPPRF87563",50,44,81,37,1,"65",80,44,11,10,"high"
10,"SUPPRF87563",49,47,66,32,12,"66",54,34,11,10,"high"
11,"SUPPRF87563",46,47,78,39,24,"73",54,39,11,10,"high"
12,"SUPPRF87563",52,50,6,-35,-14,"71",20,41,11,10,"high"
13,"SUPPRF87563",49,49,41,-5,-13,"63",54,46,11,10,"high"
14,"SUPPRF87563",48,48,38,13,-16,"61",54,25,11,10,"high"
15,"SUPPRF87563",49,49,62,30,-1,"64",63,32,11,10,"high"
16,"SUPPRF87563",49,50,94,54,23,"60",71,40,11,10,"high"
17,"SUPPRF87563",50,50,46,9,17,"68",29,37,11,10,"high"
18,"SUPPRF87563",100,48,100,52,20,"67",80,48,11,10,"high"
19,"SUPPRF87563",44,43,56,9,-15,"69",71,47,11,10,"high"
20,"SUPPRF87563",48,50,55,-6,-16,"76",71,61,11,10,"high"
21,"SUPPRF87563",50,47,46,-3,0,"47",46,49,11,10,"high"
22,"SUPPRF87563",53,47,45,11,-1,"50",46,34,11,10,"high"
23,"SUPPRF87563",52,49,22,-18,-15,"44",37,40,11,10,"high"
24,"SUPPRF87563",48,46,15,-36,-14,"43",29,51,11,10,"high"
25,"SUPPRF87563",46,50,67,-8,-13,"65",80,75,11,10,"high"
26,"SUPPRF87563",49,48,34,-11,-12,"58",46,45,11,10,"high"
27,"SUPPRF87563",49,48,77,51,14,"65",63,26,11,10,"high"
28,"SUPPRF87563",51,49,47,-6,-16,"65",63,53,11,10,"high"
29,"SUPPRF87563",49,49,19,1,-1,"92",20,18,11,10,"high"
30,"SUPPRF87563",100,53,88,35,25,"79",63,53,11,10,"high"
31,"SUPPRF87563",35,53,50,-14,-13,"83",63,64,11,10,"high"
32,"SUPPRF87563",51,50,55,7,1,"85",54,48,11,10,"high"
33,"SUPPRF87563",34,52,38,-3,1,"75",37,41,11,10,"high"
34,"SUPPRF87563",79,53,96,39,16,"37",80,57,11,10,"high"
35,"SUPPRF87563",69,35,63,20,0,"76",63,43,11,10,"high"
36,"SUPPRF87563",73,29,8,-9,-12,"57",20,17,11,10,"high"
37,"SUPPRF87563",64,31,49,15,12,"63",37,34,11,10,"high"
38,"SUPPRF87563",64,38,16,-41,-13,"49",29,57,11,10,"high"
39,"SUPPRF87563",70,30,61,26,24,"56",37,35,11,10,"high"
40,"SUPPRF87563",77,28,80,-1,0,"76",80,81,11,10,"high"
41,"SUPPRF87563",67,62,70,60,-1,"86",71,10,11,10,"high"
42,"SUPPRF87563",63,24,58,14,29,"86",29,44,11,10,"high"
43,"SUPPRF87563",63,18,29,-16,0,"64",29,45,11,10,"high"
44,"SUPPRF87563",65,27,58,16,12,"57",46,42,11,10,"high"
45,"SUPPRF87563",72,30,83,20,12,"69",71,63,11,10,"high"
46,"SUPPRF87563",69,27,71,13,0,"70",71,58,11,10,"high"
47,"SUPPRF87563",64,18,28,-11,-1,"69",29,39,11,10,"high"
48,"SUPPRF87563",68,15,37,-16,0,"77",37,53,11,10,"high"
