"Trial.Number","Random_ID","Response_H","Response_Ax","Response_fdbk","Response_SubjPE","Response_PE","Response_certainty","Response_m_hist","Response_pred","mini_SPIN_total","Social_Anxiety"
1,"SUPPRF23130",78,69,100,23,20,78,80,77,3,"low"
2,"SUPPRF23130",38,34,15,-6,-14,46,29,21,3,"low"
3,"SUPPRF23130",57,54,29,13,0,53,29,16,3,"low"
4,"SUPPRF23130",13,54,6,-46,-14,40,20,52,3,"low"
5,"SUPPRF23130",51,51,78,31,24,43,54,47,3,"low"
6,"SUPPRF23130",61,52,47,35,27,17,20,12,3,"low"
7,"SUPPRF23130",39,48,22,-28,-15,55,37,50,3,"low"
8,"SUPPRF23130",65,60,55,-4,1,68,54,59,3,"low"
9,"SUPPRF23130",47,34,34,-21,-12,55,46,55,3,"low"
10,"SUPPRF23130",58,51,20,-29,0,49,20,49,3,"low"
11,"SUPPRF23130",48,45,49,-9,12,52,37,58,3,"low"
12,"SUPPRF23130",64,66,33,7,-13,30,46,26,3,"low"
13,"SUPPRF23130",67,60,63,11,0,52,63,52,3,"low"
14,"SUPPRF23130",66,63,62,-2,-1,66,63,64,3,"low"
15,"SUPPRF23130",44,44,68,-9,-12,67,80,77,3,"low"
16,"SUPPRF23130",59,59,46,14,17,34,29,32,3,"low"
17,"SUPPRF23130",48,46,38,-25,1,65,37,63,3,"low"
18,"SUPPRF23130",56,60,35,11,15,29,20,24,3,"low"
19,"SUPPRF23130",73,56,61,7,24,64,37,54,3,"low"
20,"SUPPRF23130",67,67,80,31,0,51,80,49,3,"low"
21,"SUPPRF23130",75,92,94,35,23,65,71,59,3,"low"
22,"SUPPRF23130",50,51,38,-9,-16,46,54,47,3,"low"
23,"SUPPRF23130",64,49,67,12,-13,58,80,55,3,"low"
24,"SUPPRF23130",73,70,41,2,-13,84,54,39,3,"low"
25,"SUPPRF23130",67,69,28,0,-1,85,29,28,3,"low"
26,"SUPPRF23130",42,47,50,-24,-13,67,63,74,3,"low"
27,"SUPPRF23130",57,49,55,-17,-16,52,71,72,3,"low"
28,"SUPPRF23130",56,50,45,-12,-1,59,46,57,3,"low"
29,"SUPPRF23130",29,42,8,-6,-12,75,20,14,3,"low"
30,"SUPPRF23130",53,60,54,8,0,57,54,46,3,"low"
31,"SUPPRF23130",82,75,96,42,16,63,80,54,3,"low"
32,"SUPPRF23130",78,64,83,58,12,30,71,25,3,"low"
33,"SUPPRF23130",70,65,66,10,12,46,54,56,3,"low"
34,"SUPPRF23130",64,74,75,36,29,44,46,39,3,"low"
35,"SUPPRF23130",63,65,71,11,0,65,71,60,3,"low"
36,"SUPPRF23130",67,67,58,28,29,49,29,30,3,"low"
37,"SUPPRF23130",63,51,77,19,14,23,63,58,3,"low"
38,"SUPPRF23130",74,71,56,-3,-15,93,71,59,3,"low"
39,"SUPPRF23130",46,39,19,-20,-1,37,20,39,3,"low"
40,"SUPPRF23130",69,71,70,-7,-1,89,71,77,3,"low"
41,"SUPPRF23130",43,63,47,-18,-16,79,63,65,3,"low"
42,"SUPPRF23130",68,80,16,4,-13,79,29,12,3,"low"
43,"SUPPRF23130",27,59,37,-17,0,72,37,54,3,"low"
44,"SUPPRF23130",84,74,88,37,25,63,63,51,3,"low"
45,"SUPPRF23130",75,74,81,-1,1,88,80,82,3,"low"
46,"SUPPRF23130",45,59,46,-9,0,61,46,55,3,"low"
47,"SUPPRF23130",52,51,24,-5,-13,78,37,29,3,"low"
48,"SUPPRF23130",57,58,58,8,12,50,46,50,3,"low"
1,"SUPPRF57988",46,37,37,-13,0,44,37,50,5,"low"
2,"SUPPRF57988",48,39,88,26,25,64,63,62,5,"low"
3,"SUPPRF57988",46,38,33,-7,-13,31,46,40,5,"low"
4,"SUPPRF57988",47,41,46,-10,17,26,29,56,5,"low"
5,"SUPPRF57988",40,46,66,10,12,36,54,56,5,"low"
6,"SUPPRF57988",44,40,55,-2,-16,27,71,57,5,"low"
7,"SUPPRF57988",47,43,58,17,29,30,29,41,5,"low"
8,"SUPPRF57988",42,48,16,-33,-13,37,29,49,5,"low"
9,"SUPPRF57988",44,47,68,-14,-12,34,80,82,5,"low"
10,"SUPPRF57988",43,47,94,36,23,42,71,58,5,"low"
11,"SUPPRF57988",41,42,47,-19,-16,41,63,66,5,"low"
12,"SUPPRF57988",45,44,96,51,16,34,80,45,5,"low"
13,"SUPPRF57988",44,42,20,-22,0,37,20,42,5,"low"
14,"SUPPRF57988",43,46,56,-9,-15,41,71,65,5,"low"
15,"SUPPRF57988",43,46,54,-4,0,38,54,58,5,"low"
16,"SUPPRF57988",45,44,46,7,0,45,46,39,5,"low"
17,"SUPPRF57988",38,32,38,-6,1,41,37,44,5,"low"
18,"SUPPRF57988",37,33,75,37,29,36,46,38,5,"low"
19,"SUPPRF57988",41,41,29,-13,0,35,29,42,5,"low"
20,"SUPPRF57988",43,40,41,-18,-13,39,54,59,5,"low"
21,"SUPPRF57988",39,38,83,22,12,40,71,61,5,"low"
22,"SUPPRF57988",38,39,67,-12,-13,37,80,79,5,"low"
23,"SUPPRF57988",40,38,15,-11,-14,39,29,26,5,"low"
24,"SUPPRF57988",35,41,24,-16,-13,40,37,40,5,"low"
25,"SUPPRF57988",43,40,100,18,20,43,80,82,5,"low"
26,"SUPPRF57988",44,42,38,-17,-16,41,54,55,5,"low"
27,"SUPPRF57988",41,44,70,11,-1,33,71,59,5,"low"
28,"SUPPRF57988",39,41,77,17,14,37,63,60,5,"low"
29,"SUPPRF57988",44,41,63,2,0,40,63,61,5,"low"
30,"SUPPRF57988",40,41,55,-1,1,41,54,56,5,"low"
31,"SUPPRF57988",36,39,61,7,24,39,37,54,5,"low"
32,"SUPPRF57988",39,36,19,-4,-1,38,20,23,5,"low"
33,"SUPPRF57988",37,41,45,-19,-1,40,46,64,5,"low"
34,"SUPPRF57988",40,37,47,18,27,36,20,29,5,"low"
35,"SUPPRF57988",35,34,35,13,15,35,20,22,5,"low"
36,"SUPPRF57988",32,33,28,-17,-1,39,29,45,5,"low"
37,"SUPPRF57988",37,41,34,-4,-12,38,46,38,5,"low"
38,"SUPPRF57988",42,35,22,-21,-15,39,37,43,5,"low"
39,"SUPPRF57988",35,36,58,12,12,36,46,46,5,"low"
40,"SUPPRF57988",37,38,62,14,-1,35,63,48,5,"low"
41,"SUPPRF57988",39,40,50,-17,-13,37,63,67,5,"low"
42,"SUPPRF57988",39,38,8,-25,-12,42,20,33,5,"low"
43,"SUPPRF57988",39,39,6,-16,-14,39,20,22,5,"low"
44,"SUPPRF57988",37,42,81,8,1,38,80,73,5,"low"
45,"SUPPRF57988",38,41,49,-7,12,34,37,56,5,"low"
46,"SUPPRF57988",41,38,78,9,24,29,54,69,5,"low"
47,"SUPPRF57988",46,39,80,2,0,36,80,78,5,"low"
48,"SUPPRF57988",43,43,71,1,0,36,71,70,5,"low"
1,"SUPPRF28201",57,55,63,9,0,61,63,54,2,"low"
2,"SUPPRF28201",49,42,50,-20,-13,68,63,70,2,"low"
3,"SUPPRF28201",51,49,19,3,-1,71,20,16,2,"low"
4,"SUPPRF28201",48,47,68,-21,-12,64,80,89,2,"low"
5,"SUPPRF28201",52,49,77,29,14,32,63,48,2,"low"
6,"SUPPRF28201",52,46,56,-24,-15,51,71,80,2,"low"
7,"SUPPRF28201",56,45,24,-17,-13,23,37,41,2,"low"
8,"SUPPRF28201",41,48,8,-8,-12,38,20,16,2,"low"
9,"SUPPRF28201",51,46,46,-5,0,30,46,51,2,"low"
10,"SUPPRF28201",48,47,49,-4,12,10,37,53,2,"low"
11,"SUPPRF28201",51,49,55,-12,-16,42,71,67,2,"low"
12,"SUPPRF28201",44,42,47,-11,-16,47,63,58,2,"low"
13,"SUPPRF28201",42,49,34,-20,-12,51,46,54,2,"low"
14,"SUPPRF28201",47,41,61,13,24,21,37,48,2,"low"
15,"SUPPRF28201",40,28,29,4,0,31,29,25,2,"low"
16,"SUPPRF28201",42,39,35,10,15,39,20,25,2,"low"
17,"SUPPRF28201",45,38,67,7,-13,31,80,60,2,"low"
18,"SUPPRF28201",31,34,37,-5,0,28,37,42,2,"low"
19,"SUPPRF28201",44,48,71,3,0,30,71,68,2,"low"
20,"SUPPRF28201",42,44,62,-6,-1,40,63,68,2,"low"
21,"SUPPRF28201",49,48,83,13,12,33,71,70,2,"low"
22,"SUPPRF28201",43,39,58,20,12,19,46,38,2,"low"
23,"SUPPRF28201",37,40,66,17,12,29,54,49,2,"low"
24,"SUPPRF28201",48,49,78,19,24,49,54,59,2,"low"
25,"SUPPRF28201",39,37,33,-22,-13,44,46,55,2,"low"
26,"SUPPRF28201",42,43,81,9,1,38,80,72,2,"low"
27,"SUPPRF28201",32,36,38,-23,-16,44,54,61,2,"low"
28,"SUPPRF28201",51,37,58,39,29,7,29,19,2,"low"
29,"SUPPRF28201",65,34,96,23,16,37,80,73,2,"low"
30,"SUPPRF28201",35,43,6,-20,-14,35,20,26,2,"low"
31,"SUPPRF28201",45,43,70,-13,-1,28,71,83,2,"low"
32,"SUPPRF28201",70,46,55,0,1,37,54,55,2,"low"
33,"SUPPRF28201",42,39,16,-12,-13,34,29,28,2,"low"
34,"SUPPRF28201",47,34,46,32,17,17,29,14,2,"low"
35,"SUPPRF28201",31,33,45,2,-1,25,46,43,2,"low"
36,"SUPPRF28201",39,38,94,18,23,16,71,76,2,"low"
37,"SUPPRF28201",34,36,41,-12,-13,39,54,53,2,"low"
38,"SUPPRF28201",20,24,100,36,20,28,80,64,2,"low"
39,"SUPPRF28201",32,31,38,-2,1,20,37,40,2,"low"
40,"SUPPRF28201",29,30,88,55,25,26,63,33,2,"low"
41,"SUPPRF28201",29,30,22,-27,-15,14,37,49,2,"low"
42,"SUPPRF28201",30,30,20,-5,0,13,20,25,2,"low"
43,"SUPPRF28201",34,31,75,37,29,35,46,38,2,"low"
44,"SUPPRF28201",29,23,47,24,27,19,20,23,2,"low"
45,"SUPPRF28201",31,30,28,-21,-1,36,29,49,2,"low"
46,"SUPPRF28201",24,32,54,8,0,25,54,46,2,"low"
47,"SUPPRF28201",21,22,15,-13,-14,12,29,28,2,"low"
48,"SUPPRF28201",20,24,80,7,0,23,80,73,2,"low"
1,"SUPPRF94387",52,55,46,-4,17,60,29,50,1,"low"
2,"SUPPRF94387",52,53,58,11,12,61,46,47,1,"low"
3,"SUPPRF94387",51,49,50,4,-13,60,63,46,1,"low"
4,"SUPPRF94387",56,50,83,19,12,62,71,64,1,"low"
5,"SUPPRF94387",56,48,56,-6,-15,80,71,62,1,"low"
6,"SUPPRF94387",56,49,47,-2,-16,67,63,49,1,"low"
7,"SUPPRF94387",48,58,41,-16,-13,80,54,57,1,"low"
8,"SUPPRF94387",49,55,62,8,-1,64,63,54,1,"low"
9,"SUPPRF94387",51,49,22,-21,-15,74,37,43,1,"low"
10,"SUPPRF94387",48,54,100,23,20,87,80,77,1,"low"
11,"SUPPRF94387",47,45,78,21,24,40,54,57,1,"low"
12,"SUPPRF94387",49,43,63,19,0,69,63,44,1,"low"
13,"SUPPRF94387",53,53,34,-13,-12,72,46,47,1,"low"
14,"SUPPRF94387",56,47,49,5,12,75,37,44,1,"low"
15,"SUPPRF94387",58,43,94,34,23,69,71,60,1,"low"
16,"SUPPRF94387",49,49,20,-23,0,42,20,43,1,"low"
17,"SUPPRF94387",54,38,67,-21,-13,68,80,88,1,"low"
18,"SUPPRF94387",57,46,55,-2,-16,55,71,57,1,"low"
19,"SUPPRF94387",60,44,35,12,15,80,20,23,1,"low"
20,"SUPPRF94387",53,45,68,-4,-12,55,80,72,1,"low"
21,"SUPPRF94387",44,49,66,7,12,63,54,59,1,"low"
22,"SUPPRF94387",45,47,47,21,27,72,20,26,1,"low"
23,"SUPPRF94387",44,48,16,-18,-13,64,29,34,1,"low"
24,"SUPPRF94387",56,46,88,30,25,57,63,58,1,"low"
25,"SUPPRF94387",57,45,33,-16,-13,60,46,49,1,"low"
26,"SUPPRF94387",46,37,19,4,-1,60,20,15,1,"low"
27,"SUPPRF94387",43,36,28,-3,-1,75,29,31,1,"low"
28,"SUPPRF94387",40,44,37,-4,0,58,37,41,1,"low"
29,"SUPPRF94387",42,48,46,1,0,74,46,45,1,"low"
30,"SUPPRF94387",46,39,54,-8,0,56,54,62,1,"low"
31,"SUPPRF94387",45,40,15,-16,-14,47,29,31,1,"low"
32,"SUPPRF94387",40,34,55,-1,1,58,54,56,1,"low"
33,"SUPPRF94387",51,40,81,8,1,60,80,73,1,"low"
34,"SUPPRF94387",51,42,75,27,29,67,46,48,1,"low"
35,"SUPPRF94387",49,42,70,15,-1,58,71,55,1,"low"
36,"SUPPRF94387",45,41,8,-14,-12,76,20,22,1,"low"
37,"SUPPRF94387",47,39,77,17,14,75,63,60,1,"low"
38,"SUPPRF94387",46,43,38,-20,1,63,37,58,1,"low"
39,"SUPPRF94387",49,37,61,19,24,74,37,42,1,"low"
40,"SUPPRF94387",46,38,96,21,16,81,80,75,1,"low"
41,"SUPPRF94387",51,42,71,34,0,40,71,37,1,"low"
42,"SUPPRF94387",45,41,80,8,0,70,80,72,1,"low"
43,"SUPPRF94387",50,42,24,-19,-13,70,37,43,1,"low"
44,"SUPPRF94387",47,38,38,-27,-16,66,54,65,1,"low"
45,"SUPPRF94387",44,52,29,-1,0,52,29,30,1,"low"
46,"SUPPRF94387",47,42,45,2,-1,61,46,43,1,"low"
47,"SUPPRF94387",33,41,6,-26,-14,70,20,32,1,"low"
48,"SUPPRF94387",39,47,58,26,29,67,29,32,1,"low"
1,"SUPPRF06891",48,46,47,30,-16,1,63,17,6,"high"
2,"SUPPRF06891",48,49,47,47,27,10,20,0,6,"high"
3,"SUPPRF06891",47,48,81,33,1,22,80,48,6,"high"
4,"SUPPRF06891",46,47,61,31,24,24,37,30,6,"high"
5,"SUPPRF06891",49,44,88,54,25,6,63,34,6,"high"
6,"SUPPRF06891",46,46,29,3,0,27,29,26,6,"high"
7,"SUPPRF06891",49,50,38,36,1,0,37,2,6,"high"
8,"SUPPRF06891",48,48,78,45,24,25,54,33,6,"high"
9,"SUPPRF06891",49,48,49,-2,12,8,37,51,6,"high"
10,"SUPPRF06891",49,48,71,12,0,21,71,59,6,"high"
11,"SUPPRF06891",50,46,33,-11,-13,30,46,44,6,"high"
12,"SUPPRF06891",45,50,46,5,0,34,46,41,6,"high"
13,"SUPPRF06891",49,50,75,30,29,37,46,45,6,"high"
14,"SUPPRF06891",50,48,41,13,-13,0,54,28,6,"high"
15,"SUPPRF06891",48,50,58,38,29,1,29,20,6,"high"
16,"SUPPRF06891",50,46,54,29,0,2,54,25,6,"high"
17,"SUPPRF06891",49,47,45,9,-1,2,46,36,6,"high"
18,"SUPPRF06891",36,38,22,2,-15,1,37,20,6,"high"
19,"SUPPRF06891",41,33,100,77,20,43,80,23,6,"high"
20,"SUPPRF06891",46,30,8,-12,-12,28,20,20,6,"high"
21,"SUPPRF06891",42,25,46,30,17,10,29,16,6,"high"
22,"SUPPRF06891",49,37,63,1,0,49,63,62,6,"high"
23,"SUPPRF06891",48,35,77,77,14,45,63,0,6,"high"
24,"SUPPRF06891",49,36,37,-13,0,0,37,50,6,"high"
25,"SUPPRF06891",45,28,24,-24,-13,0,37,48,6,"high"
26,"SUPPRF06891",34,30,55,6,1,1,54,49,6,"high"
27,"SUPPRF06891",36,28,35,-12,15,1,20,47,6,"high"
28,"SUPPRF06891",45,26,55,30,-16,0,71,25,6,"high"
29,"SUPPRF06891",50,34,16,-16,-13,1,29,32,6,"high"
30,"SUPPRF06891",46,28,67,43,-13,1,80,24,6,"high"
31,"SUPPRF06891",47,26,83,53,12,1,71,30,6,"high"
32,"SUPPRF06891",51,30,80,3,0,49,80,77,6,"high"
33,"SUPPRF06891",49,28,70,70,-1,1,71,0,6,"high"
34,"SUPPRF06891",47,26,20,20,0,1,20,0,6,"high"
35,"SUPPRF06891",48,32,58,29,12,43,46,29,6,"high"
36,"SUPPRF06891",50,21,6,-17,-14,0,20,23,6,"high"
37,"SUPPRF06891",50,27,94,94,23,0,71,0,6,"high"
38,"SUPPRF06891",49,20,50,49,-13,0,63,1,6,"high"
39,"SUPPRF06891",51,23,15,3,-14,1,29,12,6,"high"
40,"SUPPRF06891",48,12,68,59,-12,2,80,9,6,"high"
41,"SUPPRF06891",48,19,19,4,-1,0,20,15,6,"high"
42,"SUPPRF06891",48,17,62,59,-1,1,63,3,6,"high"
43,"SUPPRF06891",50,21,56,54,-15,1,71,2,6,"high"
44,"SUPPRF06891",42,14,28,15,-1,2,29,13,6,"high"
45,"SUPPRF06891",50,23,38,27,-16,41,54,11,6,"high"
46,"SUPPRF06891",50,22,96,17,16,49,80,79,6,"high"
47,"SUPPRF06891",48,21,66,66,12,1,54,0,6,"high"
48,"SUPPRF06891",47,18,34,33,-12,0,46,1,6,"high"
1,"SUPPRF35199",43,13,8,-26,-12,62,20,34,7,"high"
2,"SUPPRF35199",46,40,77,19,14,56,63,58,7,"high"
3,"SUPPRF35199",36,50,58,22,29,55,29,36,7,"high"
4,"SUPPRF35199",55,47,62,8,-1,57,63,54,7,"high"
5,"SUPPRF35199",51,53,6,-25,-14,51,20,31,7,"high"
6,"SUPPRF35199",52,61,88,32,25,70,63,56,7,"high"
7,"SUPPRF35199",53,59,46,5,0,44,46,41,7,"high"
8,"SUPPRF35199",98,54,100,37,20,73,80,63,7,"high"
9,"SUPPRF35199",56,53,61,25,24,44,37,36,7,"high"
10,"SUPPRF35199",56,58,96,18,16,81,80,78,7,"high"
11,"SUPPRF35199",53,55,20,-25,0,43,20,45,7,"high"
12,"SUPPRF35199",56,55,33,3,-13,60,46,30,7,"high"
13,"SUPPRF35199",61,56,50,-29,-13,79,63,79,7,"high"
14,"SUPPRF35199",55,55,34,-11,-12,67,46,45,7,"high"
15,"SUPPRF35199",55,61,70,2,-1,71,71,68,7,"high"
16,"SUPPRF35199",57,56,71,7,0,62,71,64,7,"high"
17,"SUPPRF35199",60,57,46,13,17,54,29,33,7,"high"
18,"SUPPRF35199",53,53,66,10,12,59,54,56,7,"high"
19,"SUPPRF35199",56,59,47,-22,-16,65,63,69,7,"high"
20,"SUPPRF35199",54,54,37,1,0,49,37,36,7,"high"
21,"SUPPRF35199",54,58,56,2,-15,55,71,54,7,"high"
22,"SUPPRF35199",57,59,28,-5,-1,62,29,33,7,"high"
23,"SUPPRF35199",63,58,94,32,23,62,71,62,7,"high"
24,"SUPPRF35199",63,54,19,-9,-1,46,20,28,7,"high"
25,"SUPPRF35199",66,60,45,1,-1,48,46,44,7,"high"
26,"SUPPRF35199",64,63,58,-1,12,58,46,59,7,"high"
27,"SUPPRF35199",65,65,80,2,0,60,80,78,7,"high"
28,"SUPPRF35199",60,59,81,10,1,65,80,71,7,"high"
29,"SUPPRF35199",60,57,22,-19,-15,56,37,41,7,"high"
30,"SUPPRF35199",61,59,63,2,0,57,63,61,7,"high"
31,"SUPPRF35199",67,67,35,21,15,65,20,14,7,"high"
32,"SUPPRF35199",68,69,83,22,12,70,71,61,7,"high"
33,"SUPPRF35199",63,58,29,-11,0,49,29,40,7,"high"
34,"SUPPRF35199",57,59,15,-13,-14,51,29,28,7,"high"
35,"SUPPRF35199",62,65,54,10,0,55,54,44,7,"high"
36,"SUPPRF35199",55,55,67,4,-13,64,80,63,7,"high"
37,"SUPPRF35199",59,59,16,-39,-13,38,29,55,7,"high"
38,"SUPPRF35199",62,64,68,-3,-12,65,80,71,7,"high"
39,"SUPPRF35199",60,59,38,-13,-16,53,54,51,7,"high"
40,"SUPPRF35199",59,58,41,-6,-13,53,54,47,7,"high"
41,"SUPPRF35199",62,59,38,-1,1,53,37,39,7,"high"
42,"SUPPRF35199",60,59,24,-20,-13,59,37,44,7,"high"
43,"SUPPRF35199",57,61,75,31,29,56,46,44,7,"high"
44,"SUPPRF35199",59,58,55,9,1,60,54,46,7,"high"
45,"SUPPRF35199",58,61,47,10,27,62,20,37,7,"high"
46,"SUPPRF35199",62,58,55,-11,-16,61,71,66,7,"high"
47,"SUPPRF35199",63,59,78,34,24,61,54,44,7,"high"
48,"SUPPRF35199",62,60,49,3,12,61,37,46,7,"high"
1,"SUPPRF45434",65,80,49,-12,12,62,37,61,4,"low"
2,"SUPPRF45434",95,93,83,8,12,64,71,75,4,"low"
3,"SUPPRF45434",95,96,66,0,12,62,54,66,4,"low"
4,"SUPPRF45434",93,91,68,-22,-12,75,80,90,4,"low"
5,"SUPPRF45434",78,83,54,-4,0,61,54,58,4,"low"
6,"SUPPRF45434",83,84,58,-11,29,62,29,69,4,"low"
7,"SUPPRF45434",73,72,35,-21,15,70,20,56,4,"low"
8,"SUPPRF45434",71,72,38,-19,1,58,37,57,4,"low"
9,"SUPPRF45434",66,83,55,2,-16,70,71,53,4,"low"
10,"SUPPRF45434",63,68,41,-29,-13,63,54,70,4,"low"
11,"SUPPRF45434",63,78,8,-34,-12,77,20,42,4,"low"
12,"SUPPRF45434",73,77,20,-17,0,60,20,37,4,"low"
13,"SUPPRF45434",65,67,55,-3,1,62,54,58,4,"low"
14,"SUPPRF45434",64,75,77,11,14,59,63,66,4,"low"
15,"SUPPRF45434",67,82,24,-31,-13,89,37,55,4,"low"
16,"SUPPRF45434",55,70,50,-15,-13,66,63,65,4,"low"
17,"SUPPRF45434",80,66,58,2,12,65,46,56,4,"low"
18,"SUPPRF45434",61,60,46,11,17,45,29,35,4,"low"
19,"SUPPRF45434",73,69,56,-8,-15,59,71,64,4,"low"
20,"SUPPRF45434",66,75,28,-26,-1,58,29,54,4,"low"
21,"SUPPRF45434",60,87,38,-25,-16,61,54,63,4,"low"
22,"SUPPRF45434",77,71,75,1,29,73,46,74,4,"low"
23,"SUPPRF45434",69,76,15,-60,-14,86,29,75,4,"low"
24,"SUPPRF45434",78,71,45,-18,-1,71,46,63,4,"low"
25,"SUPPRF45434",76,73,47,-31,-16,69,63,78,4,"low"
26,"SUPPRF45434",75,71,22,-42,-15,68,37,64,4,"low"
27,"SUPPRF45434",73,77,16,-69,-13,79,29,85,4,"low"
28,"SUPPRF45434",74,62,47,-14,27,59,20,61,4,"low"
29,"SUPPRF45434",71,63,61,-4,24,64,37,65,4,"low"
30,"SUPPRF45434",85,74,6,-54,-14,59,20,60,4,"low"
31,"SUPPRF45434",71,62,46,-19,0,64,46,65,4,"low"
32,"SUPPRF45434",79,68,29,-51,0,71,29,80,4,"low"
33,"SUPPRF45434",68,68,34,-19,-12,68,46,53,4,"low"
34,"SUPPRF45434",76,73,67,6,-13,63,80,61,4,"low"
35,"SUPPRF45434",100,88,80,21,0,61,80,59,4,"low"
36,"SUPPRF45434",81,86,88,31,25,71,63,57,4,"low"
37,"SUPPRF45434",75,80,62,-2,-1,69,63,64,4,"low"
38,"SUPPRF45434",82,72,70,9,-1,67,71,61,4,"low"
39,"SUPPRF45434",70,64,19,-43,-1,52,20,62,4,"low"
40,"SUPPRF45434",67,71,71,-6,0,73,71,77,4,"low"
41,"SUPPRF45434",68,74,37,-27,0,65,37,64,4,"low"
42,"SUPPRF45434",100,100,94,43,23,66,71,51,4,"low"
43,"SUPPRF45434",100,100,100,35,20,67,80,65,4,"low"
44,"SUPPRF45434",100,100,81,-2,1,100,80,83,4,"low"
45,"SUPPRF45434",72,86,63,-2,0,61,63,65,4,"low"
46,"SUPPRF45434",80,76,78,22,24,55,54,56,4,"low"
47,"SUPPRF45434",83,82,33,-21,-13,68,46,54,4,"low"
48,"SUPPRF45434",100,100,96,20,16,100,80,76,4,"low"
1,"SUPPRF83664",77,69,71,-7,0,72,71,78,5,"low"
2,"SUPPRF83664",80,78,83,6,12,78,71,77,5,"low"
3,"SUPPRF83664",76,76,54,-6,0,65,54,60,5,"low"
4,"SUPPRF83664",67,69,6,-19,-14,79,20,25,5,"low"
5,"SUPPRF83664",70,74,78,21,24,67,54,57,5,"low"
6,"SUPPRF83664",77,67,41,-18,-13,71,54,59,5,"low"
7,"SUPPRF83664",74,81,68,21,-12,4,80,47,5,"low"
8,"SUPPRF83664",88,78,80,11,0,68,80,69,5,"low"
9,"SUPPRF83664",61,73,47,-15,-16,77,63,62,5,"low"
10,"SUPPRF83664",77,82,29,-1,0,69,29,30,5,"low"
11,"SUPPRF83664",87,73,38,5,-16,24,54,33,5,"low"
12,"SUPPRF83664",81,70,15,-14,-14,73,29,29,5,"low"
13,"SUPPRF83664",85,75,63,13,0,68,63,50,5,"low"
14,"SUPPRF83664",88,77,70,0,-1,79,71,70,5,"low"
15,"SUPPRF83664",61,76,22,-32,-15,19,37,54,5,"low"
16,"SUPPRF83664",80,78,96,57,16,10,80,39,5,"low"
17,"SUPPRF83664",78,82,56,0,-15,19,71,56,5,"low"
18,"SUPPRF83664",80,87,77,17,14,76,63,60,5,"low"
19,"SUPPRF83664",79,85,75,0,29,78,46,75,5,"low"
20,"SUPPRF83664",63,80,50,-20,-13,75,63,70,5,"low"
21,"SUPPRF83664",51,74,20,-16,0,15,20,36,5,"low"
22,"SUPPRF83664",79,82,35,12,15,70,20,23,5,"low"
23,"SUPPRF83664",81,74,33,-17,-13,63,46,50,5,"low"
24,"SUPPRF83664",63,64,34,-21,-12,72,46,55,5,"low"
25,"SUPPRF83664",81,68,49,21,12,36,37,28,5,"low"
26,"SUPPRF83664",75,72,58,20,29,35,29,38,5,"low"
27,"SUPPRF83664",65,75,46,-6,0,78,46,52,5,"low"
28,"SUPPRF83664",73,79,55,6,-16,34,71,49,5,"low"
29,"SUPPRF83664",85,72,67,30,-13,24,80,37,5,"low"
30,"SUPPRF83664",63,74,16,-13,-13,62,29,29,5,"low"
31,"SUPPRF83664",73,70,46,18,17,65,29,28,5,"low"
32,"SUPPRF83664",77,85,100,22,20,79,80,78,5,"low"
33,"SUPPRF83664",77,69,45,1,-1,64,46,44,5,"low"
34,"SUPPRF83664",68,77,66,36,12,66,54,30,5,"low"
35,"SUPPRF83664",58,73,19,-12,-1,39,20,31,5,"low"
36,"SUPPRF83664",81,73,28,6,-1,78,29,22,5,"low"
37,"SUPPRF83664",75,68,55,2,1,70,54,53,5,"low"
38,"SUPPRF83664",87,84,88,31,25,61,63,57,5,"low"
39,"SUPPRF83664",78,79,38,-5,1,63,37,43,5,"low"
40,"SUPPRF83664",84,82,81,1,1,76,80,80,5,"low"
41,"SUPPRF83664",71,71,94,61,23,24,71,33,5,"low"
42,"SUPPRF83664",78,72,61,20,24,25,37,41,5,"low"
43,"SUPPRF83664",83,79,47,-6,27,25,20,53,5,"low"
44,"SUPPRF83664",79,71,62,1,-1,74,63,61,5,"low"
45,"SUPPRF83664",82,76,58,13,12,67,46,45,5,"low"
46,"SUPPRF83664",56,70,24,-30,-13,67,37,54,5,"low"
47,"SUPPRF83664",83,73,37,-1,0,76,37,38,5,"low"
48,"SUPPRF83664",81,72,8,-10,-12,77,20,18,5,"low"
1,"SUPPRF30408",54,63,38,5,1,80,37,33,4,"low"
2,"SUPPRF30408",62,66,100,19,20,79,80,81,4,"low"
3,"SUPPRF30408",53,60,56,-15,-15,64,71,71,4,"low"
4,"SUPPRF30408",51,67,46,14,0,69,46,32,4,"low"
5,"SUPPRF30408",51,58,58,28,29,75,29,30,4,"low"
6,"SUPPRF30408",53,53,71,8,0,66,71,63,4,"low"
7,"SUPPRF30408",54,52,75,34,29,53,46,41,4,"low"
8,"SUPPRF30408",54,61,55,-17,-16,81,71,72,4,"low"
9,"SUPPRF30408",51,50,28,0,-1,61,29,28,4,"low"
10,"SUPPRF30408",52,53,6,-11,-14,53,20,17,4,"low"
11,"SUPPRF30408",54,50,81,15,1,60,80,66,4,"low"
12,"SUPPRF30408",52,51,58,21,12,70,46,37,4,"low"
13,"SUPPRF30408",56,51,94,31,23,62,71,63,4,"low"
14,"SUPPRF30408",53,53,78,14,24,71,54,64,4,"low"
15,"SUPPRF30408",51,52,41,-21,-13,58,54,62,4,"low"
16,"SUPPRF30408",56,51,88,37,25,34,63,51,4,"low"
17,"SUPPRF30408",55,60,61,7,24,12,37,54,4,"low"
18,"SUPPRF30408",52,54,49,-2,12,66,37,51,4,"low"
19,"SUPPRF30408",50,53,62,-2,-1,77,63,64,4,"low"
20,"SUPPRF30408",53,54,22,-26,-15,67,37,48,4,"low"
21,"SUPPRF30408",52,54,45,-4,-1,67,46,49,4,"low"
22,"SUPPRF30408",52,50,16,-29,-13,50,29,45,4,"low"
23,"SUPPRF30408",51,51,29,6,0,78,29,23,4,"low"
24,"SUPPRF30408",55,52,77,13,14,80,63,64,4,"low"
25,"SUPPRF30408",49,52,46,18,17,71,29,28,4,"low"
26,"SUPPRF30408",50,49,34,-12,-12,64,46,46,4,"low"
27,"SUPPRF30408",52,52,35,14,15,70,20,21,4,"low"
28,"SUPPRF30408",51,49,24,-36,-13,61,37,60,4,"low"
29,"SUPPRF30408",54,50,37,3,0,70,37,34,4,"low"
30,"SUPPRF30408",49,52,33,-29,-13,51,46,62,4,"low"
31,"SUPPRF30408",53,51,20,2,0,65,20,18,4,"low"
32,"SUPPRF30408",52,51,54,-2,0,64,54,56,4,"low"
33,"SUPPRF30408",52,51,70,12,-1,67,71,58,4,"low"
34,"SUPPRF30408",50,51,68,1,-12,73,80,67,4,"low"
35,"SUPPRF30408",53,50,83,81,12,56,71,2,4,"low"
36,"SUPPRF30408",48,49,15,-33,-14,3,29,48,4,"low"
37,"SUPPRF30408",51,54,47,26,27,70,20,21,4,"low"
38,"SUPPRF30408",52,49,38,10,-16,45,54,28,4,"low"
39,"SUPPRF30408",49,49,80,56,0,18,80,24,4,"low"
40,"SUPPRF30408",68,50,67,-14,-13,71,80,81,4,"low"
41,"SUPPRF30408",51,52,63,0,0,75,63,63,4,"low"
42,"SUPPRF30408",51,50,47,-16,-16,81,63,63,4,"low"
43,"SUPPRF30408",50,52,66,19,12,72,54,47,4,"low"
44,"SUPPRF30408",51,47,55,-3,1,72,54,58,4,"low"
45,"SUPPRF30408",53,54,96,34,16,63,80,62,4,"low"
46,"SUPPRF30408",52,51,50,-14,-13,74,63,64,4,"low"
47,"SUPPRF30408",49,49,8,-27,-12,52,20,35,4,"low"
48,"SUPPRF30408",51,49,19,1,-1,80,20,18,4,"low"
1,"SUPPRF88256",54,78,47,24,27,70,20,23,7,"high"
2,"SUPPRF88256",65,84,75,-3,29,68,46,78,7,"high"
3,"SUPPRF88256",67,83,80,-8,0,81,80,88,7,"high"
4,"SUPPRF88256",72,83,68,-20,-12,94,80,88,7,"high"
5,"SUPPRF88256",76,93,28,11,-1,92,29,17,7,"high"
6,"SUPPRF88256",88,99,100,23,20,60,80,77,7,"high"
7,"SUPPRF88256",71,92,77,23,14,21,63,54,7,"high"
8,"SUPPRF88256",51,53,50,-20,-13,42,63,70,7,"high"
9,"SUPPRF88256",76,90,33,-35,-13,55,46,68,7,"high"
10,"SUPPRF88256",67,96,16,-33,-13,34,29,49,7,"high"
11,"SUPPRF88256",81,92,8,-32,-12,21,20,40,7,"high"
12,"SUPPRF88256",69,85,56,-19,-15,83,71,75,7,"high"
13,"SUPPRF88256",70,92,49,10,12,9,37,39,7,"high"
14,"SUPPRF88256",51,96,15,-24,-14,24,29,39,7,"high"
15,"SUPPRF88256",49,96,24,-17,-13,26,37,41,7,"high"
16,"SUPPRF88256",48,94,55,6,1,13,54,49,7,"high"
17,"SUPPRF88256",50,98,78,17,24,33,54,61,7,"high"
18,"SUPPRF88256",68,99,83,30,12,10,71,53,7,"high"
19,"SUPPRF88256",61,99,46,8,0,33,46,38,7,"high"
20,"SUPPRF88256",51,98,81,25,1,38,80,56,7,"high"
21,"SUPPRF88256",55,98,94,29,23,70,71,65,7,"high"
22,"SUPPRF88256",49,97,46,13,17,37,29,33,7,"high"
23,"SUPPRF88256",51,96,22,-25,-15,29,37,47,7,"high"
24,"SUPPRF88256",52,98,71,9,0,31,71,62,7,"high"
25,"SUPPRF88256",50,97,66,4,12,35,54,62,7,"high"
26,"SUPPRF88256",52,97,61,24,24,16,37,37,7,"high"
27,"SUPPRF88256",49,98,55,-20,-16,62,71,75,7,"high"
28,"SUPPRF88256",51,98,58,21,29,24,29,37,7,"high"
29,"SUPPRF88256",49,99,63,10,0,63,63,53,7,"high"
30,"SUPPRF88256",41,98,58,27,12,20,46,31,7,"high"
31,"SUPPRF88256",49,99,34,-38,-12,32,46,72,7,"high"
32,"SUPPRF88256",49,99,62,-3,-1,32,63,65,7,"high"
33,"SUPPRF88256",44,98,19,1,-1,53,20,18,7,"high"
34,"SUPPRF88256",42,100,37,20,0,82,37,17,7,"high"
35,"SUPPRF88256",49,97,6,-25,-14,92,20,31,7,"high"
36,"SUPPRF88256",51,99,41,-32,-13,72,54,73,7,"high"
37,"SUPPRF88256",48,97,47,-8,-16,24,63,55,7,"high"
38,"SUPPRF88256",49,100,96,35,16,32,80,61,7,"high"
39,"SUPPRF88256",47,98,20,8,0,94,20,12,7,"high"
40,"SUPPRF88256",52,99,67,-15,-13,89,80,82,7,"high"
41,"SUPPRF88256",48,98,38,-21,1,24,37,59,7,"high"
42,"SUPPRF88256",48,99,45,4,-1,6,46,41,7,"high"
43,"SUPPRF88256",59,97,54,-11,0,79,54,65,7,"high"
44,"SUPPRF88256",59,97,70,32,-1,15,71,38,7,"high"
45,"SUPPRF88256",51,96,38,-17,-16,16,54,55,7,"high"
46,"SUPPRF88256",49,96,35,30,15,96,20,5,7,"high"
47,"SUPPRF88256",63,98,88,31,25,59,63,57,7,"high"
48,"SUPPRF88256",51,97,29,-24,0,6,29,53,7,"high"
1,"SUPPRF55208",79,43,75,36,29,16,46,39,9,"high"
2,"SUPPRF55208",74,71,24,-34,-13,22,37,58,9,"high"
3,"SUPPRF55208",73,86,38,26,-16,42,54,12,9,"high"
4,"SUPPRF55208",99,99,56,20,-15,5,71,36,9,"high"
5,"SUPPRF55208",100,99,62,-10,-1,49,63,72,9,"high"
6,"SUPPRF55208",98,100,47,45,-16,1,63,2,9,"high"
7,"SUPPRF55208",98,99,35,-8,15,34,20,43,9,"high"
8,"SUPPRF55208",99,98,55,-6,-16,44,71,61,9,"high"
9,"SUPPRF55208",99,100,16,-9,-13,26,29,25,9,"high"
10,"SUPPRF55208",99,99,55,6,1,34,54,49,9,"high"
11,"SUPPRF55208",98,98,66,3,12,7,54,63,9,"high"
12,"SUPPRF55208",99,98,80,21,0,9,80,59,9,"high"
13,"SUPPRF55208",99,99,78,19,24,23,54,59,9,"high"
14,"SUPPRF55208",98,99,77,29,14,9,63,48,9,"high"
15,"SUPPRF55208",99,99,15,-7,-14,83,29,22,9,"high"
16,"SUPPRF55208",99,99,100,70,20,39,80,30,9,"high"
17,"SUPPRF55208",99,99,94,64,23,72,71,30,9,"high"
18,"SUPPRF55208",98,98,54,37,0,79,54,17,9,"high"
19,"SUPPRF55208",98,99,49,13,12,6,37,36,9,"high"
20,"SUPPRF55208",98,100,28,24,-1,93,29,4,9,"high"
21,"SUPPRF55208",98,100,81,3,1,24,80,78,9,"high"
22,"SUPPRF55208",98,100,46,21,17,92,29,25,9,"high"
23,"SUPPRF55208",98,98,22,-50,-15,44,37,72,9,"high"
24,"SUPPRF55208",99,98,29,16,0,88,29,13,9,"high"
25,"SUPPRF55208",98,98,58,13,12,10,46,45,9,"high"
26,"SUPPRF55208",99,99,34,1,-12,46,46,33,9,"high"
27,"SUPPRF55208",98,100,96,57,16,21,80,39,9,"high"
28,"SUPPRF55208",99,99,6,-67,-14,22,20,73,9,"high"
29,"SUPPRF55208",99,99,63,11,0,32,63,52,9,"high"
30,"SUPPRF55208",99,98,33,-13,-13,44,46,46,9,"high"
31,"SUPPRF55208",99,98,50,-19,-13,20,63,69,9,"high"
32,"SUPPRF55208",98,99,67,-20,-13,78,80,87,9,"high"
33,"SUPPRF55208",99,99,71,47,0,29,71,24,9,"high"
34,"SUPPRF55208",98,69,8,-16,-12,0,20,24,9,"high"
35,"SUPPRF55208",99,68,19,7,-1,96,20,12,9,"high"
36,"SUPPRF55208",99,69,45,3,-1,2,46,42,9,"high"
37,"SUPPRF55208",100,63,46,-3,0,78,46,49,9,"high"
38,"SUPPRF55208",98,49,41,-8,-13,25,54,49,9,"high"
39,"SUPPRF55208",97,45,58,39,29,32,29,19,9,"high"
40,"SUPPRF55208",99,50,20,14,0,80,20,6,9,"high"
41,"SUPPRF55208",98,44,37,-25,0,3,37,62,9,"high"
42,"SUPPRF55208",99,35,47,25,27,69,20,22,9,"high"
43,"SUPPRF55208",99,31,61,49,24,83,37,12,9,"high"
44,"SUPPRF55208",98,30,68,-14,-12,11,80,82,9,"high"
45,"SUPPRF55208",98,31,88,39,25,1,63,49,9,"high"
46,"SUPPRF55208",100,27,38,-16,1,9,37,54,9,"high"
47,"SUPPRF55208",100,20,70,41,-1,6,71,29,9,"high"
48,"SUPPRF55208",98,99,83,15,12,81,71,68,9,"high"
1,"SUPPRF59973",47,50,29,-27,0,50,29,56,2,"low"
2,"SUPPRF59973",52,52,68,27,-12,51,80,41,2,"low"
3,"SUPPRF59973",50,51,88,32,25,48,63,56,2,"low"
4,"SUPPRF59973",51,53,22,-50,-15,54,37,72,2,"low"
5,"SUPPRF59973",56,51,20,-39,0,45,20,59,2,"low"
6,"SUPPRF59973",55,48,46,-33,0,51,46,79,2,"low"
7,"SUPPRF59973",58,49,33,-23,-13,61,46,56,2,"low"
8,"SUPPRF59973",53,48,75,18,29,52,46,57,2,"low"
9,"SUPPRF59973",51,48,47,-12,-16,55,63,59,2,"low"
10,"SUPPRF59973",53,53,34,-22,-12,54,46,56,2,"low"
11,"SUPPRF59973",52,54,8,-45,-12,49,20,53,2,"low"
12,"SUPPRF59973",53,50,94,40,23,49,71,54,2,"low"
13,"SUPPRF59973",56,50,46,30,17,46,29,16,2,"low"
14,"SUPPRF59973",50,42,70,17,-1,51,71,53,2,"low"
15,"SUPPRF59973",55,51,67,16,-13,54,80,51,2,"low"
16,"SUPPRF59973",55,53,28,-26,-1,56,29,54,2,"low"
17,"SUPPRF59973",47,54,56,-2,-15,51,71,58,2,"low"
18,"SUPPRF59973",49,61,71,17,0,49,71,54,2,"low"
19,"SUPPRF59973",51,53,66,39,12,51,54,27,2,"low"
20,"SUPPRF59973",50,50,35,-20,15,51,20,55,2,"low"
21,"SUPPRF59973",54,47,41,-10,-13,50,54,51,2,"low"
22,"SUPPRF59973",52,49,100,56,20,52,80,44,2,"low"
23,"SUPPRF59973",61,52,38,-36,1,65,37,74,2,"low"
24,"SUPPRF59973",52,45,38,-12,-16,50,54,50,2,"low"
25,"SUPPRF59973",50,54,16,-37,-13,46,29,53,2,"low"
26,"SUPPRF59973",56,50,6,-41,-14,61,20,47,2,"low"
27,"SUPPRF59973",59,59,77,25,14,53,63,52,2,"low"
28,"SUPPRF59973",53,60,49,-5,12,66,37,54,2,"low"
29,"SUPPRF59973",61,53,47,-10,27,51,20,57,2,"low"
30,"SUPPRF59973",50,55,58,8,12,50,46,50,2,"low"
31,"SUPPRF59973",49,40,62,2,-1,48,63,60,2,"low"
32,"SUPPRF59973",47,52,81,27,1,47,80,54,2,"low"
33,"SUPPRF59973",52,54,55,0,1,48,54,55,2,"low"
34,"SUPPRF59973",65,72,83,39,12,54,71,44,2,"low"
35,"SUPPRF59973",56,66,37,-17,0,52,37,54,2,"low"
36,"SUPPRF59973",52,58,96,43,16,56,80,53,2,"low"
37,"SUPPRF59973",52,53,61,5,24,55,37,56,2,"low"
38,"SUPPRF59973",48,46,63,12,0,58,63,51,2,"low"
39,"SUPPRF59973",63,53,45,-6,-1,56,46,51,2,"low"
40,"SUPPRF59973",65,51,78,14,24,65,54,64,2,"low"
41,"SUPPRF59973",53,55,55,-38,-16,54,71,93,2,"low"
42,"SUPPRF59973",88,46,19,-35,-1,55,20,54,2,"low"
43,"SUPPRF59973",55,51,58,0,29,100,29,58,2,"low"
44,"SUPPRF59973",60,71,15,-38,-14,47,29,53,2,"low"
45,"SUPPRF59973",65,55,80,26,0,55,80,54,2,"low"
46,"SUPPRF59973",64,55,24,-28,-13,100,37,52,2,"low"
47,"SUPPRF59973",55,76,54,-7,0,52,54,61,2,"low"
48,"SUPPRF59973",66,62,50,-9,-13,66,63,59,2,"low"
1,"SUPPRF14988",77,68,15,-13,-14,88,29,28,9,"high"
2,"SUPPRF14988",48,48,67,-18,-13,89,80,85,9,"high"
3,"SUPPRF14988",31,42,68,-12,-12,65,80,80,9,"high"
4,"SUPPRF14988",66,59,46,25,17,56,29,21,9,"high"
5,"SUPPRF14988",19,12,6,-13,-14,45,20,19,9,"high"
6,"SUPPRF14988",93,94,100,23,20,70,80,77,9,"high"
7,"SUPPRF14988",50,49,33,-40,-13,13,46,73,9,"high"
8,"SUPPRF14988",26,25,63,-12,0,77,63,75,9,"high"
9,"SUPPRF14988",38,51,71,11,0,33,71,60,9,"high"
10,"SUPPRF14988",67,65,96,35,16,6,80,61,9,"high"
11,"SUPPRF14988",56,50,56,-9,-15,26,71,65,9,"high"
12,"SUPPRF14988",26,20,19,-38,-1,20,20,57,9,"high"
13,"SUPPRF14988",31,31,22,-11,-15,49,37,33,9,"high"
14,"SUPPRF14988",45,23,37,2,0,29,37,35,9,"high"
15,"SUPPRF14988",64,32,83,22,12,43,71,61,9,"high"
16,"SUPPRF14988",93,33,80,5,0,48,80,75,9,"high"
17,"SUPPRF14988",90,37,54,-6,0,56,54,60,9,"high"
18,"SUPPRF14988",81,25,47,-17,-16,69,63,64,9,"high"
19,"SUPPRF14988",17,17,20,-39,0,27,20,59,9,"high"
20,"SUPPRF14988",80,32,88,33,25,41,63,55,9,"high"
21,"SUPPRF14988",57,32,34,-3,-12,60,46,37,9,"high"
22,"SUPPRF14988",82,32,58,13,12,25,46,45,9,"high"
23,"SUPPRF14988",95,42,94,32,23,33,71,62,9,"high"
24,"SUPPRF14988",74,48,49,8,12,42,37,41,9,"high"
25,"SUPPRF14988",62,56,70,23,-1,50,71,47,9,"high"
26,"SUPPRF14988",75,52,81,-7,1,78,80,88,9,"high"
27,"SUPPRF14988",80,57,38,-8,1,70,37,46,9,"high"
28,"SUPPRF14988",85,38,47,27,27,60,20,20,9,"high"
29,"SUPPRF14988",38,13,38,-16,-16,70,54,54,9,"high"
30,"SUPPRF14988",86,39,28,-5,-1,25,29,33,9,"high"
31,"SUPPRF14988",12,12,8,-12,-12,81,20,20,9,"high"
32,"SUPPRF14988",72,31,78,38,24,49,54,40,9,"high"
33,"SUPPRF14988",68,52,66,11,12,68,54,55,9,"high"
34,"SUPPRF14988",75,63,29,-5,0,79,29,34,9,"high"
35,"SUPPRF14988",81,77,55,-7,1,71,54,62,9,"high"
36,"SUPPRF14988",83,77,62,5,-1,63,63,57,9,"high"
37,"SUPPRF14988",93,91,45,1,-1,87,46,44,9,"high"
38,"SUPPRF14988",97,83,75,30,29,93,46,45,9,"high"
39,"SUPPRF14988",87,79,41,-28,-13,67,54,69,9,"high"
40,"SUPPRF14988",97,73,61,18,24,74,37,43,9,"high"
41,"SUPPRF14988",86,61,24,-21,-13,49,37,45,9,"high"
42,"SUPPRF14988",94,82,58,22,29,47,29,36,9,"high"
43,"SUPPRF14988",96,71,77,20,14,44,63,57,9,"high"
44,"SUPPRF14988",98,88,35,-5,15,10,20,40,9,"high"
45,"SUPPRF14988",98,81,55,-5,-16,53,71,60,9,"high"
46,"SUPPRF14988",88,72,50,-12,-13,80,63,62,9,"high"
47,"SUPPRF14988",67,58,16,-27,-13,65,29,43,9,"high"
48,"SUPPRF14988",82,88,46,1,0,67,46,45,9,"high"
1,"SUPPRF46255",65,65,47,29,27,87,20,18,6,"high"
2,"SUPPRF46255",79,73,81,17,1,8,80,64,6,"high"
3,"SUPPRF46255",65,71,62,5,-1,14,63,57,6,"high"
4,"SUPPRF46255",58,51,77,25,14,18,63,52,6,"high"
5,"SUPPRF46255",60,55,34,-7,-12,69,46,41,6,"high"
6,"SUPPRF46255",64,58,96,21,16,88,80,75,6,"high"
7,"SUPPRF46255",64,68,58,26,29,76,29,32,6,"high"
8,"SUPPRF46255",58,57,100,37,20,6,80,63,6,"high"
9,"SUPPRF46255",62,58,55,19,1,77,54,36,6,"high"
10,"SUPPRF46255",63,64,71,14,0,28,71,57,6,"high"
11,"SUPPRF46255",46,45,8,-12,-12,84,20,20,6,"high"
12,"SUPPRF46255",55,50,38,-9,-16,45,54,47,6,"high"
13,"SUPPRF46255",55,56,38,-21,1,56,37,59,6,"high"
14,"SUPPRF46255",55,50,33,15,-13,71,46,18,6,"high"
15,"SUPPRF46255",50,48,70,46,-1,77,71,24,6,"high"
16,"SUPPRF46255",53,54,58,12,12,58,46,46,6,"high"
17,"SUPPRF46255",41,46,20,-36,0,29,20,56,6,"high"
18,"SUPPRF46255",58,51,78,25,24,14,54,53,6,"high"
19,"SUPPRF46255",49,48,61,18,24,12,37,43,6,"high"
20,"SUPPRF46255",50,48,47,-14,-16,58,63,61,6,"high"
21,"SUPPRF46255",46,45,24,-7,-13,36,37,31,6,"high"
22,"SUPPRF46255",52,52,50,8,-13,24,63,42,6,"high"
23,"SUPPRF46255",45,46,45,0,-1,22,46,45,6,"high"
24,"SUPPRF46255",57,52,29,-23,0,56,29,52,6,"high"
25,"SUPPRF46255",53,50,22,-18,-15,33,37,40,6,"high"
26,"SUPPRF46255",51,46,56,10,-15,33,71,46,6,"high"
27,"SUPPRF46255",42,45,16,-31,-13,15,29,47,6,"high"
28,"SUPPRF46255",56,60,80,3,0,75,80,77,6,"high"
29,"SUPPRF46255",49,47,37,23,0,10,37,14,6,"high"
30,"SUPPRF46255",54,52,63,4,0,58,63,59,6,"high"
31,"SUPPRF46255",49,52,41,-18,-13,63,54,59,6,"high"
32,"SUPPRF46255",49,49,67,30,-13,5,80,37,6,"high"
33,"SUPPRF46255",40,48,15,-44,-14,10,29,59,6,"high"
34,"SUPPRF46255",52,53,46,9,0,77,46,37,6,"high"
35,"SUPPRF46255",51,54,19,-29,-1,60,20,48,6,"high"
36,"SUPPRF46255",53,53,35,-8,15,47,20,43,6,"high"
37,"SUPPRF46255",51,50,28,11,-1,80,29,17,6,"high"
38,"SUPPRF46255",58,47,83,13,12,64,71,70,6,"high"
39,"SUPPRF46255",50,53,49,5,12,47,37,44,6,"high"
40,"SUPPRF46255",48,48,54,-6,0,56,54,60,6,"high"
41,"SUPPRF46255",43,40,6,-27,-14,2,20,33,6,"high"
42,"SUPPRF46255",42,32,46,31,17,66,29,15,6,"high"
43,"SUPPRF46255",50,38,94,45,23,5,71,49,6,"high"
44,"SUPPRF46255",49,44,66,9,12,79,54,57,6,"high"
45,"SUPPRF46255",50,34,55,3,-16,26,71,52,6,"high"
46,"SUPPRF46255",46,35,88,44,25,36,63,44,6,"high"
47,"SUPPRF46255",44,37,68,-15,-12,12,80,83,6,"high"
48,"SUPPRF46255",40,37,75,16,29,17,46,59,6,"high"
1,"SUPPRF73473",4,21,6,-20,-14,77,20,26,8,"high"
2,"SUPPRF73473",67,36,78,27,24,66,54,51,8,"high"
3,"SUPPRF73473",67,32,67,-17,-13,69,80,84,8,"high"
4,"SUPPRF73473",62,38,35,20,15,15,20,15,8,"high"
5,"SUPPRF73473",45,61,8,-6,-12,63,20,14,8,"high"
6,"SUPPRF73473",84,71,45,0,-1,75,46,45,8,"high"
7,"SUPPRF73473",31,47,29,-10,0,27,29,39,8,"high"
8,"SUPPRF73473",45,29,41,11,-13,28,54,30,8,"high"
9,"SUPPRF73473",50,42,19,-12,-1,28,20,31,8,"high"
10,"SUPPRF73473",83,51,83,47,12,6,71,36,8,"high"
11,"SUPPRF73473",100,63,96,71,16,23,80,25,8,"high"
12,"SUPPRF73473",59,44,46,2,0,35,46,44,8,"high"
13,"SUPPRF73473",76,90,81,42,1,26,80,39,8,"high"
14,"SUPPRF73473",49,27,63,10,0,56,63,53,8,"high"
15,"SUPPRF73473",60,54,34,-25,-12,69,46,59,8,"high"
16,"SUPPRF73473",42,59,49,12,12,5,37,37,8,"high"
17,"SUPPRF73473",80,27,71,-2,0,77,71,73,8,"high"
18,"SUPPRF73473",24,63,47,10,27,39,20,37,8,"high"
19,"SUPPRF73473",98,84,100,49,20,15,80,51,8,"high"
20,"SUPPRF73473",36,50,50,7,-13,23,63,43,8,"high"
21,"SUPPRF73473",28,56,94,48,23,25,71,46,8,"high"
22,"SUPPRF73473",25,16,58,23,12,52,46,35,8,"high"
23,"SUPPRF73473",61,29,47,-9,-16,25,63,56,8,"high"
24,"SUPPRF73473",28,22,46,14,17,67,29,32,8,"high"
25,"SUPPRF73473",31,35,56,-12,-15,71,71,68,8,"high"
26,"SUPPRF73473",38,32,15,-21,-14,34,29,36,8,"high"
27,"SUPPRF73473",30,55,75,34,29,26,46,41,8,"high"
28,"SUPPRF73473",37,41,61,19,24,25,37,42,8,"high"
29,"SUPPRF73473",25,25,16,-38,-13,17,29,54,8,"high"
30,"SUPPRF73473",23,24,54,14,0,70,54,40,8,"high"
31,"SUPPRF73473",78,24,88,52,25,34,63,36,8,"high"
32,"SUPPRF73473",21,23,58,48,29,81,29,10,8,"high"
33,"SUPPRF73473",23,19,62,17,-1,66,63,45,8,"high"
34,"SUPPRF73473",1,14,70,-3,-1,23,71,73,8,"high"
35,"SUPPRF73473",30,30,28,3,-1,40,29,25,8,"high"
36,"SUPPRF73473",3,1,77,31,14,23,63,46,8,"high"
37,"SUPPRF73473",2,1,20,5,0,17,20,15,8,"high"
38,"SUPPRF73473",3,2,37,-25,0,17,37,62,8,"high"
39,"SUPPRF73473",11,16,33,-34,-13,7,46,67,8,"high"
40,"SUPPRF73473",15,11,22,-10,-15,16,37,32,8,"high"
41,"SUPPRF73473",20,15,24,-13,-13,66,37,37,8,"high"
42,"SUPPRF73473",10,19,80,7,0,63,80,73,8,"high"
43,"SUPPRF73473",6,10,38,-14,-16,25,54,52,8,"high"
44,"SUPPRF73473",24,14,68,-6,-12,83,80,74,8,"high"
45,"SUPPRF73473",70,24,55,1,-16,22,71,54,8,"high"
46,"SUPPRF73473",78,16,55,0,1,18,54,55,8,"high"
47,"SUPPRF73473",25,19,38,4,1,21,37,34,8,"high"
48,"SUPPRF73473",2,3,66,32,12,29,54,34,8,"high"
1,"SUPPRF12889",70,71,8,-36,-12,65,20,44,2,"low"
2,"SUPPRF12889",78,80,58,35,29,68,29,23,2,"low"
3,"SUPPRF12889",68,66,41,-15,-13,68,54,56,2,"low"
4,"SUPPRF12889",67,69,67,-13,-13,92,80,80,2,"low"
5,"SUPPRF12889",61,54,38,-4,-16,53,54,42,2,"low"
6,"SUPPRF12889",67,69,24,-50,-13,63,37,74,2,"low"
7,"SUPPRF12889",70,64,29,-3,0,76,29,32,2,"low"
8,"SUPPRF12889",87,86,77,12,14,70,63,65,2,"low"
9,"SUPPRF12889",71,75,38,-15,1,53,37,53,2,"low"
10,"SUPPRF12889",94,88,94,31,23,66,71,63,2,"low"
11,"SUPPRF12889",59,57,47,34,27,30,20,13,2,"low"
12,"SUPPRF12889",72,80,19,10,-1,74,20,9,2,"low"
13,"SUPPRF12889",82,84,83,13,12,83,71,70,2,"low"
14,"SUPPRF12889",78,71,20,7,0,75,20,13,2,"low"
15,"SUPPRF12889",87,90,49,-5,12,20,37,54,2,"low"
16,"SUPPRF12889",46,87,22,-21,-15,76,37,43,2,"low"
17,"SUPPRF12889",96,91,100,15,20,66,80,85,2,"low"
18,"SUPPRF12889",92,92,50,6,-13,14,63,44,2,"low"
19,"SUPPRF12889",55,78,68,-16,-12,78,80,84,2,"low"
20,"SUPPRF12889",61,77,16,-6,-13,23,29,22,2,"low"
21,"SUPPRF12889",82,82,63,-3,0,80,63,66,2,"low"
22,"SUPPRF12889",62,95,47,-17,-16,67,63,64,2,"low"
23,"SUPPRF12889",91,93,71,-9,0,87,71,80,2,"low"
24,"SUPPRF12889",81,94,45,-3,-1,89,46,48,2,"low"
25,"SUPPRF12889",87,83,33,-18,-13,13,46,51,2,"low"
26,"SUPPRF12889",92,87,58,3,12,37,46,55,2,"low"
27,"SUPPRF12889",90,91,80,-10,0,71,80,90,2,"low"
28,"SUPPRF12889",66,94,34,-11,-12,71,46,45,2,"low"
29,"SUPPRF12889",83,94,55,14,1,68,54,41,2,"low"
30,"SUPPRF12889",81,92,70,2,-1,30,71,68,2,"low"
31,"SUPPRF12889",48,88,6,-8,-14,87,20,14,2,"low"
32,"SUPPRF12889",77,98,55,-8,-16,35,71,63,2,"low"
33,"SUPPRF12889",91,99,96,25,16,74,80,71,2,"low"
34,"SUPPRF12889",84,99,15,0,-14,88,29,15,2,"low"
35,"SUPPRF12889",100,100,75,14,29,76,46,61,2,"low"
36,"SUPPRF12889",82,99,35,31,15,35,20,4,2,"low"
37,"SUPPRF12889",94,100,61,17,24,70,37,44,2,"low"
38,"SUPPRF12889",99,98,46,24,17,84,29,22,2,"low"
39,"SUPPRF12889",100,100,88,33,25,19,63,55,2,"low"
40,"SUPPRF12889",98,99,46,-2,0,74,46,48,2,"low"
41,"SUPPRF12889",96,99,62,5,-1,83,63,57,2,"low"
42,"SUPPRF12889",98,99,81,5,1,85,80,76,2,"low"
43,"SUPPRF12889",99,99,78,27,24,84,54,51,2,"low"
44,"SUPPRF12889",97,100,66,21,12,32,54,45,2,"low"
45,"SUPPRF12889",82,90,54,8,0,10,54,46,2,"low"
46,"SUPPRF12889",53,66,56,-24,-15,91,71,80,2,"low"
47,"SUPPRF12889",94,93,28,14,-1,88,29,14,2,"low"
48,"SUPPRF12889",98,96,37,1,0,67,37,36,2,"low"
1,"SUPPRF54311",45,35,16,-12,-13,63,29,28,7,"high"
2,"SUPPRF54311",49,48,47,27,27,86,20,20,7,"high"
3,"SUPPRF54311",41,42,34,-11,-12,67,46,45,7,"high"
4,"SUPPRF54311",37,32,41,1,-13,76,54,40,7,"high"
5,"SUPPRF54311",51,51,81,13,1,84,80,68,7,"high"
6,"SUPPRF54311",48,74,37,7,0,82,37,30,7,"high"
7,"SUPPRF54311",63,71,61,19,24,95,37,42,7,"high"
8,"SUPPRF54311",52,73,94,37,23,95,71,57,7,"high"
9,"SUPPRF54311",51,75,20,-27,0,74,20,47,7,"high"
10,"SUPPRF54311",46,48,47,-1,-16,58,63,48,7,"high"
11,"SUPPRF54311",57,21,8,-4,-12,72,20,12,7,"high"
12,"SUPPRF54311",70,55,56,24,-15,61,71,32,7,"high"
13,"SUPPRF54311",50,75,62,17,-1,72,63,45,7,"high"
14,"SUPPRF54311",41,36,38,21,1,56,37,17,7,"high"
15,"SUPPRF54311",45,43,55,17,-16,44,71,38,7,"high"
16,"SUPPRF54311",49,74,80,0,0,79,80,80,7,"high"
17,"SUPPRF54311",48,89,70,-15,-1,88,71,85,7,"high"
18,"SUPPRF54311",48,47,67,18,-13,72,80,49,7,"high"
19,"SUPPRF54311",52,49,50,-1,-13,57,63,51,7,"high"
20,"SUPPRF54311",50,46,35,10,15,71,20,25,7,"high"
21,"SUPPRF54311",47,45,55,-7,1,88,54,62,7,"high"
22,"SUPPRF54311",47,48,28,-27,-1,96,29,55,7,"high"
23,"SUPPRF54311",62,62,77,29,14,63,63,48,7,"high"
24,"SUPPRF54311",36,49,68,8,-12,83,80,60,7,"high"
25,"SUPPRF54311",51,57,54,-6,0,91,54,60,7,"high"
26,"SUPPRF54311",44,38,22,-46,-15,92,37,68,7,"high"
27,"SUPPRF54311",50,56,29,-19,0,60,29,48,7,"high"
28,"SUPPRF54311",82,76,88,23,25,81,63,65,7,"high"
29,"SUPPRF54311",55,48,33,-25,-13,64,46,58,7,"high"
30,"SUPPRF54311",49,54,19,-14,-1,90,20,33,7,"high"
31,"SUPPRF54311",68,73,75,22,29,88,46,53,7,"high"
32,"SUPPRF54311",52,88,78,26,24,94,54,52,7,"high"
33,"SUPPRF54311",90,60,100,27,20,92,80,73,7,"high"
34,"SUPPRF54311",43,57,58,7,12,92,46,51,7,"high"
35,"SUPPRF54311",56,91,96,38,16,86,80,58,7,"high"
36,"SUPPRF54311",56,46,63,11,0,56,63,52,7,"high"
37,"SUPPRF54311",51,46,45,-3,-1,75,46,48,7,"high"
38,"SUPPRF54311",50,47,24,-31,-13,81,37,55,7,"high"
39,"SUPPRF54311",49,41,6,-56,-14,73,20,62,7,"high"
40,"SUPPRF54311",58,53,71,-9,0,78,71,80,7,"high"
41,"SUPPRF54311",52,46,46,17,17,61,29,29,7,"high"
42,"SUPPRF54311",85,72,83,40,12,76,71,43,7,"high"
43,"SUPPRF54311",38,48,49,3,12,67,37,46,7,"high"
44,"SUPPRF54311",53,84,38,-25,-16,79,54,63,7,"high"
45,"SUPPRF54311",48,48,66,19,12,81,54,47,7,"high"
46,"SUPPRF54311",39,48,15,-5,-14,81,29,20,7,"high"
47,"SUPPRF54311",74,74,58,29,29,87,29,29,7,"high"
48,"SUPPRF54311",50,51,46,-19,0,77,46,65,7,"high"
1,"SUPPRF28513",49,53,63,-10,0,4,63,73,2,"low"
2,"SUPPRF28513",55,51,19,-2,-1,3,20,21,2,"low"
3,"SUPPRF28513",52,49,71,11,0,15,71,60,2,"low"
4,"SUPPRF28513",53,53,46,-27,17,2,29,73,2,"low"
5,"SUPPRF28513",52,89,50,-2,-13,6,63,52,2,"low"
6,"SUPPRF28513",68,92,77,26,14,48,63,51,2,"low"
7,"SUPPRF28513",54,79,16,-11,-13,74,29,27,2,"low"
8,"SUPPRF28513",57,88,49,22,12,85,37,27,2,"low"
9,"SUPPRF28513",55,51,47,14,-16,22,63,33,2,"low"
10,"SUPPRF28513",51,85,56,-17,-15,48,71,73,2,"low"
11,"SUPPRF28513",14,96,34,-20,-12,98,46,54,2,"low"
12,"SUPPRF28513",53,84,75,22,29,44,46,53,2,"low"
13,"SUPPRF28513",32,91,33,-23,-13,44,46,56,2,"low"
14,"SUPPRF28513",19,74,28,-25,-1,40,29,53,2,"low"
15,"SUPPRF28513",10,23,24,-45,-13,65,37,69,2,"low"
16,"SUPPRF28513",27,38,66,-28,12,29,54,94,2,"low"
17,"SUPPRF28513",27,51,37,-1,0,21,37,38,2,"low"
18,"SUPPRF28513",21,21,15,-71,-14,86,29,86,2,"low"
19,"SUPPRF28513",48,48,29,-23,0,19,29,52,2,"low"
20,"SUPPRF28513",51,83,55,12,-16,6,71,43,2,"low"
21,"SUPPRF28513",49,17,58,7,12,9,46,51,2,"low"
22,"SUPPRF28513",34,47,38,11,1,22,37,27,2,"low"
23,"SUPPRF28513",81,49,80,-3,0,57,80,83,2,"low"
24,"SUPPRF28513",51,74,45,-16,-1,35,46,61,2,"low"
25,"SUPPRF28513",58,51,67,14,-13,30,80,53,2,"low"
26,"SUPPRF28513",93,62,100,49,20,37,80,51,2,"low"
27,"SUPPRF28513",65,59,20,-53,0,17,20,73,2,"low"
28,"SUPPRF28513",88,51,81,2,1,52,80,79,2,"low"
29,"SUPPRF28513",97,81,78,36,24,19,54,42,2,"low"
30,"SUPPRF28513",83,61,54,-33,0,70,54,87,2,"low"
31,"SUPPRF28513",20,66,6,-44,-14,82,20,50,2,"low"
32,"SUPPRF28513",37,81,55,-21,1,54,54,76,2,"low"
33,"SUPPRF28513",77,52,83,0,12,98,71,83,2,"low"
34,"SUPPRF28513",54,88,61,12,24,12,37,49,2,"low"
35,"SUPPRF28513",85,89,96,27,16,66,80,69,2,"low"
36,"SUPPRF28513",32,50,41,-35,-13,76,54,76,2,"low"
37,"SUPPRF28513",34,49,58,27,29,51,29,31,2,"low"
38,"SUPPRF28513",54,22,47,-20,27,37,20,67,2,"low"
39,"SUPPRF28513",13,5,8,-60,-12,4,20,68,2,"low"
40,"SUPPRF28513",92,53,68,61,-12,80,80,7,2,"low"
41,"SUPPRF28513",55,31,22,-41,-15,36,37,63,2,"low"
42,"SUPPRF28513",98,69,88,10,25,40,63,78,2,"low"
43,"SUPPRF28513",2,58,35,-40,15,7,20,75,2,"low"
44,"SUPPRF28513",54,56,38,-3,-16,93,54,41,2,"low"
45,"SUPPRF28513",49,77,46,-12,0,25,46,58,2,"low"
46,"SUPPRF28513",100,71,94,55,23,47,71,39,2,"low"
47,"SUPPRF28513",68,80,62,1,-1,66,63,61,2,"low"
48,"SUPPRF28513",84,66,70,-11,-1,44,71,81,2,"low"
1,"SUPPRF77346",50,53,47,-5,-16,56,63,52,8,"high"
2,"SUPPRF77346",50,57,55,-17,-16,64,71,72,8,"high"
3,"SUPPRF77346",58,56,100,42,20,49,80,58,8,"high"
4,"SUPPRF77346",60,59,77,44,14,15,63,33,8,"high"
5,"SUPPRF77346",51,48,58,5,12,58,46,53,8,"high"
6,"SUPPRF77346",49,56,58,37,29,65,29,21,8,"high"
7,"SUPPRF77346",49,55,55,5,1,51,54,50,8,"high"
8,"SUPPRF77346",56,46,34,-16,-12,33,46,50,8,"high"
9,"SUPPRF77346",52,50,81,26,1,29,80,55,8,"high"
10,"SUPPRF77346",53,52,15,-28,-14,34,29,43,8,"high"
11,"SUPPRF77346",46,50,24,-27,-13,40,37,51,8,"high"
12,"SUPPRF77346",51,50,19,-30,-1,34,20,49,8,"high"
13,"SUPPRF77346",55,55,83,33,12,33,71,50,8,"high"
14,"SUPPRF77346",51,50,16,-18,-13,32,29,34,8,"high"
15,"SUPPRF77346",49,40,20,-8,0,19,20,28,8,"high"
16,"SUPPRF77346",46,45,38,-7,1,34,37,45,8,"high"
17,"SUPPRF77346",66,49,96,50,16,50,80,46,8,"high"
18,"SUPPRF77346",51,50,46,24,17,82,29,22,8,"high"
19,"SUPPRF77346",49,58,29,-19,0,21,29,48,8,"high"
20,"SUPPRF77346",49,49,33,-17,-13,62,46,50,8,"high"
21,"SUPPRF77346",49,58,66,8,12,52,54,58,8,"high"
22,"SUPPRF77346",54,46,94,38,23,45,71,56,8,"high"
23,"SUPPRF77346",47,48,45,5,-1,41,46,40,8,"high"
24,"SUPPRF77346",55,52,80,5,0,72,80,75,8,"high"
25,"SUPPRF77346",52,46,75,43,29,24,46,32,8,"high"
26,"SUPPRF77346",33,46,47,0,27,37,20,47,8,"high"
27,"SUPPRF77346",44,34,6,-25,-14,30,20,31,8,"high"
28,"SUPPRF77346",39,37,62,23,-1,42,63,39,8,"high"
29,"SUPPRF77346",33,50,78,37,24,27,54,41,8,"high"
30,"SUPPRF77346",60,51,38,-24,-16,56,54,62,8,"high"
31,"SUPPRF77346",36,51,71,15,0,25,71,56,8,"high"
32,"SUPPRF77346",50,34,63,31,0,51,63,32,8,"high"
33,"SUPPRF77346",39,56,22,-26,-15,29,37,48,8,"high"
34,"SUPPRF77346",38,52,37,-15,0,43,37,52,8,"high"
35,"SUPPRF77346",51,36,68,19,-12,38,80,49,8,"high"
36,"SUPPRF77346",38,44,41,-5,-13,54,54,46,8,"high"
37,"SUPPRF77346",42,55,61,9,24,43,37,52,8,"high"
38,"SUPPRF77346",41,51,49,-6,12,47,37,55,8,"high"
39,"SUPPRF77346",34,33,67,11,-13,58,80,56,8,"high"
40,"SUPPRF77346",51,37,46,-11,0,57,46,57,8,"high"
41,"SUPPRF77346",34,37,56,-2,-15,26,71,58,8,"high"
42,"SUPPRF77346",35,41,88,35,25,37,63,53,8,"high"
43,"SUPPRF77346",40,46,54,-21,0,68,54,75,8,"high"
44,"SUPPRF77346",32,33,35,12,15,85,20,23,8,"high"
45,"SUPPRF77346",29,34,50,-9,-13,43,63,59,8,"high"
46,"SUPPRF77346",43,43,70,12,-1,68,71,58,8,"high"
47,"SUPPRF77346",30,36,8,-46,-12,16,20,54,8,"high"
48,"SUPPRF77346",31,33,28,-23,-1,33,29,51,8,"high"
1,"SUPPRF36491",70,37,46,7,0,66,46,39,10,"high"
2,"SUPPRF36491",73,39,78,25,24,69,54,53,10,"high"
3,"SUPPRF36491",70,58,83,-2,12,83,71,85,10,"high"
4,"SUPPRF36491",71,67,47,-24,-16,83,63,71,10,"high"
5,"SUPPRF36491",69,74,55,9,-16,85,71,46,10,"high"
6,"SUPPRF36491",72,73,50,19,-13,35,63,31,10,"high"
7,"SUPPRF36491",63,71,54,-10,0,55,54,64,10,"high"
8,"SUPPRF36491",72,77,81,48,1,27,80,33,10,"high"
9,"SUPPRF36491",72,62,20,-19,0,71,20,39,10,"high"
10,"SUPPRF36491",70,72,71,7,0,74,71,64,10,"high"
11,"SUPPRF36491",77,74,61,37,24,61,37,24,10,"high"
12,"SUPPRF36491",75,64,56,-18,-15,81,71,74,10,"high"
13,"SUPPRF36491",79,67,63,23,0,69,63,40,10,"high"
14,"SUPPRF36491",70,73,15,-53,-14,70,29,68,10,"high"
15,"SUPPRF36491",70,79,34,-2,-12,69,46,36,10,"high"
16,"SUPPRF36491",74,70,62,-6,-1,14,63,68,10,"high"
17,"SUPPRF36491",72,77,19,-10,-1,75,20,29,10,"high"
18,"SUPPRF36491",74,79,38,14,1,74,37,24,10,"high"
19,"SUPPRF36491",63,77,67,48,-13,61,80,19,10,"high"
20,"SUPPRF36491",73,63,70,9,-1,70,71,61,10,"high"
21,"SUPPRF36491",70,76,35,7,15,70,20,28,10,"high"
22,"SUPPRF36491",71,74,66,14,12,64,54,52,10,"high"
23,"SUPPRF36491",74,69,33,-15,-13,34,46,48,10,"high"
24,"SUPPRF36491",78,86,37,-5,0,75,37,42,10,"high"
25,"SUPPRF36491",77,80,75,43,29,73,46,32,10,"high"
26,"SUPPRF36491",70,71,96,28,16,74,80,68,10,"high"
27,"SUPPRF36491",70,70,46,-13,17,72,29,59,10,"high"
28,"SUPPRF36491",73,82,77,17,14,70,63,60,10,"high"
29,"SUPPRF36491",75,69,22,-10,-15,41,37,32,10,"high"
30,"SUPPRF36491",80,79,29,-14,0,31,29,43,10,"high"
31,"SUPPRF36491",79,71,28,-5,-1,70,29,33,10,"high"
32,"SUPPRF36491",87,85,100,35,20,72,80,65,10,"high"
33,"SUPPRF36491",82,88,41,-10,-13,89,54,51,10,"high"
34,"SUPPRF36491",84,87,45,19,-1,92,46,26,10,"high"
35,"SUPPRF36491",86,81,80,-3,0,89,80,83,10,"high"
36,"SUPPRF36491",74,82,6,-16,-14,88,20,22,10,"high"
37,"SUPPRF36491",84,87,8,-3,-12,83,20,11,10,"high"
38,"SUPPRF36491",76,82,68,27,-12,21,80,41,10,"high"
39,"SUPPRF36491",80,82,55,8,1,73,54,47,10,"high"
40,"SUPPRF36491",72,76,49,13,12,72,37,36,10,"high"
41,"SUPPRF36491",77,78,38,-18,-16,74,54,56,10,"high"
42,"SUPPRF36491",76,81,24,-1,-13,4,37,25,10,"high"
43,"SUPPRF36491",71,76,16,-40,-13,33,29,56,10,"high"
44,"SUPPRF36491",79,70,58,44,29,74,29,14,10,"high"
45,"SUPPRF36491",88,85,94,18,23,74,71,76,10,"high"
46,"SUPPRF36491",84,77,58,14,12,88,46,44,10,"high"
47,"SUPPRF36491",85,80,88,29,25,71,63,59,10,"high"
48,"SUPPRF36491",89,83,47,33,27,87,20,14,10,"high"
1,"SUPPRF63407",37,59,8,-20,-12,61,20,28,0,"low"
2,"SUPPRF63407",77,62,58,30,29,33,29,28,0,"low"
3,"SUPPRF63407",54,58,29,-4,0,27,29,33,0,"low"
4,"SUPPRF63407",70,67,83,39,12,19,71,44,0,"low"
5,"SUPPRF63407",65,86,46,-10,17,19,29,56,0,"low"
6,"SUPPRF63407",57,60,61,33,24,15,37,28,0,"low"
7,"SUPPRF63407",79,91,54,0,0,57,54,54,0,"low"
8,"SUPPRF63407",77,75,38,-18,-16,8,54,56,0,"low"
9,"SUPPRF63407",68,71,45,-9,-1,7,46,54,0,"low"
10,"SUPPRF63407",47,72,47,-26,-16,68,63,73,0,"low"
11,"SUPPRF63407",74,78,50,6,-13,18,63,44,0,"low"
12,"SUPPRF63407",75,71,41,-8,-13,7,54,49,0,"low"
13,"SUPPRF63407",42,71,37,-21,0,32,37,58,0,"low"
14,"SUPPRF63407",67,70,24,2,-13,18,37,22,0,"low"
15,"SUPPRF63407",43,37,15,-45,-14,32,29,60,0,"low"
16,"SUPPRF63407",37,59,62,-2,-1,68,63,64,0,"low"
17,"SUPPRF63407",57,42,19,-6,-1,29,20,25,0,"low"
18,"SUPPRF63407",74,69,77,16,14,13,63,61,0,"low"
19,"SUPPRF63407",28,32,6,-23,-14,67,20,29,0,"low"
20,"SUPPRF63407",57,69,16,-46,-13,27,29,62,0,"low"
21,"SUPPRF63407",30,41,20,-40,0,50,20,60,0,"low"
22,"SUPPRF63407",62,74,58,-3,12,31,46,61,0,"low"
23,"SUPPRF63407",71,74,71,13,0,36,71,58,0,"low"
24,"SUPPRF63407",44,74,33,-35,-13,63,46,68,0,"low"
25,"SUPPRF63407",78,78,55,0,-16,27,71,55,0,"low"
26,"SUPPRF63407",66,62,75,26,29,28,46,49,0,"low"
27,"SUPPRF63407",67,68,68,32,-12,30,80,36,0,"low"
28,"SUPPRF63407",86,79,100,41,20,27,80,59,0,"low"
29,"SUPPRF63407",44,34,28,-33,-1,76,29,61,0,"low"
30,"SUPPRF63407",63,71,38,-14,1,22,37,52,0,"low"
31,"SUPPRF63407",64,68,66,6,12,32,54,60,0,"low"
32,"SUPPRF63407",37,44,34,-10,-12,55,46,44,0,"low"
33,"SUPPRF63407",62,59,46,-9,0,37,46,55,0,"low"
34,"SUPPRF63407",66,67,63,3,0,58,63,60,0,"low"
35,"SUPPRF63407",70,71,67,-14,-13,64,80,81,0,"low"
36,"SUPPRF63407",69,74,55,-10,1,30,54,65,0,"low"
37,"SUPPRF63407",72,78,88,30,25,35,63,58,0,"low"
38,"SUPPRF63407",78,79,80,19,0,33,80,61,0,"low"
39,"SUPPRF63407",69,71,35,-30,15,32,20,65,0,"low"
40,"SUPPRF63407",74,71,81,26,1,35,80,55,0,"low"
41,"SUPPRF63407",48,70,22,-36,-15,44,37,58,0,"low"
42,"SUPPRF63407",71,66,78,18,24,69,54,60,0,"low"
43,"SUPPRF63407",90,80,94,22,23,69,71,72,0,"low"
44,"SUPPRF63407",89,83,96,23,16,56,80,73,0,"low"
45,"SUPPRF63407",78,74,56,-24,-15,57,71,80,0,"low"
46,"SUPPRF63407",76,77,70,6,-1,33,71,64,0,"low"
47,"SUPPRF63407",78,82,47,-31,27,63,20,78,0,"low"
48,"SUPPRF63407",84,84,49,6,12,84,37,43,0,"low"
1,"SUPPRF45302",44,43,66,16,12,43,54,50,3,"low"
2,"SUPPRF45302",34,42,58,20,29,61,29,38,3,"low"
3,"SUPPRF45302",24,29,15,-39,-14,56,29,54,3,"low"
4,"SUPPRF45302",52,39,37,1,0,61,37,36,3,"low"
5,"SUPPRF45302",49,48,55,-22,-16,62,71,77,3,"low"
6,"SUPPRF45302",47,37,38,-12,-16,69,54,50,3,"low"
7,"SUPPRF45302",39,53,54,-11,0,70,54,65,3,"low"
8,"SUPPRF45302",60,41,47,14,27,61,20,33,3,"low"
9,"SUPPRF45302",39,49,8,-29,-12,39,20,37,3,"low"
10,"SUPPRF45302",53,51,19,-18,-1,41,20,37,3,"low"
11,"SUPPRF45302",60,58,80,12,0,60,80,68,3,"low"
12,"SUPPRF45302",61,54,20,-11,0,34,20,31,3,"low"
13,"SUPPRF45302",68,65,46,-7,0,63,46,53,3,"low"
14,"SUPPRF45302",78,62,94,34,23,65,71,60,3,"low"
15,"SUPPRF45302",76,61,58,-1,12,57,46,59,3,"low"
16,"SUPPRF45302",46,56,63,25,0,64,63,38,3,"low"
17,"SUPPRF45302",68,63,81,10,1,65,80,71,3,"low"
18,"SUPPRF45302",67,73,68,-5,-12,57,80,73,3,"low"
19,"SUPPRF45302",59,73,41,-10,-13,57,54,51,3,"low"
20,"SUPPRF45302",58,69,50,-11,-13,69,63,61,3,"low"
21,"SUPPRF45302",47,67,24,-31,-13,37,37,55,3,"low"
22,"SUPPRF45302",67,75,70,7,-1,49,71,63,3,"low"
23,"SUPPRF45302",45,77,96,31,16,60,80,65,3,"low"
24,"SUPPRF45302",62,72,28,-13,-1,35,29,41,3,"low"
25,"SUPPRF45302",52,73,75,20,29,57,46,55,3,"low"
26,"SUPPRF45302",70,77,100,17,20,76,80,83,3,"low"
27,"SUPPRF45302",51,69,45,-15,-1,52,46,60,3,"low"
28,"SUPPRF45302",47,70,62,9,-1,34,63,53,3,"low"
29,"SUPPRF45302",46,65,47,-14,-16,34,63,61,3,"low"
30,"SUPPRF45302",56,75,29,15,0,68,29,14,3,"low"
31,"SUPPRF45302",55,74,6,-41,-14,51,20,47,3,"low"
32,"SUPPRF45302",51,72,35,-16,15,28,20,51,3,"low"
33,"SUPPRF45302",59,75,77,13,14,63,63,64,3,"low"
34,"SUPPRF45302",38,67,38,-33,1,51,37,71,3,"low"
35,"SUPPRF45302",63,81,22,-20,-15,54,37,42,3,"low"
36,"SUPPRF45302",65,75,55,1,1,61,54,54,3,"low"
37,"SUPPRF45302",60,72,16,-20,-13,60,29,36,3,"low"
38,"SUPPRF45302",44,74,61,21,24,65,37,40,3,"low"
39,"SUPPRF45302",65,82,71,-1,0,59,71,72,3,"low"
40,"SUPPRF45302",73,82,49,11,12,69,37,38,3,"low"
41,"SUPPRF45302",66,70,88,30,25,37,63,58,3,"low"
42,"SUPPRF45302",64,78,56,-5,-15,70,71,61,3,"low"
43,"SUPPRF45302",71,79,67,1,-13,52,80,66,3,"low"
44,"SUPPRF45302",48,68,34,-10,-12,58,46,44,3,"low"
45,"SUPPRF45302",54,65,33,-6,-13,58,46,39,3,"low"
46,"SUPPRF45302",52,77,78,13,24,60,54,65,3,"low"
47,"SUPPRF45302",61,72,46,16,17,63,29,30,3,"low"
48,"SUPPRF45302",68,78,83,12,12,48,71,71,3,"low"
1,"SUPPRF78576",39,52,29,-16,0,80,29,45,11,"high"
2,"SUPPRF78576",40,50,50,-15,-13,43,63,65,11,"high"
3,"SUPPRF78576",32,50,46,-4,0,16,46,50,11,"high"
4,"SUPPRF78576",34,51,38,1,1,85,37,37,11,"high"
5,"SUPPRF78576",35,48,94,26,23,80,71,68,11,"high"
6,"SUPPRF78576",35,48,34,-17,-12,65,46,51,11,"high"
7,"SUPPRF78576",25,48,75,31,29,20,46,44,11,"high"
8,"SUPPRF78576",37,54,24,-16,-13,64,37,40,11,"high"
9,"SUPPRF78576",30,50,16,-26,-13,61,29,42,11,"high"
10,"SUPPRF78576",35,52,100,14,20,85,80,86,11,"high"
11,"SUPPRF78576",35,51,88,24,25,87,63,64,11,"high"
12,"SUPPRF78576",28,51,71,9,0,58,71,62,11,"high"
13,"SUPPRF78576",33,51,33,-18,-13,50,46,51,11,"high"
14,"SUPPRF78576",34,52,46,18,17,81,29,28,11,"high"
15,"SUPPRF78576",32,53,20,-7,0,88,20,27,11,"high"
16,"SUPPRF78576",34,51,54,-7,0,67,54,61,11,"high"
17,"SUPPRF78576",26,50,78,20,24,80,54,58,11,"high"
18,"SUPPRF78576",28,48,81,6,1,74,80,75,11,"high"
19,"SUPPRF78576",37,52,37,-1,0,78,37,38,11,"high"
20,"SUPPRF78576",37,52,80,4,0,80,80,76,11,"high"
21,"SUPPRF78576",29,51,61,21,24,88,37,40,11,"high"
22,"SUPPRF78576",41,54,49,5,12,66,37,44,11,"high"
23,"SUPPRF78576",41,50,58,23,29,86,29,35,11,"high"
24,"SUPPRF78576",48,52,67,-5,-13,61,80,72,11,"high"
25,"SUPPRF78576",49,52,45,3,-1,86,46,42,11,"high"
26,"SUPPRF78576",42,48,8,-15,-12,65,20,23,11,"high"
27,"SUPPRF78576",45,53,62,-4,-1,86,63,66,11,"high"
28,"SUPPRF78576",40,51,56,-5,-15,54,71,61,11,"high"
29,"SUPPRF78576",39,51,41,-16,-13,86,54,57,11,"high"
30,"SUPPRF78576",41,52,68,-3,-12,82,80,71,11,"high"
31,"SUPPRF78576",43,49,58,9,12,82,46,49,11,"high"
32,"SUPPRF78576",36,48,6,-19,-14,80,20,25,11,"high"
33,"SUPPRF78576",43,52,55,-9,-16,64,71,64,11,"high"
34,"SUPPRF78576",38,49,70,0,-1,55,71,70,11,"high"
35,"SUPPRF78576",52,54,55,-2,1,76,54,57,11,"high"
36,"SUPPRF78576",46,51,83,13,12,93,71,70,11,"high"
37,"SUPPRF78576",37,52,66,12,12,84,54,54,11,"high"
38,"SUPPRF78576",36,55,96,21,16,51,80,75,11,"high"
39,"SUPPRF78576",42,53,47,21,27,12,20,26,11,"high"
40,"SUPPRF78576",47,59,63,5,0,23,63,58,11,"high"
41,"SUPPRF78576",50,50,35,9,15,45,20,26,11,"high"
42,"SUPPRF78576",42,53,15,-16,-14,72,29,31,11,"high"
43,"SUPPRF78576",47,58,38,-27,-16,92,54,65,11,"high"
44,"SUPPRF78576",53,62,19,-1,-1,60,20,20,11,"high"
45,"SUPPRF78576",51,60,28,-6,-1,66,29,34,11,"high"
46,"SUPPRF78576",51,55,22,-17,-15,85,37,39,11,"high"
47,"SUPPRF78576",44,58,77,20,14,49,63,57,11,"high"
48,"SUPPRF78576",38,49,47,-13,-16,87,63,60,11,"high"
1,"SUPPRF07128",32,44,61,50,24,8,37,11,8,"high"
2,"SUPPRF07128",44,36,28,-1,-1,28,29,29,8,"high"
3,"SUPPRF07128",10,10,16,3,-13,26,29,13,8,"high"
4,"SUPPRF07128",43,45,70,50,-1,28,71,20,8,"high"
5,"SUPPRF07128",46,28,45,-2,-1,48,46,47,8,"high"
6,"SUPPRF07128",33,32,38,-12,-16,50,54,50,8,"high"
7,"SUPPRF07128",44,45,33,-7,-13,42,46,40,8,"high"
8,"SUPPRF07128",47,42,46,32,0,21,46,14,8,"high"
9,"SUPPRF07128",52,51,96,50,16,41,80,46,8,"high"
10,"SUPPRF07128",50,51,47,34,-16,42,63,13,8,"high"
11,"SUPPRF07128",41,37,81,36,1,46,80,45,8,"high"
12,"SUPPRF07128",57,44,54,-3,0,66,54,57,8,"high"
13,"SUPPRF07128",62,49,55,0,-16,65,71,55,8,"high"
14,"SUPPRF07128",57,54,88,42,25,48,63,46,8,"high"
15,"SUPPRF07128",26,26,19,-41,-1,42,20,60,8,"high"
16,"SUPPRF07128",13,18,6,-44,-14,42,20,50,8,"high"
17,"SUPPRF07128",58,49,58,11,12,54,46,47,8,"high"
18,"SUPPRF07128",51,42,58,2,29,63,29,56,8,"high"
19,"SUPPRF07128",23,25,37,11,0,23,37,26,8,"high"
20,"SUPPRF07128",49,56,77,58,14,19,63,19,8,"high"
21,"SUPPRF07128",55,58,71,16,0,64,71,55,8,"high"
22,"SUPPRF07128",37,27,41,-13,-13,70,54,54,8,"high"
23,"SUPPRF07128",13,17,24,3,-13,44,37,21,8,"high"
24,"SUPPRF07128",16,22,20,-53,0,73,20,73,8,"high"
25,"SUPPRF07128",13,12,38,-9,1,46,37,47,8,"high"
26,"SUPPRF07128",46,41,29,20,0,13,29,9,8,"high"
27,"SUPPRF07128",43,42,68,5,-12,53,80,63,8,"high"
28,"SUPPRF07128",26,21,46,9,17,45,29,37,8,"high"
29,"SUPPRF07128",38,17,78,37,24,70,54,41,8,"high"
30,"SUPPRF07128",21,23,49,24,12,35,37,25,8,"high"
31,"SUPPRF07128",28,22,94,77,23,18,71,17,8,"high"
32,"SUPPRF07128",24,17,8,-9,-12,17,20,17,8,"high"
33,"SUPPRF07128",85,68,80,57,0,17,80,23,8,"high"
34,"SUPPRF07128",19,22,47,28,27,32,20,19,8,"high"
35,"SUPPRF07128",54,67,83,57,12,35,71,26,8,"high"
36,"SUPPRF07128",43,46,35,2,15,42,20,33,8,"high"
37,"SUPPRF07128",86,94,100,41,20,35,80,59,8,"high"
38,"SUPPRF07128",50,46,55,18,1,34,54,37,8,"high"
39,"SUPPRF07128",45,64,66,4,12,69,54,62,8,"high"
40,"SUPPRF07128",57,57,67,32,-13,67,80,35,8,"high"
41,"SUPPRF07128",1,8,34,-15,-12,45,46,49,8,"high"
42,"SUPPRF07128",34,45,56,24,-15,35,71,32,8,"high"
43,"SUPPRF07128",44,43,63,38,0,24,63,25,8,"high"
44,"SUPPRF07128",15,16,15,-16,-14,36,29,31,8,"high"
45,"SUPPRF07128",7,14,22,-36,-15,65,37,58,8,"high"
46,"SUPPRF07128",45,53,62,8,-1,42,63,54,8,"high"
47,"SUPPRF07128",44,46,50,8,-13,24,63,42,8,"high"
48,"SUPPRF07128",44,33,75,45,29,33,46,30,8,"high"
1,"SUPPRF65935",86,68,100,31,20,79,80,69,0,"low"
2,"SUPPRF65935",44,42,33,-35,-13,79,46,68,0,"low"
3,"SUPPRF65935",69,68,55,-23,-16,68,71,78,0,"low"
4,"SUPPRF65935",79,48,63,-11,0,69,63,74,0,"low"
5,"SUPPRF65935",35,50,35,-31,15,49,20,66,0,"low"
6,"SUPPRF65935",67,78,62,4,-1,49,63,58,0,"low"
7,"SUPPRF65935",56,42,46,-18,0,60,46,64,0,"low"
8,"SUPPRF65935",64,53,68,-13,-12,82,80,81,0,"low"
9,"SUPPRF65935",24,19,20,-46,0,63,20,66,0,"low"
10,"SUPPRF65935",24,24,22,-36,-15,28,37,58,0,"low"
11,"SUPPRF65935",69,66,71,-1,0,75,71,72,0,"low"
12,"SUPPRF65935",30,37,46,-23,17,82,29,69,0,"low"
13,"SUPPRF65935",48,50,38,5,1,72,37,33,0,"low"
14,"SUPPRF65935",54,64,66,6,12,92,54,60,0,"low"
15,"SUPPRF65935",64,52,16,-35,-13,61,29,51,0,"low"
16,"SUPPRF65935",56,37,47,-15,-16,56,63,62,0,"low"
17,"SUPPRF65935",55,60,50,-24,-13,57,63,74,0,"low"
18,"SUPPRF65935",19,13,19,-49,-1,58,20,68,0,"low"
19,"SUPPRF65935",71,88,83,17,12,98,71,66,0,"low"
20,"SUPPRF65935",24,23,28,-43,-1,58,29,71,0,"low"
21,"SUPPRF65935",51,62,70,0,-1,98,71,70,0,"low"
22,"SUPPRF65935",66,54,81,0,1,98,80,81,0,"low"
23,"SUPPRF65935",50,53,37,0,0,86,37,37,0,"low"
24,"SUPPRF65935",69,75,94,25,23,65,71,69,0,"low"
25,"SUPPRF65935",54,51,49,-34,12,99,37,83,0,"low"
26,"SUPPRF65935",77,85,77,13,14,97,63,64,0,"low"
27,"SUPPRF65935",68,70,67,-14,-13,99,80,81,0,"low"
28,"SUPPRF65935",36,34,58,0,29,93,29,58,0,"low"
29,"SUPPRF65935",62,53,41,-16,-13,88,54,57,0,"low"
30,"SUPPRF65935",17,23,24,-20,-13,85,37,44,0,"low"
31,"SUPPRF65935",67,67,38,-15,-16,89,54,53,0,"low"
32,"SUPPRF65935",10,10,6,-22,-14,90,20,28,0,"low"
33,"SUPPRF65935",55,23,34,-8,-12,84,46,42,0,"low"
34,"SUPPRF65935",31,50,61,33,24,81,37,28,0,"low"
35,"SUPPRF65935",83,67,88,25,25,84,63,63,0,"low"
36,"SUPPRF65935",71,75,80,9,0,86,80,71,0,"low"
37,"SUPPRF65935",40,59,56,-22,-15,74,71,78,0,"low"
38,"SUPPRF65935",40,50,58,-3,12,63,46,61,0,"low"
39,"SUPPRF65935",66,70,54,-14,0,89,54,68,0,"low"
40,"SUPPRF65935",28,51,15,-16,-14,86,29,31,0,"low"
41,"SUPPRF65935",0,51,8,-35,-12,73,20,43,0,"low"
42,"SUPPRF65935",79,87,96,17,16,91,80,79,0,"low"
43,"SUPPRF65935",76,67,45,-12,-1,82,46,57,0,"low"
44,"SUPPRF65935",21,55,29,-35,0,72,29,64,0,"low"
45,"SUPPRF65935",79,65,75,20,29,78,46,55,0,"low"
46,"SUPPRF65935",80,74,78,15,24,87,54,63,0,"low"
47,"SUPPRF65935",76,56,55,-7,1,88,54,62,0,"low"
48,"SUPPRF65935",77,66,47,21,27,87,20,26,0,"low"
